D : n,알파벳 네번째문자
D&C : x,dilatation and curettage(자궁 경관)확장과(내막)소파
D&D : x,Death and Dying
D'Annunzio : n,단눈치오(이탈리아의 시인,소설가,극작가)
d'orsay : n,도르세이(여성용 펌프스)
d'ya : x,do you의 단축형
d'you : x,(시각방언)=do you
D,& D : x,묵비권을 행사하다,음주문란
D,A,B : x,Dictionary of American Biography 미국 인명 사전
D,A,C, : x,Department of Army Civilian,Development Assistance Committee 개발 원조 위원회
D,A,D, : x,digital audio disc
D,A,D,M,S, : x,Deputy Assistant Director of Medical Services
D,A,D,O,S, : x,Deputy Assistant Director of Ordnance Services
D,A,G, : x,Deputy Adjutant General
D,A,Q,M,G, : x,Deputy Assistant Quartermaster General
D,A,R, : x,Daughters of the American Revolution
D,A,S,D, : x,direct access storage device
D,A,T, : x,differential aplitude test적성 판별 검사,digital audiotape
D,A,V, : x,Disabled American Veterans미국 상이 군인회
D,Ed, : x,Doctor of Education
D,Eng, : x,Doctor of Engineering
D,F, : x,Dean of Faculty 스코틀랜드 변호사협회장
D,F,C, : x,Distinguished Flying Cross 공군 수훈 십자 훈장
D,F,M, : x,(공군)Distinguished Flying Medal
D,G, : x,Dei gratia(L=by the grace of God),Deo gratias(L=thanks to God),Director General,Dragon Guards
D,Hy, : x,Doctor of Hygiene
D,I,Y, : x,do,it,yourself
D,J, : x,disk jockey,District Judge,Doctor Juris
D,K, : x,din't know
D,L, : x,Deputy Lieutenant,Doctor of Law
D,L,F, : x,Development Loan Fund(미)정부개발 차관 기금
D,L,I, : x,Durham Light Infantry
D,L,O, : x,Dead Letter Office,배달 불능 우편물계
D,L,S, : x,Doctor of Library Science
D,Lit : x,Doctor Leterarum
D,M, : x,Doctor of Medicine,Daily Mail,Doctor of Mathematics
D,M,D : x,Dentariae Medicinae Doctor(L=Doctor of Dental Medicine)
D,M,I, : x,Director of Military Intelligence
D,M,L, : x,Doctor of Modern Languages
D,M,S, : x,(영)Diploma in Management Studies,Doctor of Medical Science
D,Mus, : x,Doctor of Music
D,N, : x,Daily News
D,O,A, : x,(병원)dead on arrival
D,O,E, : x,(영)Department of the Environment,Department of Energy,(미)에너지성
D,O,P : x,developingout paper 현상 인화자
D,O,R,A, : x,(영법)Ddfence of the Realm Act
D,P, : x,data oricessing,degree of polymerization,(화)중합도
D,P,H, : x,Diploma in Public Health(의)공중 위생 면허장,Doctor of Public Health
D,P,I, : x,Director of Public Instruction
D,P,M, : x,disintegration per minute(물)(방사성 원소의) 1분간의 붕괴수
D,Ph, : x,Doctor of Philosophy
D,R, : x,
d,r, : x,dead reckoning,deposit receipt
D,R,P, : x,Democratic Republican Party
d,s, : x,days after sight (상)일람후...일,document signed
D,S, : x,Doctor of Science,Dental Surgeon.dal segno
D,S,C, : x,Distinguished Service Cross(군)청동수훈 심자장
D,S,M, : x,(군)Distinguished Service Medal
D,S,O, : x,Distinguished Sercice Order(영군)수훈장
d,s,p, : x,decessit sine prole(L=died without issue)
D,S,T, : x,Daylight Saving
D,Sc, : x,Doctor of Science
d,t, : x,delirium tremens
D,T,'S : n,=DELIRIUM TREMENS
D,Th, : x,Doctor of Theology
D,U,I, : x,driving under the influence음주 운전
D,V, : x,Deo volente(L=God willing)
d,w, : x,dust wrapper
d-n : v,=DAMN
D/A converter : x,DA변환기(디지털 신호를 아날로그 신호로 변환)
D/L : x,demand loan,(전산)data link
D/N : x,debit note차변표
D/O : x,delivery order
daad air : x,송신 기계 고장 등에 의한 방송의 중단
dab : vt,vi,a,두드리다,바르다,칠하다,한번 쓱 칠하기,지문을 채취하다,숙련된
dabber : n,가볍게 두드리는 사람,칠하는 솔,잉크솔
dabble : vt,물을 튀기다,물장난을 하다,취미삼아 해보다
dabbler : n,물장난을 하는 사람,도락 삼아 하는 사람
dabchick : n,농병아리
dabster : n,솜씨도 없으면서 좋아하는 사람,무엇이든 함부로 덤비는 사람,서투른 화가
dacapo : ad,처음주터 반복하여
Dacca : n,다카,방글라데시의 수도
dace : n,황어
dacha : n,교외 별장,시골,저택
dachshund : n,닥스훈트(긴 몸 짧은 발의 독일 개)
dacoit : n,인도 버마의 강도
dacoity : n,다코이트의 약탈
Dacron : n,데이크론(폴리에스테르계 합성 섬유)
dactyl : n,장단단격,강약약격
dactylic : a,n,댁틀의 시구
dactylo : n,손가락,발가락
dactylogram : n,지문
dactylography : n,지문학,지문법
dactylology : n,(농아자 등의)수화,지화법
dad : n,아빠,(=God 대개 가벼운 저주의 표현)
Dadaism : n,다다이즘,허무적 예술의 한파
Dadaist : n,허무주의적 예술가,다다이스트
daddy : n,아버지,최연장자,가장 중요한 인물,(=SUGAR DADDY)
daddylonglers : n,소경머리,모기아재비,다리가 긴 사람
Daddyo : n,아저씨(남자 일반에 대한 친근한 호칭)
dado : n,징두리 판벽
dadod : a,징두리 판벽을 댄
daead ball : x,사구
daedal : a,교묘한,천변만화의,가지가지의,(=DAEDALIAN)
Daedalian : a,다이달로스의 솜씨같은,복잡한
Daedalus : n,다이달로스(Crete의 미로를 만든 아테네의 명장)
daemon : n,(=DEMON)
daemonic : a,(=DEMONIC)
daff : n,(=DAFFODIL)
daffadowndilly : n,(=DAFFODIL)
daffodil : n,나팔수선화
daffy : a,어리석은,미친
daft : a,어리석은,얼간이의,미친,들떠서 떠들어대는,발광하다,daftly, ad,daftness 
dag : n,가리비 나뭇잎 무늬의 가두리 장식,별난 사람
dagger : n,단도,칼표,심한적의를 품고,이중 칼표,무서운 눈초리로 노려보다
daggle : vi,vt,(진찬 속 등으로)질질 끌고 가다,질질 끌어서 더럽히다,느릿느릿 걸어가다
dago : n,남유럽인,이탈리아,스페인 사람 등
dagoba : n,사리탑,솔도파
dago red : x,값싼 술,(알코올 중독자가 상음하는)저질의 적포도주
daguerreotype : n,은판사진(Daguerre가 발명한 옛적의)
Dagwood : n,미국의 유명한 만화의 주인공,여러 겹으로 겹친 샌드위치
dah : n,버마 사람들의 소검(나이프 대용),모르스 부호의 긴 검
dahabeah : n,나일강의 여객용 범선
dahlia : n,달리아,천축모란
Dahomey : n,다오메이,아프리카 서부 benin 공화국의 구칭
Dail Eireann : x,아일랜드 공화국의 하원
daily : ,a,n,매일의,일상의,일부의,매일,날마다,일간 신문
daily bread : x,생계,나날의 양식
daily breader : n,임금 생활자,근로자
daily double : x,(경마에서)복승식,2연승,두번 계속된 성공
daily dozen : x,(원래 12종류로 이루어져 있었던 데서),(체력 증강을 위해)매일 하는 체조
daily help : x,통근하는 하녀,파출부
daily installment : x,일부,일수
daily newspaper : x,일간 신문
Daimler : n,데임러(영국제 고급 자동차)
daimon : n,(=DEMON)
daintily : ad,우아하게,우미하게,섬세하게,맛있게,결백하게 까다롭게,(음식을)가려서
daintiness : n,우미,미미,까다로움,호사를 좋아함,(음식을)가림
dainty : a,n,우아한,품위 있는,성미가 까다로운,맛좋은,진미
daiquiri : n,다이커리,럼을 밑술로 한 칵테일
dairy : n,착유장,낙농업,낙농장,우유점,유제품 판매소
dairy cattle : x,젖소
dairy chemistry : x,낙농 화학
dairy cream : x,(가공한 것이 아닌)낙농장제 우유
dairy farming : x,낙농업
dairying : n,낙농업
dairymaid : n,젖 짜는 여자
dairyman : n,낙농장주인,우유장수
dairy products : x,낙농 제품,유제품
dais : n,은접실,식당등의 높은 단,연단,높은 단,상좌
daisied : a,데이지가 피어있는
daisy : n,데이지,상등품,훌륭한
daisy chain : x,데이지 화환,줄줄이 이어진 것,(사건,항목,단계 등의)연쇄
daisy cutter : x,(구보 때)발을 조금밖에 들지 않는 말,(야구,크리켓,정구 등에서의)땅을 스치듯 날아가는 공,(살상용)파쇄성 폭탄
daisy wheel : x,타자기의 원반형 활자 부위(고속으로 조용히 타자가 됨)
dak : n,(인도)역전(우편물)
Dak, : x,Dakota
Dakar : n,다카르(세네갈의 수도)
dak bungalow : n,(인도)여인숙
Dakota : n,다코타(미국 중부의 주,남북으로 갈림)
dal : n,달(렌즈콩과 향료를 사용한 인도 요리)
Dalai Lama : x,달라이라마(티베트의 환불)
dalasi : n,달라시(Gambia의 화폐 단위)
dale : n,골짜기
Dalek : n,(영)달렉(귀에 거슬리는 단조로운 소리로 말하는 로봇)
dalesman : n,(영국 북부의)골짜기에 사는 사람
Dalian : n,다렌(랴오둥 반도 남단의 상업항)
Dallas : n,댈러스(미국 Texas주 북동부의 도시)
Dallasite : n,댈러스의 주민
dalles : n,(미,캐나다)절벽 사이의 급류
dalliance : n,희롱,장난,애정 유희,시간의 낭비
dally : vi,장난치다,희롱하다,빈둥거리다,헛되게 보내다,dallylier 희롱
Dalmatia : n,달마티아(유고슬라비아 서부의 아드리아 해 연안 지방)
Dalmatian : n,달마티아 개(포인터 비슷한 큰 바둑이)
dalmatic : n,달마티카(제의의 일종),(국왕의)대관식복
dal segno : x,기호 있는 곳에서 반복하여
dalton : n,달톤(원자 질량의 단위)
Dalton : n,돌턴 학교(미국Massachusetts주 돌턴 시 소재),돌턴 John~(영국의 화학 ,물리학자)
daltonism : n,색맹
Daltonize : vt,...에 돌턴식 학습 지도법을 실시하다
Dalton plan : x,돌턴식 교육법(미국 Massachusetts의 돌턴 시에서 시도,학생을 능력에 따라 학습시킴)
dam : n,vt,댐,둑으로 막다,둑으로 막다,저지하다,막다
dam : n,어미,어미 짐승,
damage : n,vt,vi,손해,손상,손해 배상금,해치다,손상시키다,쓰게 되다
damageable : a,손해를 입기 쉬운
damage control : x,응급 피해 대책,피해 대책반
damaged baggage report : x,수하물 파손 신고서(승객의 파손된 수하물에 대한 항공회사의 조사서)
damaging : a,손해를 끼치는,해로운,(법적으로)불리한 진술
damascene : 다마스크의,다마스크풍의 물결무늬가  있는,다마스크스 사람,다마스크 세공,물결무늬,물결무늬를 넣다,칼날에물결무늬를 띠게하다,쇠붙이에 금은으로 상감하다
Damascus : n,다마스쿠프(시리아의 수도)
Damascus steel : x,다마스크 강철(도검용)
damask : n,a,vt,다마스쿠프천,능직,석죽색의,다마스크천의,석죽색의,능직으로 짜다,뺨을 붉히다
damaskeen : vt,(=DAMASCENE)
damask rose : x,담홍색의 장미,담홍색
damask steel : x,(=DAMASCUS STEEL)
dame : n,귀부인,귀인,지체가 높은 숙녀,나이가 든 여인,(영)이튼 학교의 사감(남자에게도 말함)
Dame Fortune : x,(의인화 하여)운명,운명의 여신
dame school : x,(전에 여인이 자택을 개방하여 경영하던)초등 학교
damfool : n,a,지독한 바보,형편 없는 바보의
damfoolish : a,(=DAMFOOL)
dammit : int,=DAMN it
damn : vt,비난하다,저주하다,욕을 퍼붓다,파멸시키다,빌어 먹을,지금도,제기랄,빌어먹을
damnable : a,저주받을 만한,지겨운
damnation : n,int,저주,욕설,악평,지옥에 떨어뜨림,천벌,파멸,제기랄,젠장
damnatory : a,저주의,파멸적인,비난의
damned : a,ad,저주받은,지겨운,지독히
damnedest : a,n,몹시 괴상한,터무니 없는,최선,최대한의 노력
damnification : n,손상
damnify : vt,손상하다
damning : a,지옥에 떨어질,파멸적인,꼼짝못할,damningly ,ad,damningness
damnosahereditas : n,(L=damaging inheritande)(로마법)불이익이 되는 상속물
Damoclean : a,(=DAMOCLES)
Damocles : n,Syracuse의 참왕 Dionysius I의 가신
Damon and Pythias : n,다먼과 피티아스(옛 글스에서 목숨을 걸고 맹세를 지킨 두 친구),둘도 없는 친구,절친한 친구,막역한 벗
damoselzel : n,=DAMSEL
damp : n,a,vt,습기,낙담,실망,방해,축죽한,습기있는,축축하게하다,낙담시키다,기를 꺽다,못살게 굴다
damp course : x,벽 속의 방습층(슬레이트와 같은 습기를 막는 재료로 됨)
dampdry : vt,a,세탁물을 설말리다,설말린
dampen : vt,vi,=축축하게 하다,축이다,남을 풀죽게 하다,축축해지다
damper : n,흥을 깨뜨리는 사람,기를 꺽는 석,피아노의 단음 장치,현악기의 약음기,난로의 공기 조정판
damping : a,n,습기를 주는,(직물을 윤내는)가습기,습윤기,제동(감폭)하는,제동,(진동의 감폭)
damping off : n,모잘록병,장승병
dampish : a,좀 습한,눅눅한
damply : ad,축축하게,기운 없이
dampness : n,축축함,습기
dampproof : a,방습의,습기를 막는
damp squib : x,불발로 끝난 기도,헛일,효과가 없는 것
damsel : n,처녀,소녀
damselfly : n,실잠자리
damsite : n,댐 건설 부지
damson : n,a,서양자두,암자색의
damson cheese : x,DAMSON의 설탕절임
damyankee : n,양키놈,북부놈
Dan : n,팔에스티나 북단의 마을(from dan to  beer sheba 전체에 걸쳐,끝에서 끝까지)
dan : n,(심해어업용의)소형 부표
Danang : n,다낭(베트남 중동부의 항구 도시)
dance : vi,vt,n,춤추다,뛰다,흔들거리다,춤을 추다,댄스
danceable : a,(음악 등이)댄스에 알맞은,댄스용의
dance drama : x,무용극
dance hall : x,댄스 홀,(미)사형 집행실
dance music : x,무도곡,무용곡,댄스 음악
dancer : n,춤추는 사람,댄서,전문적인 무용가
dancercise : n,댄서사이즈(운동으로서 추는 춤)
dance step : x,댄스의 스텝
dancing : n, 춤,무도,댄스 홀,무도장,댄스 교사)
dancing girl : x,댄서,무희
dancing hall : x, (=DANCE HALL)
dancing mania : x,무도병
dancing master : x,댄스 교사
dancing mistress : x,댄스 여교사
dancing partner : x,댄스의 상대
dancing party : x,댄스 파티,무도회
dancing room : x,무용실
dancing school : x,댄스 교습소,무용 학교
dancing shoe : x,무용화
dande band : x,댄스 밴드
dandelion : n,민들레
dandelion coffee : x,말린 민들레 뿌리로 만든 음료
dander : n,역정,뼛성,노하다,머리의 비듬
dandiacal : a,멋쟁이다운,멋부린,dandiacally,ad
Dandie Dinmont : x,댄디딘몬트 테리어(동체가 길고 다리가 짭은 테리어개의 일종)
dandification : n,치장,멋부린 차림새
dandified : a,멋부린,잔뜩 치장한,스마트한
dandify : vt,멋쟁이로 치장시키다,멋부리게 하다
dandle : vt,귀여워하다,어르다,어하다,dandler,n
dandruff : n,비듬
dandy : n,a,멋쟁이,썩좋은 물건,일품,멋진,훌륭한
dandy brush : x,말빗(고래뼈로 만든 말 솔)
dandy cart : x,(스프링이 달린)우유 배달차
dandyish : a,멋쟁이의,멋부리는
dandyism : n,치장,멋부림
dandy roll : x,비치는 무늬를 박아 넣는 롤러
Dane : n,덴마크사람
danegeld : n,데인세(10세기 후반 영국에서 침입자 데인 사람에게 바칠 공물 또는 대항할 군비로 바치던 조세)
Danelaw : n,9,11세기에 데인 사람이 재배한 영국북동부,그 지역에서 행하여진 법률
dang : v,n,(=DAMN)
dange : n,음경
danger : n,위험,장애,...의 위험이 있다
danger list : x,(병원의)중환자 명부
danger money : x,(영)위험 수당
dangerous : a,위험한,무시무시한,위독한,dangerousness,n
dangerously : ad,위험하게,위태롭게
danger signal : x,위험 신호,정지 신호
danger zone : x,(군)위험 지대
dangle : vi,vt,매달리다,뒤쫓다,따라다니다,매달다,어른거려 꾀다
dangledolly : n,(영)자동차의 유리창에 매다는 마스코트인형
dangler : n,매달리는 사람,매달린 부분,귀찮게 따라다니는 사람,여자 꽁무니를 따라다니는 사람
dangling : vt,...에게 결과를 알리지 않고 기다리게 하다,...을 애타게 (안달복달하게)하다
dangling bond : x,결합되어 있지 않은 화확 결합 손,(원자)가표
dangling participle : x,현수 분사(문장의 주어와 문법적으로 결합되지 않은 채 사용된 분사)
Daniel : n,다니엘서,히브리의 예언자,명재판관
danio : n,다니오(작은 관상용 열대어)
danish : a,덴마크의,덴마크 말
Danish dog : x,(=Great DANE)
Danish modern : x,장식이 적고 심풀한 덴마크의 가구양식(1960년대에 세계적으로 유행)
Danish pastry : x,파이 비슷한 과자빵(과일,땅콩 등을 가미한)
Danish West Indies : n,덴마크령 서인도 제도(미국령 버진 제도의 옛 이름)
dank : a,축축한,습기찬,dankly,ad, dankness,n
dankeschon : int,(G)대단히 감사합니다
Dannebrog : n,(붉은 바탕에 백십자가 있는)덴마크 국기
danny : n,손
Danny : n,남자 이름
danse macabre : n,(=dance of death)
danseur : n,남자 발레 댄서
danseuse : n,여자댄서
Dante : n,단테(이탈리아 시인)
Dantean : a,n,단테(류)의,단테 연구가(숭배자)
Dantesque : a,단테식의,장중한
Dantist : n,단테 연구가
Danube : n,독일의 강(흑해로 흐르는 독일의 한 강)
Danubian : a,다뉴브강의
Danzig : n,단치히(폴란드 북부의 항구 도시)
dap : vi,vt,n,(낚시)미끼를 살며시 수면에 떨어뜨리다,(공이)튀다,튀게하다,공의 튐
Daphne : n,아폴로에게 쫓겨 월계수로 화한 요정
daphnia : n,물벼룩류,새각류
Daphnis : n,(그리이스 신화)다프니스(목가의 창시자)
Daphnis and Chloe : n,다프니스와 클로에(2-3세기경 그리스의 목가적인 이야기 속의 순진한 연인들)
dapper : a,단정한,작고 활발한
dapple : a,얼룩진,얼룩지다
dappled : a,얼룩진
dapplegray : n,회색에 검은 얼룩이 박힌 말
darb : n,굉장한 것(사람)
darbies : n,수갑
Darby and Joan : n,(민요중의 노부부에서),의좋은 늙은 부부
Dardan : n,(=Trojan)
Dardanelles : 다르다넬스 해협(마르마라해와 에게해를 잇는 유럽 아시아 대륙간의 해협)
dare : vt,감히 ~ 하다,모험적으로 해보다,위험을 무릅쓰다,도전하다
daredevil : a,무모한
daredevilry : n,뒤를 헤아리지 않음,무모한 용기,무모
daren't : x,dare not의 단축형
daresay : v,=DARE say
darg : n,(스코,오스)하루(일정량)의 일
dargah : n,(이슬람교의)성인의 묘,성묘
Dari : n,다리 말(페르시아말의 일종,아프가니스탄의 Tajik사람이 사용함)
daric : n,옛 페르시아의 금화
daring : a,대담무쌍한,겁이 없는
Darius : n,다리우스 왕(페르시아의)
dariy farmer : x,낙농업자
Darjeeling : n,다질링(인도 West Bengal주의 소도시),다질링차(다질링에서 나는 고급 홍차)
dark : 어두운,캄캄한,거무스레한,비밀의,숨은,수수께끼 같은,무지한,사악한,음울한,슬픈,우울한,부루퉁한,방송이 정지된,암흑,어둠,땅거미,무지
dark adaptation : x,(생리)암순응
dark adapted : a,(생리)암순응의
Dark Ages : x,암흑 시대
Dark and Bloody Ground : x,(미)Kentucky주의 별명(초기의 인디언과의 전투와 관련된 호칭)
dark brown star : x,(천)암갈색의 별(가시광을 거의 발하지 않는 은하 속의 적외선원
dark comedy : x,(=BLOCK HUMOR,BLOCK COMEDY)
Dark Continent : x,암흑 대륙 아프리카
dark days : x,1불우한 시대,슬럼플 시기
dark deeda : x,비행
darken : vt,vi,어둡게 하다,모호하게  하다(don't darken my door	again,다시는 내 집에서 발을 들여놓지 말라)
darkey : n,(=DARKY)
dark field : x,(현미경의) 암시야
dark field illumination : x,암시야 조명법(현미경 시료의)
dark field microscope : x,(광)한외 현미경,암시야 현미경
dark horse : x,다크호스(경마,선거 등에서 역량 미지의 유력한 상대)
darkie : n,(DARKY)
darkish : a,어스레한,거무스름한
dark lantern : x,초롱,등롱
darkle : vi,어스름해지다,(얼굴빛,기분이)험악해지다
darkling : a,어두운,어둠 속의
darkly : ad,어둡게,거무스름하게,음울하게,험악하게,모호하게
dark meat : x,요리하면 검어지는 고기(닭다리 고기 등),(미)흑인 여자
darkness : n,어둠,암흑,무지,설명,애매
dark rays : x,암복사선(자외선이나 적외선 같은 눈에 보이지 않는 광선)
dark reaction : x,(식)암반응
darkroom : n,암실
darksome : a,어스레한,어둑한,음울한
darktown : n,흑인 거주 구역
darky : n,깜둥이,흑인
darling : a,귀여운,당신,가장 사랑하는 사람
darn : vt,꿰메 깁다,떠서 깁다
darn : vy,vi,n,=damn
darned : a,말도 안되는,우라질,터무니없는
darnel : n,(식)독 보리
darner : n,꿰매는(짜깁는,감치는),(=DARNING last)
darning : n,(해진 구멍의)감침질
darning egg : x,달걀 모양의 꿰맴질용 덧댈감
darning needle : x,감침질 바늘,잠자리
darobokka : n,(북 아프리카의)두 손바닥으로 두드리는 북
daroga : n,(인도)관리자,감독자,(경찰,세무서 등의)서장
dart : n,vt,vi,표창,던지는 창,침,던지다,발사하다,돌진하다
dartboard : n,다트판(화살 던지기의 과녁판)
darter : n,DART하는 사람,(어)아메리카산 시어(조그마한 민물 고기로서 화살처럼 날램)
dartist : n,화살던지기 게임을 하는 사람
dartle : vi,되풀이하여 던지다
Dartmoor : n,잉글랜드 남서부의 바위가 많은 고원,다트쿠어 형무소
Dartmouth : n,다트머스(영국 Devon주의 항구),(그곳의)다트머스 해군 사관학교
dartre : n,포진상 피부병,헤르페스
dartrous : n,a
darts : n,pl,다츠(둥근 과녁에 쇠 화살을 던져 득점을 다투는 놀이)
Darvon : n,다르본(진통제의 하나)
Darwin : n,다윈(영국의 박물학자)
Darwinian : n,다윈설의,진화론자
Darwinism : n,다윈설,진화론
dary farm : x,낙농장
dash : 던지다,내던지다,끼얹다,약간 섞다,때려부수다,기를 꺽다,브끄럽게 하다,돌진하다,부딪다,단숨에 하다,급히 쓰다,돌진,충동,위세,기운,허세,기미,대시,단거리 경주
Dashaveyor : n,대셔베이어(내장된 전기 모터로 궤도를 달리는 교통 기관의 하나)
dashboard : n,흙받기,물보라 막이,흙받이,자동차 따위 조종석의 계기반
dashboard light : x,계기반용 등
dashed : a,ad,의기 소침한,낙심한,괘씸한,지독히,굉장히
dasheen : n,(식)타로토란
dasher : n,돌진하는 사람,교반기,위세 당당한 사람,(미)진흙받이,계기반
dashiki : n,다시키(아프리카의 민족의상으로,선명한 빛깔의 덮어쓰는 옷)
dashing : a,기운찬,화려한,멋부린
dashpot : n 대시포트(완충,제동 장치)
dashy : a,(=DASHING)
dasn't : x,(미 방)dare not의 단축형
dastard : n,겁쟁이,비겁한 자
dastardly : a,비겁한,겁약한,못난
dastur : n,PARSI교의 고승
dasyure : n,주머니고양이(오스트레일리아 및 태즈메이니아산)
data : n,재료,자료,데이터
data acquisition : x,(전산)데이터 수집
data bank : x,데이터 뱅크(전자 계산기용 정보와 그 축적 보관 및 제공 기관)
data bank : vt,데이터뱅크에 넣다(보관하다)
data base : n,데이터베이스(전자계산기용 정보의 축적 및 이 정보의 제공 서비스)
data base management system : x,(전산)데이터베이스 관리 시스템(약 DBMS)
data binder : x,(전산)데이터 바인더(컴퓨터로부터의 프린트아웃을 철하는)
datable : a,시일을 추정할 수 있는,datableness,n
data broadcasting : x,데이터 브로드캐스팅(각종 데이터를 전송하는 등의 새로운 방송 서비스 방식)
data capture collection : x,(전산)(단말장치로부터의)데이터 수집
data communication : x,데이터 통신
datadriven : a,		 (전산)(프로그램이)데이터에 따라 처리를 행하는
data encryption standard : x,데이터 암호화 기준
data format : x,(전산)데이터의 형식(컴퓨터에 입력하는 데이터의 배열)
data integrity : x,(전산)데이터 보전성(입력된 데이터가 변경,파괴되지 않은 상태)
datal : n.a,(주로 탄광의)일급제,날짜의,날짜순으로 배열한
data link : x,(통신,전산)데이터 링크(데이터 송수신을 위한 통신선,약 D/L)
dataller : n,날품팔이(특히 탄광의)
datalogger : x,(전산)계산치 등의 물리량을 계속 기록하는 장치
data logging : x,(전산)데이터를 시계열적으로 기록하기
datamation : n,자동 데이터 처리,데이터메이션 산업
dataphone : n,데이터폰(컴퓨터에 데이터를 보내는 전화)
Datapost : n,(영)데이터포스트(익일 배달 소포 우편)
data processing : x,데이터 처리
data processor : x,데이터 처리 장치
data reduction : x,(전산)데이터 정리(압축)
datary : n,(천주교)교황청 장새원(성직 희망자의 적격 심사를 하는 교황청의 한 부서)
data security : x,(전산)데이터 보호
data set : x,데이터 세트(데이터 처리상 1단위로 취급되는 일련의 기록,데이터 통신에서 쓰이는 변환기)
data terminal equipment : x,(전산)데이터 단말 장치
data transmission : x,(전산)데이터 전송
datavase industry : x,(전산)데이터베이스산업(축적된 정보를 고객에게 제공하는 산업)
datcha : n,(=DACHA)
date : n,대추야자(의 열매)
date : n,vt,vi,날짜,연월일,기일,만날 약속,데이트,날짜를 쓰다,시일을 정하다,날짜가 적혀있다,시작되다
dateable : a,(=DATABLE)
datebook : n,(신문기자의)예정 메모책,(일반적으로)(회합 등의 예정을 적는)메모책,예정장
dated : a,날짜 있는,시대에 뒤진,datedly,ad,datedness,n
date dance : x,(미)좋아하는 여자를 동반하는 댄스 파티
dateless : a,날짜 없는,무기한의,태고의,시대를 초월하여 흥미 있는
date line : x,n,vt,날짜 변경선,날짜기입선,(기사등에)발신지와 날짜를 기입한다
datemark : n,vt,일부인(특히 금 은제 식기류에 찍은 제조 연월일)...에 일부인을 찍다
date palm : x,대추야자
dater : n,날짜 찍는 사람,날짜 스탬프,데이트하는 사람
date slip : x,(도서관)반납 기일(대출 일자)표,대출 카드
date stamp : x,vt,(우편물 등에 찍는)날짜 인자기,일부인,날짜 인,소인,(우편물 등에)일부인(소인)을 찍다
dating : 날짜기입,(상)선일부,사후 일부(날짜를 늦추어 기입하여 어음 등의 지불을 유예함),(고고학,지질학 등에서의)연대 결정,데이트하기
dating bar : 독신 남녀용 바(술집)
datival : a,(문법)여격의
dative : n,여격(의)
dative verb : x,(문법)여격동사,수여동사(간접,직접의 두 목적어를 취하는 동사)
dato : n,(필리핀,말레이시아 등지의)족장,(바리오의)수장
datum : n,논거,자료,데이터
datum line : x,기준선
datum plane : x,기준면
datura : n,흰독말풀
daub : vt,바르다,바르기,처덕처덕 칠하다
dauber : n,칠하는 사람,미장이,(=DAUBSTER),칠하는 솔
daubery : n,그림물감을 누덕누덕 칠하기,서투른 그림,속임수
daubster : n,서투른 화가
dauby : a,마구 그린,끈적끈적한
daughter : 딸,(사람,사건,시대의 정신적 소산인)여자,동성애의  남성(특히)유혹되어 동성애의 세계로 빠진 남자,딸로서의,(생)제1세의 소산의,(물)방사성 붕괴로 생긴,딸된 신분,처녀 시절,(집합적)딸들,daughterless,a
daughter element : x,(방사 물질읨 분열로 생기는)자원소
daughterinlaw : n,며느리
daughterly : a,딸로서의,딸다운
daunt : vt,놀라게하다,으르다,의 시새를 꺾다,조금도 겁내지 않고
dauntless : a,대담한
dauphin : n,황태자
dauphiness : n,(사)프랑스 황태자비의 칭호
Dave : n,남자 이름
davenport : n,침대 겸용의 긴 소파
david : n,다윗(이스라엘의 제 2대 왕)
Davidic : a,데이브의
da Vinci : x, Leonardo(1452,1519)이탈리아의 화가 조각가,건축가,과학자
Davis : n,남자 이름
Davis apparatus : x,잠수함으로 부터의 탈출 장치의 하나
Davis Cup : x,데이비스컵(국제 테니스시합 우승배)
Davis Strait : n,데이비스 해협(Greenland 와 캐나다의 Baffin섬 사이의)
davit : n,보트 메다는 기둥
Davy : n,David의 애칭,선서서
Davy Jones : x,해마(in davy joness locker 물고기 밥이 되어)
Davy Jones' locker : x,바다,해저,(특히)바다의 무덤
Davy lamp : x,갱부용 안전등
daw : n,바보
dawdle : vt,핀둥핀둥 시간을 보내다
dawdler : n,느림보,게으름뱅이
dawg : n,개(시각방언)
dawk : n,(=DAK),(미)소극적 반전론자,비둘기파와 매파의 중간파
dawn : n,vi,새벽,동틀녁,여명,동이 트다,밝아지다,나타나기 시작하다,날이새다
dawn chorus : x,(극광 등으로 인한)새벽의 라디오 전파 장애,이른 아침의 합창(새들의 지저귐)
dawning : n,새벽,여명,동녁,동쪽,(새 시대 등의)조짐,출현,시작
dawnlike : a,새벽(조짐)같은
dawn patrol : x,(군)새벽 정찰 비행,(라디오,텔레비젼의)새벽 프로그램 담당자
day : n,낮,하루,(노동 시간의)하루,기념일,축제일,시절,사람의 일생,주간,약속날,시대,싸움,승부,승리
Dayak : n,다야크족(보르네오섬 내륙부에 분포하는 비이슬람교 종족),다야크 말
day bed : x,침대 겸용 소파(낮에는 소파로 씀)
day bilndness : x,(병리)주맹(증)
dayboarder : n,통학생
daybook : n,업무일지
day boy : x,통학생
daybreak : n,새벽,동틀녘
day by day : a,날마다의,매일의
day camp : x,주간에만 하는 어린이를 위한 캠프
day care : x,데이케어(미취학 아동,고령자 신체장애자 등을 주간만 돌봐주는 일)
day care : a,vt,(취학 전의 아이를 맡는)주간 탁아소의,보육의,(취학 전의 아이를)탁아소(보육원)에 맡기다
daycare center : x,보육소,탁아소
day clean : n,(카리브,서아프리카)새벽,이른아침
day coach : x,침대차와 구별하여)보통 개차
daydream : n,백일몽,공상에 잠기다
daydreamer : n,공상가
day fighter : x,주간 전투기
day flower : n,피었다가 그날 시드는 꽃,(식)자주달개비
dayfly : n,하루살이
day girl : x,(영)(기숙제 학교의)여자 통학생
day glow : n,(기상)주간 대기광
day hospital : x,주간 병원,외래 환자 전용 병원
day in court : x,(법)법정 출두일,자기 주장을 말할 기회
day labor : x,날품
day labourer : x,날품팔이
dayletter : x,주가니 완송 전보(요금이 쌈)
daylight : n,일광,낮,주간(born daylight 쓸데없는 짓을 하다)
daylight blue : x,주광색,주광색 채료(안료)
daylight lamp : x,주광등
daylight robbery : x,백주의 강도,공공연한 도둑 행위,터무니없는 대금(청구),바가지 씌우기,폭리
daylight saving : x,일광 절약(이용)(여름에 시계를 1시간 앞당겨 낮을 많이 이용하는 제도)
daylight saving thme : x,하기 일광 절약 시간
day lily : x,(식)원추리속의 총칭(백합과),옥잠화속의 총칭
daylong : a,온종일
daymark : n,(공)주표,주간 항공 표지
daymode : x,(미)주간 모드(사람이 주간에 활동하고 밤에는 잠자는 상태)
day nurery : x,탁아소
Day of Atonement : x,(=YOM KIPPUR)
day off : x,비번,휴일
Day of Judgment : x,최후 심판의 날
Day one : x,최초의 날
day owl : x,주행성 올빼미
day pack : x,당일치기 하이킹,캠프용의 배낭(룩색)
day part : x,(방송국 네트워크의)하루의 방송 시간 구분
day release : x,(영)연수 휴가 제도(종업원에게 대학 다닐 낮시간을 허락해 주는 일)
day return : x,(영)당일 통용의(할인)왕복 요금(표)
day room : x,기지,공공 시설 내의 오락실
days : ad,(미)(언제나)낮에(는)
day sailer : n,(침구의 설비가 없는)소형선(요트의 일종)
day scholar : x,(기숙제 학교의)통학생
day school : x,boarding school에 대한 통학 학교,주간 학교
day shift : x,근대 근무의 낮 근무
day side : x,(천)햇빛을 받는 행성(달)의 반구,낮이 되는 쪽
day side : n,(신문사의)석간 요원,주간 근무자
daysman : n,중재인,조정자,일용근로자,날품팔이꾼
days of grace : x,(어음 등의 기한 직후의)지불 유예 기간(보통 3일간)
day spring : n,(=DAWN)
day star : n,샛별,(시)낮의 별(태양)
day student : x,(기숙제 학교의)통학생
day taler : n,(=DATALLER)
day ticket : x,(영)당일 통용의 할인 왕복표
daytime : n,낮,주간
day to day : a,나날의,그날 벌어 그날 사는
Dayton : n,데이튼(Ohio주 남서부의 도시)
day trader : x,(증권)당일 매매만을 하는 투기가
day tripper : n,당일치기 여행자
daze : vt,n,현혹시키다,멍하게 하다,눈이 부시게 하다,현혹,얼떨떨한 상태
dazedly : ad,눈이 부셔,멍하니
dazibao : n,(중공의)대자보
dazzle : vt,눈이 부시다,현혹하다
dazzle paint : x,미채,위장
dazzling : a,눈부신
Dday : n,공격 개시 예정일,행동 개시 예정일
deaccession : vt,n,(작품,수집품의 일부를 다른 작품을 구입하기 위하여)매각(처분)하다,매각,처분
deacon : n,집사,부제
deaconess : n,(기독교의)여자 집사,(기독교의)자선 사업 여성 회원
deaconry : n,DEACON의 직,집합적 DEACON들
deacquisition : n,처분 예정의 수집품,수집품의 처분(매각)
deactivate : vt,해산하다,활성을 잃게 하다
dead : 죽은,무감각한,활기없는,지쳐버린,쓸모없이된,완전한,확실한,아주,완전히,몹시,죽은 사람,가장  생기가 없는	시각,죽은 듯이 고요함
deadalive : a,기운 없는,불경기의
dead angle : x,사각
dead attractive : x,(미)잘생긴,미남인
dead beat : x,지친(exhausted)
deadbeat : 흔들리지 않는,제 눈금에  딱서는,외상,빚등을 데먹는 사람,게으름뱅이,식객
deadborn : a,사산의
dead caln : x,죽은 듯이 고요함,무풍
dead cat : x,서커스의 전시용사자,범,신랄한 비판
dead center : x,(크랭크의)사점,(선반의)부동 중심,정확한 중심
dead certainty : x,절대 확실한 것
dead color : x,(유화의)바탕칠
dead drop : x,(스파이의)연락용 정보의 은닉
dead duck : x,가망없는 자(것)
deadee : n,(사진을 보고 그린)고인의 초상화
deaden : vt,vi,약하게 하다,둔하게  하다,무감각하게	하다,소리를  없애다,죽다,약해지다,둔해지다
dead end : x,막다른 데
deadend : a,막다른,빈민가의
deadening : n,방음재,방음장치,무광(택)도료,(미)(나무를 고사시켜)개간한 토지
deadeye : n,명사수,세 구멍 도르래,명사수
deadfall : n,무거운 물체를  떨어뜨려 동물을 눌러 잡는 올가미,서로 엉켜 쓰러진
dead fire : x,(=ST.ELMO'S FIRE)
dead forms : x,허례
dead freight : x,(상)공하 운임
dead ground : x,사각,완전 잡지
dead hand : x,(법)(=MORTMAIN),(현재 생존자에 대한)과거(죽은 자)의 압박감,(병리)레이노 현상(병)(손,손가락등이 희게 되는 증상)
deadhead : n,무료 입장자,무임 승객,멍청이,비어서 가는 차
dead heat : x,팽팽한 접전
deadhouse : n,임시 시체 안치소
dead language : x,사어(라틴,고대 그리스어 따위)
dead letter : x,배달 불능의 우편,버버령 따위의 공문
dead letter box : x,(=DEAD DROP)
dead lift : x,(기계를 쓰지 앞고)바로 들어올리기,(고)필사적 노력(을 요하는 일,상황)
deadlight : n,현창 안 뚜껑(침수나 불빛이 새는 것을 막음),채광창
deadline : n,마감 시간,사선
deadline diplomacy : x,기한부 외교(시간을 정해 놓고 문제를 해결하려는 외교적 절충)
deadliness : n,치명적임,집념이 강함,맹렬함
dead load : x,정(사)하중,자중,자체중량
dead loan : x,회수 불능 대출금
deadlock : n,막힘,정돈
dead loss : x,전손
deadly : a,ad,치명적인,죽음 같은,심한,용서 할수 없는,주검처럼,몹시
deadly nightshade : x,(식)(=BELLADONNA)
deadly sins : x,(지옥에 떨어지는)칠대 죄악(오만,탐욕,색욕,화냄,대식,선망,나태)
dead man : x,죽은 사람,(연회가 끝난 뒤의)빈 술병,(영)허수아비
dead man's float : x,엎드려 뜨기(양 팔을 옆으로 뻗고 엎드린 자세)
deadman's hand : x,(미)(포커에서)에이스 2매와 8짜리 2매가 있는 패,불운,불행
deadman's handle : x,(기)손을 떼면 동력이 멈추는 비상 제어 장치
dead march : x,특히 군대의 장송 행진곡
dead marine : x,빈 술병
dead matter : x,무기물
deadness : n,죽음(의 상태),생기 없음,무감각,(광택,빛 등의)칙칙함,(술 등의)김빠짐
dead nettle : x,(식)광대수염
deadon : a,바로 그대로의,완전하게 정확한
deadonarribal : n,병원에 도착하였을 때 이미 사망한 환자,(전자)처음 사용 때 작동하지 않는 전기 회로)
deadpan : n,a,vi,무표정한 얼굴,무표정한,무표정한 얼굴을 하다
dead pedal : x,(미)느리게 운전하는 차,서툴러서 신중한 드라이버
dead pigeon : x,가망(쓸모)없는 사람
dead point : x,(=DEAD CENTER)
dead pull : x,(=DEAD LIFT)
dead reckoning : x,(해,공)추측 항법,(일반적으로)추측,추정
dead ringer : x,똑같이 닮은 사람(물건),대역
dead room : x,무향실(음향의 반사를 최소로 한 방)
Dead Sea : x,사해
Dead Sea apple : x,(=APPLE of Sodom)
dead season : x,사교,거래 등이 한산한 계절
dead set : x,사냥개가 사냥감을 가리키는 부동의 자세,맹공격,끈질긴 노력
Dead Set Scrolls : x,사해 문서(사본)(사해 북서부 동굴에서 발견된 구약 성서 등을 포함한 고문서의 총칭)
dead shot : x,사격의 명수
deadsmooth : a,매우 매끄러운,매우 매끄럽게 움직이는
dead soldier : x,빈 술병,(미)똥
dead space : (생리)사강(비강에서 폐포까지의 호흡기계 중 혈액이 가스대사를 하지 않는 부분),(건)소용이 없는 공간(기둥 둘레 등),사계,사각(사격할 수 없는 지역)
dead spot : x,라디오의 난청지력
dead stick : x,팔다 남은 물건,농기구
deadstick landing : x,(공)프로펠러 정지 착륙(엔진을 끄고 내리는 불시착)
dead stock : x,팔리고 남은 상품,사장 재고,(가축에 대해)농구
deadstraight : ad,a,일직선으로(의)
dead time : x,(전자)부동시간,불감 시간(지령후 작동하기까지의)
dead wall : x,창 따위가 없는 평벽
dead water : x,괸물,갇힌 물
dead weight : x,차량의 자중
deadweight capacity : x,(해)재화 중량 톤수
deadweight ton : x,중량톤(2240파운드)
dead wind : x,역풍,맞바람
deadwood : n,죽은 나무,무용지물
deaf : a,귀머거리의,들으려 하지 않는
deafaid : n,(영)보청기
deaf and dumb : n,농아의,농아자(용)의,
deafen : vt,귀먹게 하다,큰 소리를 줄이다
deafening : a,n,귀청이 터질듯한,방음 장지
deafmute : n,벙어리,농아자
deafmutism : n,농아 상태
deafness : n,귀먹음,귀를 기울이지 않음
deaf nut : x,인이 없는 견과,무가치한 일
deakbound : a,앉아서 일하는,책상에 얽매인,(전시에)비전투원인
deal : vt,vi,n,나누다,베풀다,도르다,주다,가하다,거래하다,장사하다,소나무재목,분량,카드놀이의 패 도르는 일,한 판
deal : n,소나무 재목(판자),전나무 재목
dealcoholize : vt,(술의)알코올분을 제거하다
dealer : n,상안,패도르는 사람,어떤 특정의 행동을 하는 사람
dealership : n,상품 총판권
dealing : n,취급,관계,교제
dealt : v,deal의 과거분사
deambulation : n,산책,(산책과 같은)가벼운 걷기 운동
deambulatory : a,n,(=AMBULATORY)
deAmericanization : n,비(탈)미국화
deAmericanize : vt, 비(탈)미국화하다,...에 대한 미국의 관여를 적게 하다
dean : n,사제장,대학의 학장
dean's list : x,(미)(학기,학년말의)대학 우등생 명단
deanery : n,DEAN의 직(지위,임기),DEAN의 관구
deanship : n,dean의 직(직위,임기)
dear : a,n,ad,int,친애하는,귀여운,귀중한,비싼,사랑하는 사람,귀여운 사람,애인,사랑스레,비싸게,어머나,참,아니 그런데
dearie : n,(=DEARY)
Dear John letter : x,(편지 서두의 Dear John에서),(병사에게 부친 아내의) 이혼 요구서,(애인,약혼자가 보낸)절연장,(일반적으로)절교장
dearly : ad,대정 깊이,비싸게
dear money : x,고금리 자금,고리채
dearness : n,값비쌈,고가,귀중함,귀여움,사랑스러운 성질,친애의 정
dearth : n,결핍,부족,기근
deary : n,=DARLING
death : 사망,죽음,소멸,사인,사신,죽음이 가깝다,에 능하다,을 아주 좋아하다,의 사인이 되다,...을 주다
death adder : x,(오스트레일리아산)독사의 일종
death agony : x,죽음의 고통
deathbed : n,임종,죽음의 자리
death bell : x,임종을 알리는 종
death benefit : x,(생보)사망 급부금
deathblow : n,치명적 타격
death cell : x,사형수 감방(독방)
death certificate : x,사망 진단서(확인서)
death chair : x,=ELECTRIC CHAIR
death chamber : x,사형실,임종의 방
death cup : x,과리 버섯속(독버석)
deathday : n,사망일,기일
deathdealing : a,치명적인,죽음을 초래하는
death duty : x,상속세
death education : x,죽음에 관한 교육(죽음 및 죽음에 관한 문제들을 다루는 교육)
death fire : x,도깨비불(죽음의 징조)
deathful : a,죽음의,죽음과 같은,치명적인
death house : x,사형수 감방
death instince : x,죽음의 본능
death Knell : x,조종,죽음(종언)의 전조,종결(폐지)을 재촉하는 것
deathless : a,불사(불멸,불후)의 영구한,deathly,ad,deathness,n
deathlike : a,죽음(죽은 사람)과 같은,죽은 듯한
deathly : a,ad,(DEATHLIKE),치사의 치명적인,잔인한,(시)죽음의(침묵 등),죽은 듯이
deathmask : n,사면,데스마스트
death penalty : x,사형
deathplace : n,사망지
death rate : x,사망률(mortality)
death rattle : x,임종 때의 꼬르득 소리
death ray : x,살인 광선
deathroll : n,과거장,사망자 명단
death row : x,(한 줄로 늘어선)사형수 감방
death sand : x,죽음의 재(radioactive dust)
death sentence : x,사형 선고
deathshead : x,해골
death squad : x,(중남미등의 군사정권에서의 경범죄자,좌파 등에 대한)암살대
death tax : x,(미)상속세
death throes : x,죽음의 고통
death toll : n,사망자 수
deathtrap : n,위험한 장소,화재 휘험이 있는 건물
Death Valley : n,데스 밸리,죽음의 계곡
death warrant : x,사형 집행 명령
deathwatch : n,경야,임종의 간호
death wish : x,(심)죽고 싶은 생각,남이 죽었으면 하는 마음,환각제
deautomatization : n,탈 자동화
deb : n,(=DEBUTANTE),(미)거리를 배회하는 불량 소녀
debacle : n,사태,붕괴,괴멸
debag : vt,(장난 벌로서)바지를 벗기다,정체를 폭로하다
debar : vt,저지하다,제외하다
debark : vt,(나무의)껍질을 벗기다
debarkation : n,양륙,상륙
debase : vt,(품성,품질 따위를)저하시키다,저하된,야비한
debatable : a,이론의 여지가 있는
debatable ground : x,자칫 문제가 일어나기 쉬운 국경 지대,논쟁점
debate : n,vt,vi,토른,논쟁,숙고,토론회,토론하다,숙고하다)
debater : n,토론가,토의자
debating society club : x,토론회
debauch : vt,n,타락시키다,우혹하다,퇴폐시키다,방탕,난봉
debauched : a,타락의,우혹의,퇴페의
debauchee : n,난봉꾼
debauchery : n,방탕,유혹
debauchment : n,방탕
debby : n,(=DEBUTANTE)
Debby : n,여자이름
debenture : n,사채
debenture bond : x,무담보 사채권
debenture stock : x,사채권
debilitate : vt,쇠약하게하다
debilitation : n,쇠약,허약(화)
debility : n,쇠약
debit : n,vt,차변(에 기입하다)
debit card : x,(은행 예금에서 직접 인출할 수 있는 크레디트 카드(은행이 고객에게 발행
debonair : a,사근사근한,점잖고 쾌활한
deboost : n,(우주선 따위를)감속
Deborah : n,여자 이름,(성)데보라(이스라엘의 여자 예언자)
debouch : vi,(좁은 곳에서 넓은 곳으로)진출하다
debouche : n,(요새 등의)진출구,출구,(상품의)판로
Debrett : n,디브렛(영국 귀족 연감)
debridement : n,(외과)(상처에서의)이물질,괴사조직제거
debrief : vt,(귀환 비행사등으로 부터)보고를 듣다
debris : n,파괴의 자취,쓰레기
debt : n,부채,빚,의리,은혜,죄(be in bad debt 빚이 있다)
debt collector : x,(영)빚 수금 대행업자
debt financing : x,채권 금융(공채,사채등 채권 발행에 의한 자금 조달)
debt limit : x,채무 한도액,채부 한계
debtor : n,꾼 사람,차주채무자,차변
debtor nation : x,채무국
debuchment : n,군대의 진출,하구
debug : vt,~에 해충을 제거하다,잘못을 제거하다,잘못을 찾아 정정하다
debugging : n,(전산)디버깅(프로그램의 잘못을 찾아내어 수정하기)
debunk : vt,정체를 폭로하다
debus : vt,vi,(주로 차)(자동차,버스,트럭에서)내리다
Debussy : n,프랑스의 작곡가
debut : n,첫출연,사교계에의 첫발,데뷔,처음사교계에 나도다,첫무대를 밟다,초연하다
debutant : n,처음으롱 사교계에 사선 사람,첫무대를 밟는 사람
debutante : n,DEBUTANT의 여성형
decadal : a,10(년간)의
decade : n,10년간,10,10개
decadence : n,쇠미,퇴미
decadency : n,쇠미,퇴폐
decadent : a,n,쇠비한,(19세기말 프랑스의 퇴페파의 예술가)
decadent : a,쇠미한
decaf : n,카페인을 제거한(줄인)커피(콜라 등)
decaffeinate : vt,(커피 등에서)카페인을 제거하다(줄이다)
decagon : n,십각형
decagonal : a,
decagram : n,10그램,데카그램
decahedral : a,(수)10면체의,10면이 있는
decahedron : n,십면체
decal : n,vt,(=DECALCOMANIA),(도안,그림 등을)전사하다
decalcify : vt,석회질을 제거하다
decalcomania : n,전사술(도기,목제품 따위에 무늬 넣는 법)전사화
decaliter : n,10리터
Decalogue : n,십계
Decameron : n,데카메론
decameter : n,10미터
decametric : a,(통신)고주파 무선의(1-10 데카미터의 주파수대의)
decamp : vi,도망치다,야영을 걷어 치우다,진을 거두고 물러나다
decanal : a,DEAN(직)의,성당의 남쪽(성가대)의
decani : a,(찬송가의 교창에서)남쪽 성가대가 노래해야 할
decant : vt,욕액 따위의 웃물을 딴 그릇에 가만히 옮기다
decantation : n,(웃물을)간만히(찬찬히)붓기
decanter : n,경사기,식탁용의 마개 달린 유리 술병
decapacitate : vt,(생리)(정자의)수정 능력을 없앤다
decapacitation : n,(생리)(정자의)수정 능력 제거
decapitate : vt,해고하다,~의 목을 베다
decapitation : n,목베기,해고,파면
decapitator : n,목베는 사람,(미)해고(파면)하는 사람
decapod : n,십각류의 동물
decarboaization : n,탄소 제거,탈 탄소
decarbonate : vt,...에서 이산화탄소를 제거하다.decarbonator,n
decarbonation : n,
decarbonize : vt,(엔진의 실린더 벽 등의 탄소를 제거하다
decarburize : vt,(=DECARBONIZE),탈탄하다
decare : n,데카르(10아르,1,000평방미터)
decarock : n,(=GLITTERROCK)
decartelization : n,(경)기업 집중 배제,카르텔 해체
decartelize : vt,카르텔을 해체시키다
decastere : n,10입방 미터
decasualize : vt,(임시 근로자의)고용을 중지하다,상시 고용화하다
decasyllabic : a,10음절
decasyllable : n,10음절
decathlete : n,10종경기 선수
decathlon : n,10종경기
decatholicize : vt,카톨릭적 성질을 제거하다
decay : vi,n,썩다,부패하다,쇠미하다,부패,쇠미
Deccan : 데칸  반도(인도 Narbada강  이남의 지역),데칸고원(데같  반도의 배반을 차지하는 고원)
decease : n,사망,죽은,사망하다
deceased : a,죽은,고(the deceased 고인)
decedent : n,고인
decedent estate : x,(미 법)유산
deceit : n,사기,허위,거짓,거짓의
deceitful : a,거짓의
deceivable : a,속이기 쉬운
deceive : vt,속이다,미혹시키다(deceive oneslf 잘못 생각하다)
deceiver : n,사기꾼
deceivingly : ad,거짓으로,속여서
decelerate : vt,감속하다
deceleration : n,감속,감속도
deceleration lane : x,(미)(고속 도로의)감속차선
December : n,12월
decemvir : n,(로마사)10대관의 한 사람,10인 위원회의 한 사람
decemvirate : n,(로마사)10대관의 직(기간),십두 정치
decency : n,체면,예의,점잖음,체면상,예의 범절,보통의 살림에 필요한 물건
decennary : n,a,10년간,10년간의
decenniad : n,(=DECENNIUM)
decennial : a,10년간의,10년제
decennium : n,10년간
decent : a,적당한,어울리는,관대한,친절한
decently : ad,볼썽사납지 않게,괜찮게,품위 있게,점잖게,상당히,제법,친절하게,
decentralization : n,분산,집중 배제,지방 분권화
decentralize : vt,분산하다
deception : n,속임,속은 상태,야바위
deceptive : a,속임의,미혹케 하는
decertify : vt,...의 증명(인가)을 취소(철회)하다
decey : a,위험한,아슬아슬한,불확실한
dechristianize : vt,...의 기독교적 특질을 잃게 하다
deci : pref,10분의 1의 뜻
deciare : n,데시아르
decibar : n,(기상)0.1바
decibel : n,데시벨,전압,늠향 측정 단위
decidable : a,결정할 수 있는 
decide : vt,vi,결정하다,해결하다,결심시키다,결심하다,결정하다
decided : a,뚜렷한,명백한,단호한
decidedly : ad,확실히,단호히
decider : n,결정(재결)자,결승 경기
deciding : a,결정적인,결승(결전)의
deciduous : a,탈락성의,낙엽성의
deciduous teeth : x,배냇니,젖니
decigram : n,데시그램
decile : n,십분위수
deciliter : n,데시리터
decillion : n,(영,독일)백만의 10제곱,(미,프랑스)천의 11제곱
decimal : a,십진법의,소수의
decimal arithmetic : x,십진산,소수산
decimal classification : x,도서의 십진 분류법
decimal coinage : x,통화 십진제
decimal currency : x,십진제 통화
decimal fraction : x,소수
decimalization : n,십진법화,십진법 채용
decimalize : vt,십진법으로 하다
decimally : ad,십진법으로,소수로
decimal notation : x,십진 기수법
decimal place : x,소수 자리
decimal point : x,소수점
decimal system : x,십진법
decimate : vt,(질병,전쟁 따위가)많은  사람을 죽이다(고대 형법에서)열명에 하나씩 죽이다
decimation : n,다수의 인명을 앗음
decimeter : n,데시미터
decimviral : a,(로마사)10대관의,10인 위원의
decipher : vt,번역하다,암호를 풀다
decision : n,결정,해결,판결,결심
decisionmaker : n,(정책 등의)의사 결정자
decisionmaking : a,(정책,원칙 등을)결정하는
decision support system : x,(전산)(경영의)의사 결정 지원 시스템
decision table : x,의사 결정표(모든 조건과 필요한 행동을 표시하는 일람표)
decision tree : x,의사 결정 분지도(전략,방법 등을 나뭇가지 모양으로 그린 것)
decisive : a,결정적인,움직이기 어겨운,단화한,확고한
decisive ballot : x,결선 투표
decisive evidence proof : x,결정적 증거,확증
decistere : n,데시스테르(10분의 1 스테르)
deck : n,vt,갑판,평평한 지붕,지면,전투 준비를 하다,갑판에 나와서,준비되어,다음 타자가 되어,갑판을 깔다,꾸미다,단장하다
deck boy : x,갑판(청소)원
deck bridge : x,상로교,노선교
deck cabin : x,갑판 선실
deck cargo : x,갑판에 싣는 짐
deck chair : x,갑판 의자
deckel : n,(=DECKLE)
decker : n,갑판 선원,...층의 갑판이 있는 함선(버스),장식자(물)
deck gand : x,갑판원,평선원,무대 계원(장치,조명 따위의)
deckhand : n,갑판원,평선원
deckhouse : n,갑판실
deckle : n,뜸틀(종이의 판형을 정하는),(=DECKLE EDGE)
deckle edge : x,(손으로 뜬 종이의)도련하지 않은 가장자리
deck load : x,(해)갑판 적재 화물
deck log : x,갑판부(항해)일지
deckman : n,덱맨(윈치 작업의 하역 지휘자)
deck officer : x,갑판부 사관
deck passage : x,갑판 도항
deck passenger : x,3등 선객
deck quoits : x,(갑판 위에서 밧줄(고무)고리로 하는)고리던지기 놀이
deck tennis : x,덱테니스(갑판에서 네트를 사이에 두고 작은 밧줄 고리를 치고 받음)
declaim : vi,(미사어구를 늘어놓아)연설하다,열변을 토하다,(극적으로)낭독하다
declamation : n,낭독법,연설법
declamatory : a,낭독의,연설조의
declarable : a,선언(언명)할 수 있는,밝힐(증명할)수 있는,(세관에서)신고해야 할
declarant : n,(법)신고인,원고,(미)미국 귀화 신청(선서)자,(=DECLARER)
declaration : n,선언,포고,신고,미국 독립 선언(1776년 7월 4일)
declarative : a,선언하는,단언적인,서술적인
declarative sentence : x,평서문
declaratory : a,선언(신고)의,진술(단정)적인
declare : vt,vi,선언하다,언명하다,신고하다,공언하다,성명하다,언명해 놓고 그만두다,해약하다)
declared : a,공언한,숨김 없는,공공연한
declaredly : ad,공공연하게
declarer : n,선언(단언)자,신고자,(특히 카드놀이에서)디클레어러,분명히 밝히는 사람(것)
declass : vt,...의 계급을 낮추다,사회적 지위(신분)를 낮추다
declasse : n,몰락한 사람
declassed : a,(=DECLASSE)
declassification : n,비밀 취급의 해제(서류,암호 등의)
declassify : vt,기밀 취급을 해제하다,기밀 리스트에서 빼다
declension : n,쇠미,경사,기욺
declinable : a,(문법)어형 변화가 되는,격변화가 있는
declinate : a,(꽃 등이)아래로 구부러진(기운)
declination : n,경사,쇠미,사퇴,편차,편각
decline : vi,n,기울다,아래로 향하게 하다,사퇴하다,쇠하다,겨변화하다,경사,기욺,물가의 하락,쇠비,쇠약병,늘그막,기울어,쇠하여)
decliner : n,사퇴자
declining : a,기울어,쇠하여
declinometer : n,방위각계,자침 편차계
declivitous : a,내리받이의
declivity : n,하향,내리막
declivous : a,기운,아래로 향한,내리받이의
Declomycin : n,데클로마이신(광범위 항생 물질의 일종)
declutch : vi,(영)(자동차의)클러치를 풀다
decoct : vt,달이다,달인 약
decoction : n,달이기,달인 즙
decode : vt,암호를 풀다
decoder : n,암호 해독자,자동 암호 해독 장치,아군 식별 장치,해독기
decoding : n,(전산)디코딩(코드화된 데이터 명령을 처리 가능하도록 해독하기)
decoke : vt,(=DECARBONIZE)
decollate : a,어깨와 목을 드러낸
decollation : n,참수,(종)성도 참수화
decollator : n,목베는 관리,망나니
decolletage : n,목덜미와 어깨를 드러냄,목둘레를 깊이 판 네크라인
decollete : a,목덜미와 어깨를 드러낸,데콜테옷을 입은,(여성의 야회복)
decolonization : n,
decolonize : vt,(식민지에)자치(독립)를 부여하다,비식민지화하다
decolor : vt,탈색하다
decolorant : n,표백제
decolorization : n,탈색,표백,
decolorize : vt,(=DECOLOR)
decommission : vt,취역을 해제하다
decommunization : n,
decommunize : vt,비공산화하다
decompensation : n, 보상 작용의 상실,(의)(심장의)대상 부전(호흡 곤란 등)
decompose : vt,분해(분석)할 수 있는
decomposer : n,분해하는 사람(것),(생태)분해자(박테리아,균류 등)
decomposite : n,a,복(재)혼합된,복(재)혼합물
decomposition : n,분해,해제,부패,변질
decompound : vt,분해하다,(고)혼합물과 배합하다
decompress : vt,vi,에어록으로 압력을 감소시키다,감압하다,(의)(기관,부위의)압박을 완화하다,감압되다
decompression : n,감압
decompression chamber : x,감압실,기압 조정실
decompression sickness : x, (병리)잠함병,
decompressor : n,감압 장치
deconcentrate : vt,(중앙 집중에서)분산시키다,(경제력의)집중을 배제하다
deconcentration : n,분산,(경제력의)집중 배제
decongestant : n,(특히 코의)충혈 완화제,소염제
decontaminant : n,오염 제거 장치,정화제
decontaminate : vt,정화하다,오염을 제거하다
decontamination : n,오염,정화
decontrol : vt,n,~의 통제를 해제하다,통제 해제
decor : n,장식
decorate : vt,꾸미다,장식하다,훈장을 수여하다
decorated : a,훌륭하게 꾸민,장식된,훈장을 받은,(건)장식식의
decoration : n,장식,장식품,훈장,서훈
Decoration Day : x,(미)현충일
decorative : a,장식적인
decorator : n,실내 장식업자
decorous : a,예의바른,점잖은
decorticate : vt,...의 (나무) 껍질을 벗기다,(의)(뇌 등의)피질을 제거하다
decorum : n,(태도,말,복장 따위의)고상함,예의바름
decoupage : n,오려낸 종이 쪽지를 붙이는 그림(의 기법)
decouple : vt,감결합하다(전기의 유해한 귀환 작용을 덜기 위하여 회로의 결합도를 낮춤)
decoupling : n,(지하 핵폭발로)충격을 흡수(완화)하기
decoy : n,유혹물,미끼새,꾀어들이다,유인하다
decoy bird : x,(사냥)후림새,매조
decoyduck : n,후림오리,미끼 구실하는 사람
decoy ship : x,(=QBOAT)
decrease : n,vi,vt,감소,줄다,저하하다
decreasing : a,감소하는,점점 주는
decreasingly : ad,점점 줄어(감소하여),점감적으로
decree : n,vt,법령,포고,명영,판결,명하다,포고하다,정하다
decree nisi : x,이혼의 가판결
decrement : n,감소
decremeter : n,(전)감폭계
decrepit : a,노쇠한
decrepitate : vt,vi,(소금 등)바작바작 소리나게 굽다(구워지다)
decrepitation : n,
decrepitude : n,노쇠,노후
decresc, : x,(=decrescendo)
decrescendo : ad,점점 여리게
decrescent : a,이지러지는,하현의,점감하는
decretal : n,로마 교황 교서
decretist : n,교회법 학자
decretive : a,(=DECRETAL)
decrial : n,비난,중상
decrier : n,비난자
decriminalization : n,
decriminalize : vt,해금하다,(사람,행위를)기소(처벌)대상에서 제외하다
decruit : vt,(고령자 등을0다른 회사(낮은 부서)로 배치 전환하다,decruitment,n
decry : vt,비난하다,헐뜯다
decrypt : vt,(암호를)해독(번역)하다
decuman : a,열번째의,(파도가)거대한
decumbency : n,드러누움,땅 위로 뻗음
decumbent : a,드러누운,가로누운,(식)(가지,줄기가)땅 위로 뻗은
decumulate : vt,(축적된 것을)줄이다,까먹어 없애다,decumulation,n
decuple : a,vt,10배(의),10배로 하다
decurrent : a,(식)(잎이)줄기 아래로 뻗은
decussate : vt,vi,a,X자 꼴로 교차하다,직각으로 교차한,X자꼴의,(식)십자 대생의
decussation : n,X자 꼴(십자형)교차
ded, : x,dedicated,dedication
dedal : a,(=DEADAL)
Dedalian : a,(=DAEDALIAN)
dedans : n,(테니스 코트의)서브측 뒤의 관람석
dedicate : vt,봉납하다,바치다,증정하다
dedicated : a,(이상,정치,목표 등에)일신을 바친,(장치 등)오로지 특정한 목적을 위한,전용의
dedicatee : n,헌정받는 사람
dedication : n,바침,헌신,헌정
dedicative : a,(=DEDICATORY)
dedicator : n,봉납자,헌정자,헌신자
dedicatory : a,봉납의,헌상의
deduce : vt,추론하다,연역하다,...의 유래를 캐다
deducible : a,추론할 수 있는
deduct : vt,빼다,할인하다
deductible : n,
deduction : n,뺌,공제,추정
deductive : a,추론의,연역적인
dee : n,D자,D자형,마구고리,(사이클로트론의)반원형 전극
deed : n,행위,행동,실행
deedbox : n,(중서 등의)서류 보관함(금고)
deed poll : x,(법)(당사자의 한쪽만이 작성하는)단독 날인 증서
deejay : n,=DISK JOCKEY
deem : vt,생각하다,~로 간주하다
deemphasize : vt,덜 강조하다,중요성을 깎아내리다
deemster : n,(영구 the Isle of Man의)재판관,판사
deep : 깊은,심원한,깊이 파묻힌,몰두해 있는,,목소리가 굵고 낮은,색이 짙은,심한,마음으로부터의,음험한,속검은,깊이 ,깊숙이,늦게,깊은 곳,심연
deepbrowed : a,이마가 넓고 시원한(지성을 나타냄)
deepchested : a,가슴이 두툼한,낮고 힘센
deep cover : x,(첩보원 등의 신분 소재의)은폐,위장,극비로 하기
deepcover : a,극비의
deepdish : a,(요리)운두가 높은 접시로 구운(파이 등)
deepdrawn : a,크게 들이 쉰(한숨 등)
deepdyed : a,짙게 물든,순전한,악에 깊이 물든
deepen : vt,깊게 하다,깊어지다,짙게하다
deepfelt : a,강하게 느낀,감명깊은
Deepfreeze : n,급속냉동
deepfried : a,기름에 튀긴
deepie : n,입체 영화
deep kiss : x,혀 키스
deeplaid : a,교묘히 꾀한
deeply : ad,깊이,짙게,(음조가)굵고 낮게,철저히,심각하게
deepmined  : a,깊은 갱에서 캐낸
deep mourning : x,정식 상복,깊은 애도
deepmouthed : a,(사냥개의 짖는 소리가)낮고 굵직한
deepness : n,깊이,심도,현묘,오묘,심오
deepread : a,학식이 깊은
deeprooted : a,깊이 뿌리 박힌,뿌리 깊은
deepsea : a,원양의
deepsea fishery : x,원양 어업
deepseated : a,뿌리깊은
deepset : a,깊이 파인,(눈)뿌리 깊은
deep six : x,수장,해장,바다에 버리기,무덤
deepsix : vt,(배에서)바다로 내던지다,폐기하다
Deep South : n,(미국의)최남부 지방
deep space : x,태양계 밖의 우주
deep structure : x,심층 구조((변형)생성 문법에서 문장의 의미를 결정하는 심리적 실재로서의 기저 구조)
deep therapy : x,심부 X선 치료(주대상은 악성 종양)
deepthink : x,(미)극단적으로 학구적인 생각,탁상 공론
deep throat : x,(미,캐나다)내부 고발자,밀고자(특히 정부의 고관)
deepvoiced : a,목소리가 낮고 굵은
deepwater : a,깊은 물의,심해의
deer : n,사슴
deerhound : n,사슴 사냥개
deer lick : x,사슴이 소금기를 핥으러 오는 샘
deer mouse : x,흰발생쥐(북미산)
deer park : x,사슴 사냥터
deerskin : n,사슴 가죽
deerstalker : n,사슴 사냥꾼,사냥 모자
deerstalking : n,사슴 사냥
deescalate : vi,단계적으로 축소하는,a
deescalation : n,단계적 축소
deet : n,방충제의 일종
def : ad,(미)전적으로,정말(그래)
def, : x,defective,defendane,deferred,definite,definition
deface : vt,흠내다,표면을 손상시키다,흉하게 하다,defacer(),n
defacement : n,오손,파손,파손물
defacto : ad,사실상(의)
defalcate : vi,위탁금을 써 버리다
defalcation : n,(법)위탁금 유용,부당 유용액
defamation : n,중상,비방
defamatory : a,중상하는,비방하는
defame : vt,~의 명예를 손상하다,중상하다
defang : vt,...의 엄니를 뽑다
defat : 태만,부족,(경기 등에의)불출장,기권,의무를 게을리하다,채무를 이행하지 않다,(재판에)결석하다,(시합에)출장하지 않다,(의무,채무를)이행하지 않다,
defaudation : n,사취
default : n,태만,불이행,결석,결핍(udgment by default 결석 재판)
defaulter : n,불이행자,재판 결석자,위탁금 소비자
defeasance : n,폐기,파기
defeasibility : n,폐기(파기)가능성
defeasible : a,무효로 할 수 있는,해제(취소,폐기)할 수 있는
defeat : vt,n,격파하다,지우다,방해하다,무효로 하다,격파,타파,패배,과기
defeatism : n,패배주의
defeatist : n,a,패배주의자,패배주의(자)적인
defeature : vt,n,(=DISFIGRRE)
defecate : vt,맑게하다,맑아지다,뒤를 보다
defecation : n,깨끗하게함,(더어움,불순물의)배제,배변
defecator : n,정화기,여과 장치
defect : n,결함,결점,부족
defection : n,배반,변절,탈당,부족
defective : a,결점 있는,불완전한
defective verb : x,결여 동사(변화형이 결여된 call,may,must,shall,will 등)
defectology : n,결함(결점)연구,결함학
defector : n,탈주자,탈당자,배반자,망명자
defeminize : vt,여성다움을 없애다,남성화하다
defence : n,=DEFENSE
defend : vt,지키다,방위하다,변호하다
defendant : n,피고
defender : n,방어(옹호)자,(스포츠)선수권 보유자,(법)(=DEFENDANT)
defenestration : n,(사람,물건을)창밖으로 내던지기
defense : n,방위,수비,변명,변호,수비측,종심방어,...을  지키어,...을 변호하여
defenseless : a,무방비의
defense mechanism : x,자기 방위기제
defense spending : x,국방비,국방비 지출
defensibility : n,방어(변호)의 가능성
defensible : a,방어할 수 있는
defensive : n,수세,방위(be on the defensive 수세를 위하다)
defensive driving : x,(미)(경찰의)방위적 운전법,방어 운전(범인의 추적,체포에서)
defensive medicine : x,(의사의)자기 방어적 의료(의료 과오 소송을 피하려고 과잉 검사,진단을 지시하는 일)
defensive tactics : x,(미)(경찰의)호신술
defensory : a,(=DEFENSIVE)
defer : vt,늦추다,물리다,늦춰지다,연기하다,따르다
deferable : a,(=DEFERRABLE)
deference : n,복종,경의
deferent : a,수송(배설)의,수정관의,(=DEFERENTIAL)
deferential : a,공경하는,공손한
deferment : n,연기,천연,거치,(미)징병 유예
deferrable : a,연기할 수 있는,유예할 수 있는
deferral : n,(예산의)집행 연기
deferred : a,연기한,거치한
deferred annuity : x,거치 연금
deferred assets : x,이연 자산
deferred instinct : x,지발 본능
deferred insurance : x,거치 보험
deferred pay : x,(영)(사병의 급여중)거치 지불금(제대 또는 사망 때까지 보류하는)
deferred payment : x,연불
deferred savings : x,거치 저금
deferred sentence : x,(법)선고 유예
deferred share : x,(영)배당 거치주
deferred telegram : x,간송 전보(요금이 쌈)
defeudalization : n,봉건 제도 철폐
defeudalize : vt,...의 봉건제를 없애다,봉건적 성질을 제거하다
defiance : n,도전,반항,무시
defiant : a,도전적인,무례한,무시하는
deficiency : n,결핍,결함
deficiency disease : x,영야 실조,비타민 결핍증
deficiency payment : x,(영)(농산물 가격 안정)정부 보조금
deficient : a,결함 있는,불충분한
deficit : n,결손,부족액
deficit financing : x,(정부의)적자 재정(정책)
deficit spending : x,적자 지출
defier : n,도전자,반항자,무시하는 사람
defilade : n,vt,(군)차폐(하다)
defile : vt,더럽히다
defilement : n,더럽힘,오염
definable : a,한정할 수 있는,정의(설명)할 수 있는
define : vt,한계를 정하다,명확히 하다,정의를 내리다
defineable : a,정의할 수 있는,한정할 수 있는
definiendum : n,정의되는 것(사전의 표제어 등),정의되는 항
definiens : n,정의하는 것,정의(사전의 어의 설명 부분 등),(논)정의하는 항
definite : a,명확한,뚜렷한,일정한
definite article : x,(문법)정관사
definitely : ad,한정적으로,명확히,(강한 긍정,동의)확실히,절대로...아니다
definite policy : x,(보험)확정 보험 증권
definition : n,한정,정의,해석,선명도
definitive : a,결정적인,최종적인
definitive host : x,(생)종결(고유)숙주
definitude : n,명확성,정확성
deflagrate : vt,vi,갑자기 연소시키다(하다),확 타게 하다(타다)
deflagration : n,(화)폭연(작용)
deflate : vt,~에서 공기를 빼다,수축시킨다
deflation : n,공기를 빼기,통화 수축,디플레이션
deflationary : a,통화 수축적인,디플레이션의
deflationary spiral : x,(경)진행성 디플레이션
deflator : n,
deflect : vt,빗나가다,삐뚤어지게 생각하다
deflection : n,빗나감,비뚤어짐,치우침,(물)편향(계기 등의 바늘의)기움,(총알의)편차,(빛의) 굴절
deflective : a,편향적인,빗나가는,휘어진
deflector : n,변류기(기류,연소 가스 조절용),편침의(나침반 자차 수정용)
defloration : n,능욕,꽃을 땀,미를 빼앗음
deflower : vt,능욕하다,꽃을 따다
deflutition : n,(생리)삼킴,삼키는 작용
defocus : vt,vi,n,(렌즈 등의)초점을 흐리게 하다,초점이 흐려지다,초점이 흐려짐,흐리게 한 영상
Defoe : n,Daniel(1659~1731)영국의 소설가
defog : vt,(자동차의 유리 등에서)서린 김(물방울)을 제거하다
defoliant : n,고엽제(월남전에서 미군이 씀)
defoliate : vt,잎을 따내다,잎을 말리다,잎이 떨어지다
defoliation : n,낙엽,나무를 자르거나 숲을 불태우거나 하는 작전
deforce : vt,(법)(남의 재산을)불법으로 점유하다
deforest : vt,개척하다,산림을 베어내다
deforestation : n,산림 벌채(개척)
deform : vt,흉하게 하다,모양 없이 하다,불구로 하다
deformation : n,변형
deformative : a,DEFORM하는( 경향이 있는)
deformed : a,흉한,일그러진,불구의
deformity : n,불구,추함,결함
defraud : vt,편취하다,속이다
defray : vt,지불하다
defrock : vt,성직을 빼앗다
defrost : vt,서리를 제거하다,언 것을 녹이다
defroster : n,제상 장치
deft : a,솜씨 좋은,능숙한
deft, : x,defendant
defunct : a,소멸한,죽은
defunctive : a,고인의 장례식의
defuse : vt,신관을 제거하다,위험성을 없애다
defy : vt,도전하다,반항하다,거부하다,무시하다
deg, : x,degree,degrees
degage : a,편안한
degas : vt,가스를 제거하다
Degas : n,Edgar(1834~1917)프랑스의 화가
De Gaulle : n,드골(프랑스의 장군 대통령)
De Gaullist : x,드골파의 사람
degauss : vt,(선체,텔레비전 수상기 등을)소자하다
degender : vt,(말 등에서)성의 구별을 없애다
degeneracy : n,퇴보,타락,퇴화
degenerate : vi,나빠지다,퇴보하다,퇴보한,타락한
degeneration : n,퇴보,타락,악화
degenerative : a,타락의
deglitch : vt,...의 고장을 제거하다(고치다)
degradable : a,(화학적으로)분해할 수 있는
degradation : n,좌천,파면,저락,하락,퇴보
degradation : n,격하,좌천,면직,타락,저하,침식,분해
degrade : vt,하위로 낮추다,타락시키다
degraded : a,타락(퇴화)한
degrading : a,품위(자존심)를 떨어뜨리는,치사한,창피스러운
degrease : vt,~에서 유지를 빼다
degree : n,정도,눈금,지위,계급,학위
degree day : x,(대학의)학위 수여일
degreeday : n,도일(어느날의 평균 기온의 표준 온도와의 차)
degression : n,하강,(과세의)체감
degressive : a,체감적인
de haut en bas : a,ad,깔보는9태도로),무례한(태도로)
dehead : vt,(새우 등의)머리를 자르다(잡아떼다)
dehire : vt,(미)퇴직시키다
dehisce : vt,입을 벌리다,(씨껍질,과실이)터져 벌어지다,열개하다
dehiscence : n,(식)열개,터져 벌어짐
dehiscent : a,(식)열개성의
dehorn : vt,n,(미)뿔을 잘라내다,주정뱅이,취한
dehortation : n,말림,간언
dehotative : a,말리는,간언의
dehumanization : n,인간성 말살
dehumanize : vt,~의 인간성을 빼앗다
dehumidifier : n,제습기
dehumidify : vt,습기를 없애다,건조시키다
dehydrate : vt,탈수하다,수분이 없어지다
dehydration : n,탈수
dehydrofreezing : n,건조 냉동법
dehydrogenate : vt,(화)(화합물에서)수소를 제거하다
dehydrogenation : n,
dehydrogenize : vt,(=DEHYDROGENATE)
dehypnotize : vt,최면술을 풀다,최면 상태에서 깨어나게 하다
deice : vt,제빙하다
deicer : n,제빙장치
deicide : n,신을 죽임,신을 죽이는 사람
deictic : a,지시적인,직중적인
deific : a,신격화하는,신과 같은
deification : n,신으로 숭상함(섬김),신격화,신성시
deification : n,신성
deiform : a,신의 모습을 한,신 같은
deify : vt,신으로 삼다,신성시하다
deign : vi,~하옵시다,내리시다
Deigratia : ad,신의 은총으로
deil : n,(스코)=DEVIL
deindustrialization : n,(특히 패전국의)산업 조직의 파괴(축소)
deinstitutionalize : vt,비 제도화하다
deintegrate : vt,(기업의 종합경영을 그만두고)분산 전문 경영으로 하다
deintegration : n,비종합기업화
deionize : vt,(화)(물,기체 등의)이온을 제거하다
deism : n,자연신교
deistic : a,자연신교(도)의
deity : n,신성,신,여신,하느님
deja entendu : n,이미(듣고)안다는 느낌(인식)
dejalu : n,이미 읽은 적이 있다는 느낌(인식)
dejavu : a,달라진 것이 없는,이미 본,재탕의
deject : vt,a,...의 기를 꺾다,낙심(낙담)시키다,(고)=DEJECTED
dejecta : n,배설물,똥오줌
dejected : a,낙담한,기운 없는
dejection : n,낙담,실의
dejeuner : n,(특히,늦은)아침 식사,점심
dejure : a,합법의,정당한 권리로
dek- : x,(연결형)
dekko : n,(영)일별,엿봄
del, : x,delegate,delete
Del, : x,Delaware
Delacroix : n,Ferdinand Victor'Eugene(1798~1863)들라크루아(프랑스의 화가)
delaine : n,메린스,모슬린
delaminate : vi,vt,얇은 조각(층)으로 갈라지다(가르다),(생)엽렬하다
delamination : n,
Delaney amendment : x,(미)딜레이니 수정(조항)(발암성 식품 첨가물 등의 전면 금지법)
delate : vt,(고)고소하다,소문을 퍼뜨리다
delation : n,고소,고발
delator : n,고소인,밀고자
Delaware : n,미국동부의 주
Delawarean : a,n,델라웨어주의,델라웨어주의 사람
Delaware Water Gap : x,델라웨어협곡
delay : vt,늦게하다,지연시키다,연기하다,늦어지다,지체하다,지연,유예
delayed : a,뒤 늦은
delayedaction : a,지효성의,지발의
delayed neutron : x,(물)지발 중성자
delayed time system : x,(전자)시간 지연(축적)방식
delaying action : x,지연 전술
delay machine : x,(악기)딜레이 머신(음성 신호를 임의로 지연시켜 재생하는 장치
dele : vt,삭제하라
delectable : a,매우 즐거운,유쾌한
delectation : n,유쾌,환희,환락
delectus : n,(학습용)라틴(그리스)작가 발췌서(본),명문초
delegable : a,(직권 등이)대리인에게 위임할 수 있는
delegacy : n,대표단,대표자 파견
delegalize : vt,...의 법적 인가를 취소하다,비합법화하다
delegate : n,대표자,사절,위임하다
delegated legislation : x,(영국 의회의)위임 입법
delegation : n,파견,위임,위원단
delete : vt,n,삭제하다,지우다,삭제
deleterious : a,해로운,유독한
deletion : n,삭제,삭제 부분
delf : a,네덜란드의
delftware : n,델프 도자기
Delhi : n,델리(인도 북부의 연방 직할주,그 주도,Mogul제국의 옛 수도,원래 영국의 인도 정청 소재지)
Delhi belly : x,여행자의 인도 설사
deli : n,(미)=DELICATESSEN
Delia : n,여자이름
deliberate : vt,숙고하다,협의하다,신중한,유유한
deliberately : ad,신중히,고의로,일부러,찬찬히,유유히
deliberateness : n,심사숙고,신중,고의,유유함
deliberation : n,숙고,심의,신중
deliberative : a,신중한,심의의,심의를 위한
deliberator : n,숙고자,심의자
delicacy : n,섬세함,우미,정교,연약함
delicate : a,섬세한,정묘한,고상한,민감한,허약한,미묘한
delicately : ad,우아하게,섬세하게,미묘하게,정교하게,고상하게
delicatessen : n,조제 식료품
delicious : a,n,맛있는,유쾌한,멜리셔스(사과)
delict : n,(법)불법 행위,범죄
delight : n,기쁨,유쾌,기뻐하다,즐기다,즐겁게하다
delighted : a,매우 즐거운,기쁜
delightful : a,매우 기쁜,즐거운
delightsome : a,매우 기쁜
Delilah : n,데릴라(samson의 불성실한 애인),요부
delimit : vt,한계를 정하다
delimitate : vt,한계를 정하다
delimitation : n,한계,경계,한계결정
delimiter : n,구분짖는 기호(테이프상에서 테이터 항목을 구분짓는)
delineate : vt,묘사하다,윤곽을 그리다
delineation : n,윤곽묘사,약도,도형,서술
delineator : n,묘사하는 사람(기구),(양재의)본
delinquency : n,직무 태만,의무 불이행,지불 기한이 지난 부채,체납(금)과실,범죄,비행,=JUVENILE DELINQUENCY
delinquent : a,태만한,체납되어 있는,의무를 게을리 하는
delinquent subculture : x,(심)비행성 저 문화(비공리성,찰나주의,집단 맹종성 등)
deliquesce : vi,용해하다
deliquescence : n,용해,(화)조해(성)
delir : vi,섬망 상태가 되다
deliration : n,(=DELIRIUM)
delirious : a,정신 착란의,헛소리하는,무아경의,황홀한
delirium : n,정신 착란,황홀,무아경
delirium tremens : vt,(알코올 중독에 의한)섬망증
delist : vt,목록(표)에서 빼다
delitescence : n,잠복(기간),(증상의)돌연 소실
delitescent : a,잠복하고 있는
deliver : vt,넘겨주다,배달하다,연설을 하다,구해내다,석방을 하다
deliverance : n,(문어)구출,구조,석방,해방,진술(의견)의 공표,공식 의견,(배심의)평결
delivered : a,(상)...인도의
delivered price : x,인도 가격
deliverer : n,구조자,석방자,인도인,교부자,배달인
delivery : n,배달,인도,교부,석방
delivery boy : x,배달 사환,신문 배달 소년
delivery man : n,배달인
delivery note : x,(영)상품 수령증
delivery room : x,분만실,도서출납실
dell : n,작은 골짜기
Della : n,여자 이름
dellinger phenomenon : a,델린저 현상
delly : n,(=DELI)
Delmarva : n,(미)델마버(반도),(미국 동부 3주를 포함하는 반도,비공식 호칭)
delocalization : n,
delocalize : vt,본래의 장소에서 옮기다,지방성을 없애다
delouse : vt,~에서 이를 없애다
Delphi : n,델포이(그리스의 옛 도시,Apollo신전이 있었음)
Delphian : a,Apollo신전의,모호한
Delphically : ad,모호하게
Delphic oracle : x,아폴로 신전의 신탁
Delphine : n,여자 이름
delphinium : n,참제비 고깔
Delphinus : n,(천)돌고래자리
Delphology : n,(과학,기술 분야에서의)미래 예측 방식의 연구
delta : n,삼각주,그리스어 알파벳의 넷째글자
Delta Air Lines : x,델타 항공(미국의 항공 회사)
Delta blues : x,델타 블루스(컨트리 뮤직)
Delta Force : x,(미)델타 테러 타격 부대
deltaic : a,삼각주의(같은)
delta metal : x,델타 메탈(구리,아연,철의 합금)
delta ray : x,(물)델타선
delta rhythm : x,(의)델타 리듬
delta wave : x,(의)(뇌파의)델타파(깊은 수면 상태 때 보임)
deltawing : a,삼각날개의
deltawinged : a,삼각 날개의(제트기 등)
deltiology : n,그림엽서 수집
deltoid : a,n,삼각형의,삼각근
delude : vt,속이다,호리다,매혹시키다
deluge : n,vt,대홍수,큰비,쇄도,범람시키다,...에 쇄도하다
delusion : n,속임,매혹,미망,착각
delusive : a,기만적인,믿을 수 없는,망상적인,현혹적인,착각하게하는,delusively()a,delusiveness,n
delusory : a,호리는,소리는
deluxe : a,호화로운,호화판의,호화롭게
delve : n,파는 사람
dely, : x,delivery
dem, : x,demurrage
Dem, : x,Democrat,Democratic
dem- : x,(연결형)대중,민중,인민의 뜻,(모음에서는 dem-)
demagnetization : n,소자
demagnetize : vt,자기를 없애다,(테이프의)녹음을 지우다
demagnetizer : vt,n
demagnify : vt,(특히 보존을 위해)축소하다,마이크로화하다
demagog : n,선동가,정치가
demagogic : a,선동가의,선동적인,데마의
demagogism : n,=DEMAGOGUERY
demagogue : n,vi,vt,(민중의 지도자)의 뜻에서,선동정치가,(옛날의)민중(군중)지도자,demagogue로서 행동하다,과장해서 말하다
demagoguery : n,데마를 퍼뜨림,민중 선동
demagogy : n,선동,민중 선동가
demal : a,피부에 관한,피부의
deman : vi,vt,(영)감원하다,해고하다,(미)...의 사내다움을 없애다
demand : n,요구,청구,요구하다,심문하다
demandable : a,요구(청구)할 수 있는
demandant : n,요구자,원고
demand bill : x,요구불 어음
demand bus : x,(영)요청 버스(일정 구역내의 이용자가 요청을 하면 태우러 오는 버스)
demand deposit : x,요구불 예금
demander : n,요구(청구)자
demand inflation : x,=DEMANDPULL
demanding : a,(사람이)요구가 지나친,지나친 요구를 하는,(일이)큰 노력을 요하는
demand loan : x,=CALL LOAN
demand note : x,일람불 약속 어음,지불 청구서
demandoriented : n,(경)수요 과잉 인플레이션(수요가 공급을 초과할때의 물가 상승)
demandpull inflation : x,수요과잉 인플레
demandside economics : x,수요 중시의 경제학
deMaoization : n,탈 모택동화,모택동 색채의 일소
demarcate : vt,~의 경계를 정하다,~을 한정하다,~을 구획하다
demarcation : n,한계,구별,구분
demarche : n,수단,전환책
demarketing : n,수요 억제를 위한 선전 활동
demasculinize : vt,...의 남성다움을 없애다
demassify : vt,비 대중화하다,비 집중화하다,다양하게 하다,나치스화하다
dematerialize : vt,vi,비 물질화시키다(하다),안 보이게 하다(되다)
deme : n,(그리스사)(고대 Attica의)시구,(현대 그리스의)시,지방자치체,(생)딤(개군체의 단위)
demean : vt,떨어뜨리다,처신하다,행동하다
demeanor : n,행동,태도
dement : vt,미치게 하다
demented : a,정신 착란의,미친
demented : a,미친,치매가 된,demently()a,ad,demintness()n
dementi : n,공식적인 부인
dementia : n,치매
dementia praecox : x,조발치매
Demerara : x,(원산지명에서)황갈색 조당
demerger : n,재분리
demerit : n,결점,과실,죄과,벌점
demesne : n,소유,영지,범위
Demeter : n,농업의 여신
demi- : x,(연결형)(반...,부분적...)의 뜻
demigod : n,반신
demigoddess : n,DEMIGOD의 여성형
demijohn : n,목이 가는 병
demilitarization : n,비군사화
demilitarize : vt,비군사화하다,군정에서 민정으로 이양하다
demilitarized zone : x,비무장지대(약 DMZ)
demilune : n,반달,반월보
demimini : a,n,초미니의,초미니스커트(드레스)
demimondaine : n,a,화류계 여자,매춘부,첩,화류계의
demimonde : n,화류계
demineralize : vt,...에서 광물질을 제거하다,탈염하다
demiofficial : n,공사에 관한 사한
demipension : n,(하숙,호텔의)1박 2식제,그 요금
demirep : n,=DEMIMONDAINE
demisable : a,양도할 수 있는
demise : n,vt,죽음,서거,폐지,소멸,물려주다,양위하다,유증하다
demisemiquaver : n,32분 음표
demission : n,사직,퇴위,해고,면직
demist : vt,(영)(차의 창유리 등에서)흐림(안개)을 제거하다,=DEFROSTER
demit : vt,사익하다
demitasse : n,작은 차종(식후의 블랙커피용)
demitint : n,(미)간색,(그림의)바림 부분
demiurge : n,(Plato철학에서)조물주,(옛 그리스의)행정관
demiurgic : a,조물주의,세계 창조의,창조력을 가진
demivolt : n,(말이 다리를 들고 하는) 반회전
demiworld : n,화류계
Demo : n,민주당원,데모
demo : n,데모(참가자),레코드나 상품의 견본
demob : vt,복원하다,제대하다
demobilize : vt,복원하다,제대시키다
Demochristian : n,(유럽의)기독교 민주당원
democracy : n,민주주의,민주 정체,민주국
democrat : n,민주주의자
democratic : n,민주주의의,민주적인
Democratic Party : x,(미)민주당(the Republican Party와 더불어 현재 미국의 2대 정당)
DemocraticRepublican Party : x,(미)(19세기초의)민주 공화당
democratism : n,민주주의의 이론(제도,원칙)
democratization : n,민주화,평등화
democratize : vt,민주화하다
Democritus : n,데모크리토스(그리스의 철학자)
demode : a,시대(유행)에 뒤진,낡은
demoded : a,=DEMODE
demodulate : vt,복조하다,검파하다
Demogorgon : n,(고대 신화의)마왕,마신
demographer : n,인구 통계학자
demographic : a,인구(통계)학의
demographic characteristics : x,(잡지 독자의)인구 통계적 특성
demographics : n,인구 통계
demographic transition : x,인구학적 추이(출생률,사망률의 주된 변화)
demography : n,인구 통계학
demoiselle : n,=DAMSEL,상모두루미(북아프리카산),기생잠자리
demolish : vt,파괴하다,먹어치우다
demolition : n,파괴,폭파
demolition bomb : x,대형 파괴 폭탄
demolition derby : x,차의 격돌경기(남은 차가 우승)
demon : n,악마,귀신,일에 비범한 사람
demonetization : n,(본위 화폐로서의)통용(유통)금지,폐화
demonetize : vt,본위 호폐로서의 자격을 잃게 하다,(화폐,우표 등의)통용을 폐지하다
demoniac : a,악마의,악마와 같은,미친 듯한,귀신들린 듯한
demoniacal : a,=DEMONAC
demonic : a,ad
demonism : n,
demonize : vt,악마처럼 만들다,악마로 화하게 하다,귀신 붙게 하다
demono- : x,(연결형)(마귀,귀신)의 뜻
demonocracy : n,마귀(귀신)의 지배
demonolatry : n,마귀(귀신)숭배
demonology : n,악마연구
demonstrability : n,논증 가능성
demonstrable : a,논증할 수 있는
demonstrant : n,=DEMONSTRATOR
demonstrate : vt,논증하다,실물선전하다,시위운동을하다
demonstration : n,논증,실물 선전,시위 운동
demonstrative : a,감정을 노골적으로 나타내는
demonstrator : 논증자,증명자,실지 교수자,(해부학의)실지 수업의  조수,(상품 기계의)실지 설명자(선전원),실지 선전용 제품(모델)(자동차 등),시위 운동자,데모 참가자
demoralization : n,퇴폐,혼란
demoralize : vt,퇴폐시키다,~의 사기를 꺽다,혼란시키다,당황케하다
demos : n,민중
Demosthenes : n,데모스테네스(고대 그리스의 웅변가,정치가)
Demosthenic : a,데모스테네스류의,애국적 열변의
demote : vt,강등시키다
demothball : vt,(전투를 위해 군함 등을)현역으로 복귀시키다
demotic : a,민중의,통속적인
demotics : n,민중과 사회의 연구,민중학
demotion : n,좌천,강등,격하
demotivate : vt,...의 의욕(동기)을 잃게 하다
demount : vt,떼어내다,뜯어내다,demountable()vt,떼어낼 수 있는a
demulcent : a,진통의
demur : n,이의를 말하다,항변하다
demure : a,기품 있는,침착한,진지한
demurrable : a,(법)항변할 수 있는,이의를 제기할 수 있는
demurrage : n,초과 정류,종류 일수 초과 할증금
demurral : n,이의,항변
demurrant : n,(법)이의 신청자
demurrer : n,항변자,이의 신청자,(법)방소 항변,(피고의)항변,이의(신청)
demurrero : n,방소 항변,항변자,반대,이의
demy : n,디마이판,(영)옥스포드 Magdalen College의)장학생(졸업생)
demystification : n,
demystify : vt,...의 신비성을 제거하다,계몽하다
demythicization : n,비신화화
demythicize : vt,vi,...의 신화적 요소를 없애다,비신화화하다
demythify : vt,=DEMYTHICIZE
demythologization : n,(성서의)비신화화
demythologize : vt,...의 신화성을 없애다,(기독교의 가르침,성서를)비신화화하다
den : n,굴,소굴,작고 아늑한 사실
denarius : n,고대 로마의 은화(영국은 1971년까지 penny,pence를 그 머릿자 d로 약기 했음)
denary : a,십진의
denationalization : n,해제,박탈
denationalize : vt,~의 국적을 박탈하다,독립국의 자격을 빼앗다,~의 국유를 해제하다
denaturalization : n,변질,시민권 발탈
denaturalize : vt,~을 부자연하게 하다,~을  변성시키다,~의 시민을 박탈하다
denaturant : n,변성제
denaturation : n,
denature : vt,변성시키다
denatured alcohol : x,변성 알코올(마시지 못함)
denazification : n,비나치스화
denazify : vt,비나치스화하다
den chief : x,(미)유년단 분대의 분대장
den dad : x,(미)유년단 분대의 감독
dendr- : x,(연결형)(나무)의 뜻(모음에서는 dendr-)
dendriform : a,수목상의
dendrite : n,모수석,수상돌기
dendritic : a,모수석(상)의
dendrochronology : n,(식)연륜 연대학
dendroid : a,수목상의
dendrolite : n,나무의 화석
dendrology : n,수목학
dendrometer : n,측수기(높이,지름을 잼)
dendron : x,(연결형)나무의 뜻
dene : n,(영)(숲이 있는)깊은 골짜기,(해안의)모래톱,사구
Deneb : n,(천)데네브(백조자리의 알파성)
denegation : n,부정,부인,거절
deneutralize : vt,비중립화하다
Dengist : n,등소평 지지자
dengue : n,뎅그열
Deng Xiaoping : n,등소평(중국 공산당의 지도자)
deniability : n,(정부 고관 등의)법적 부인권
deniable : a,부인(거부)할 수 있는
denial : n,부정,부인,거부,극기,싫다는 말을 못하게 하다)
denicotinize : vt,니코틴을 없애다
denier : n,부인하는 사람
denier : n,프랑스의 옛 은화,소액의 돈,데니르
denigrate : vt,검게 하다,~을 더럽히다,~의 평판을 떨어뜨리다
denigration : n,
denim : n,데님(작업복용의 기능직 무명),(푸른 데님천의)작업복
Denis : n,남자 이름,성 드니(프랑스의 수호 성인)
Denise : n,여자 이름
denitrate : vt,질산을 없애다
denitration : n,
denitrification : n,탈질(작용)
denitrify : vt,질소를 제거하다
denizen : n,주민,귀화인,귀화를 허가하다,시민권을 주다
Denmark : n,덴마크
den mother : x,(미)유년단 분대의 여성 지도자
denner cloth : x,정찬용 식탁보
Dennis : n,남자 이름,데니스(영국의 비평가,극작가)
Dennis the Menace : x,개구쟁이 데니스(미국의 만화 주인공)
denobilization : n,동원 해제,복리원
denominaism : n,종파심,파벌주의
denominate : vt,명명하다,특정한 이름이 있는
denomination : n,명명,명칭,교파,종류
denominational : a,종파의 지배하의
denominative : a,이름 구실을 하는,이름을 표시하는
denominator : n,분모
denoninationaliam : n,종파신의,파벌주의
denotable : a,표시할 수 있는
denotation : n,지시,표시,표,명칭
denotative : a,외연적인,객관적인,과학적인
denote : vt,나타내다,표시하다,의미하다
denouement : n,대단원,종결
denounce : vt,공공연히 비난하다,고발하다,선언하다
de nouveau : ad,=DENOVO
de novo : ad,(L=from the new)처음부터 새로이,다시
dense : a,조밀한,짙은,우둔한
densely : ad,짙게,밀집하여,빽빽이
denseness : n,
dense pack : x,(미)(전략 미사일의)밀집 배치(방식)
densify : vt,밀도를 높이다,(수지를 배어들게 하여)(목재를)치밀하게 하다
densimeter : n,비중계,밀도계
densitometer : n,사진 농도계
density : n,밀도,농도
dent : n,움푹 팬 곳
dental : a,치과의,이의,치음,치음자
dental floss : x,(치과)치간 청소용 견사
dental hygiene : x,치과 위생
dental hygienist : x,치과 위생사
dentalize : vt,치음화하다
dental mechanic : x,치과 기공사
dental plate : x,의치,의치상
dental surgeon : x,치과 의사,(특히)구강 외과 의사
dental surgery : x,치과(의학),구강외과(학)
dentate : a,이빨이 있는,톱니 모양의
dentation : n,(동)이 모양의 구조(돌기),(식)톱니 모양
denti- : x,(연결형)=DENT
denticare : n,(캐나다)(정부에 의한)어린이 무료 치아 치료
denticle : n,작은 이,이 모양의 돌기,(건)DENTIL
denticular : a,작은 이 모양의
denticulate : a,(식)작은 이 모양의,(건)이 모양의 장식이 있는
denticulation : n,작은 이의 돌기,작은 이,(건)이 모양의 장식
dentiform : a,이 모양의
dentifrice : n,치마분,치약
dentigerous : a,이를 가진
dentil : n,(건)이 모양의 장식
dentilabial : a,n,(음성)이와 입술의,순치음
dentilingual : a,(음성)설치음의
dentine : n,a
dentist : n,치과의사
dentistry : n,치과 의숙
dentition : n,치열,이가나기
dentoid : a,이 같은
denture : n,치열,잇속,의치
denturist : n,의치 기공사
denuclearization : n,비핵화
denuclearize : vt,핵무장을 금지하다
denucleate : vt,(원자,세포 등의)핵을 제거하다
denudation : n,
denudation : n,노출,박탈,삭박
denude : vt,발가벗기다,벗기다,삭박하다
denunciate : vt,=DENOUNCE
denunciation : n,고발,공공연한 비난,파기 통고
denunciative : a,=DENUNCIATORY
denunciator : n,탄핵(고발)자,비난자
denunciatory : a,비난하는,위협적인
Denver : n,덴버(비국Colotado주의 주도)
Denver boot : x,=FRENCH BOOT
deny : vt,부정하다,거절하다,면회를 거절하다
deodar : n,히말라야 산목
deodorant : a,n,방취의,방취제
deodorization : n,냄새 제거(작용)
deodorize : vt,탈취하다
deodorizer : n,방탈취제
Deogratias : ad,(L=thanks to God),천행으로
deontology : n,(철)의무론
deorbit : vt,궤도에서 벗어나게 하다
Deo volente : ad,(L=God being willing),하늘(하느님)의 뜻이라면,사정이 허락하면
deoxidate : vt,=DEOXIDIZE
deoxidation : n,산소 제거,환원
deoxidize : vt,탈산하다,환원하다
deoxygenate : vt,(유리)산소를 제거하다,=DEOXIDIZE
deoxyribonuclease : n,디옥시리보뉴클레아제(DNA분해 효소)
deoxyribonucleic acid : n,디옥시리보 핵산
deozyribose : n,디옥시리보스(디옥시리보핵산의 주요 성분)
dep, : x,departed,department,departs,departure,dependency,deponent,deposed,(은행)deposit,depot,deputy
depacinate : vt,~을 뿌리째  뽑다,근절하다,~을 고립시키다,소외시키다
depart : vi,출발하다,떠나다,벗어나다,빗나가다
departed : a,(완곡)죽은,지나간,과거의,고인(개인),죽은사람(전체)
departee : n,조국(지역)을 떠나는 사람,(미)연극의 막간에 가버리는 사람
department : n,부(문),과,국
departmental : a,과의,국의
departmentalize : vt,각 부문으로 나누다
departmental store : x,(영)=DEPARTMENT STORE
Department D : x,(소련 KGB의) D기관(허위 보도로 다른 나라를 혼란시키는 기관)
department store : x,백화점
departure : n,출발,발차,이탈,변경
depasturage : n,방목(권)
depasture : vt,(가축이)목초를 뜯어먹다,방목하다,(토지의)목초를 다 뜯어먹다,(토지가 가축에)목초를 공급하다
depauperate : vt,(고)가난하게 하다,빈약하게 하다,쇠약하게 하다,(토지를)메마르게 하다
depauperation : n,빈곤화,쇠약,(식)발육 부전,위축
depauperize : vt,가난하지 않게 하다,가난뱅이를 없애다
depend : vi,의지하다,~나름이다,~여하에 달리다
dependability : n,의존할(믿을)수 있음
dependable : a,의존할(믿을,신회할)수 있는,dependableness()a,n,dependably()a,ad
dependence : n,의존,종속,신뢰,의지
dependency : n,종속물,속령,속국
dependent : n,a,=DEPENDENT
dependent : a,n,~에 의지하고 있는,의존하는,~나름의,종속의,의존하는 사람,부양 가족
dependent clause : x,종속절
dependent variable : x,(수)종속 변수
depeople : vt,...의 주민을 줄이다(없애다)
depersonalization : n,비개인화,객관화
depersonalize : vt,비인격(비인간)화하다,인격(개성)을 박탈하다
dephosphorize : vt,(광석에서)인분을 제거하다
depict : vt,묘사하다
depiction : n,묘사
depictive : a,묘사적인
depicture : vt,=DEPICT
depilate : vt,털을 뽑다,탈모하다
depilation : n,탈모,(특히 동물 가죽의)털뽑기
depilatory : a,탈모의
deplane : vi,비행기에서 내리다
deplenish : vt,비우다
deplete : vt,고갈시키다,비우다
depletion : n,고갈
depletive : a,고갈(소모)시키는,혈액(체액)을 감소시키는
depletory : a,=DEPLETIVE
deplorability : n,한탄스러움,비통,비참
deplorable : a,슬퍼할,가엾은,애처로운,비참한
deplorably : ad,한탄스럽게(도),비통하게
deplore : vt,~을 비탄하다
deploy : vi,전개하다,전개시키다,
deployment : n,전개,비군사적 사역
deplumation : n,
deplume : vt,깃털을 잡아 뜯다,명예(재산)를 박탈하다
depolarization : n,(전,자)탈분극,복극,소극(한 것),(광)편광의 소멸
depolarize : (전,자)복극(소극)하다,(광)편광을소멸시키다,(확신,편견 등을)뒤집다,해소시키다
depolarizer : 복극(소극)제
depoliticize : vt,정치색을 없애다,비정치화하다
depollute : vt,~의 오염을 제거하다
depollution : n,오염 제거
depone : vt.vi,(법)선서하고 증언하다
deponent : a,수동형의
depopulate : vt,~의 주민을 없애다,인구가 줄다
depopulation : n,감소
depopulator : n,인구를 줄이는 것(사람,전쟁,기근 등)
deport : vt,처신하다,이송하다
deportation : n,추방
deportee : n,피추방자
deportment : n,태도,거동,처신,행실,품행,(영)(젊은 여성의)행동 거지
deposable : a,폐할 수 있는,증언할 수 있는
deposal : n,폐위,면직,파면
depose : vt,면직시키다,폐하다,증언하다
deposit : vt,n,놓다,낳다,핌전시키다,맡기다,부착물,침전물,예금,공탁금,보증금,계약금
deposit account : x,(영)저축 예금 구좌(미)예금 구좌
depositary : n,피신탁인,관재인
depositary receipt : x,(발행국 은행에 맡기는)예탁 증권
deposition : n,면직,퇴위,증언
deposit money : x,공탁금,예금 화폐
depositor : n,공탁자,예금자
depository : n,공탁소,수탁소,보관소,창고,보관인,수탁자
depot : n,정거장,저장소,창고
depot ship : x,모함
depr, : x,depreciation
depravation : n,타락하다
deprave : vt,타락시키다
depraved : a,타락한
depravity : n,타락,비행
deprecate : vt,비난하다
deprecatingly : ad,비난하듯이,애원(탄원)조로
deprecation : n,비난
deprecatorily : a,ad
deprecatory : a,반대의,변명적인
depreciable : a,가격 인하가되는,(미)감가 견적할 수 있는
depreciate : vt,가치를 떨어뜨리다,깎아내리다,얕보다,경시하다,가치가 떨어지다
depreciatingly : ad,얕보아,경시하여
depreciation : n,가치 하락,감가 상각,경시
depreciation insurance : x,(보험)감가상각비 보험
depreciation reserve : x,감가 상각 준비금
depreciative : a,=DEPRECIATORY
depreciatory : a,가치 하락의,경시하는
depredate : vt.vi,약탈하다
depredation : n,약탈
depredatory : vt.vi,a
depress : vt,내리 누르다,저하시키다,약화시키다,풀이 죽게 만들다
depressant : a,진정 작용이 있는,진정제
depressdible : a,저하시킬 수 있는
depressed : a,내리 줄인,저하된,움푹 들어간,볼황의
depressed area : x,불황지역(지방)
depressed classes : x,(인도의)최하층민
depressing : a,억압적인,침울하게 만드는,울적한,depressingly()a,ad
depression : n,하락,침하,우묵 팬곳,저기압
depressive : a,n,=DEPRESSING,울병환자
depressor : n,억압자,(의)압저기,(생리)감압 신경(약)혈압 강하제
depressurize : vt,감압하다,...의 기압을 내리다
deprivable : a,빼앗을 수 있는
deprival : n,박탈
deprivation : n,저해,면직
deprive : vt,빼앗다,면직시키다,저해하다
deprived : a,가난한,불우한,가난한 사람들
de profundis : ad,(L=out lf the depths)(슬픔,절망 등의)구렁텅이에서,
deprogram : vt,신념(신앙)을 버리게 하다,눈뜨게 하다
dept, : x,department,deputy
depth : n,깊이,세로길이,농로,깊은 곳
depth bomb : x,폭뢰
depth finder : x,(해)음향 측심기
depth interview : x,심층적 인터뷰(정해진 많은 질문을 자세히 물어봄)
depth psychology : x,심층 심리학
depth recorder : x,(해)자기 심도계
depurant : n,청정제
depurate : vt,vi, 정화하다
depuration : n,정화(정혈)작용
depurative : a,정화하는
depurator : n,정화기,정화제
depurge : vt,추방을 해제하다
depurgee : n,추방 해제자
deputation : n,대리 임명,대표,대표단
depute : vt,대리를 명하다,위임하다
deputize : vi,대리를 보다
deputy : n,대리,대표자,사절
deputy gobernor : x,부지사
deputy sheriff : x,(미)군 보안관 대리
deque : n,(전산)덱(양끝의 어느 쪽에서든 데이터의 출입이 가능한 데이터 행렬)
De Quincey : n,드퀸시(영국의 수필가)
der, : x,derivation,derivative,derived
deracialize : vt,인종적 특징을 없애다
deracinate : vt,뿌리째 뽑다,근절하다,deracination()vt,n
deradicalize : vt,과격주의(사상)를 버리게 하다
derail : vi,탈선하다,derailment()vi,n
derailleur : n,(자전거의)변속장치,변속장치가 있는 자전거
Derain : n,Andre(1880~1954) 드랭(프랑스의 화가)
derange : vt,혼란시키다,방해하다,발광시키다
deranged : a,혼란된,미친
derangement : n,혼란,발광
derate : vt,감세하다
deration : vt,배급에서 제외하다
deratization : n,쥐잡기
Derby : n,더비 경마
Derby Day : x,더비 경마일
Derby dog : x,경마장의 경기로를 헤매는 개,거치적거리는 사람(것)
Derby hat : x,(미)중산 모자
Derbyshire : n,더비셔(영국 중부의 주)
derecognize : vt,(국가에 대한)승인을 취소하다,derecognition()vt,
derect motion : x,직진운동,(천)순행
deregister : vt,등록을 취소하다,deregistration()vt,n
de regle : ad,규정대로(인)
deregulate : vt,규칙을 폐지하다,통제(규제)를 철폐하다,deregulation()vt,n
dereism : n,(심)비현실성
Derek : n,남자 이름
derelict : a,n,버려진,버림받은,유기된,직무  태만의,유기물,유기선,버림받은 사람
dereliction : n,유기,태만
derepress : n\vt,
derepressor : n,9(생)유도자
derequisition : n,접수 해제
derestrict : vt,...의 제한을 해제하다
deride : vt,조롱하다,derider()vt,n,deridingly()vt,ad
derigueur : a,예의상 필요한(required by etiquette)
derisible : a,웃음거리가 되는
derision : n,비웃음,조롱,경멸,조소거리
derisive : a,조소(조롱)하는,비웃을 만한,조소받을(만한)
derisively : ad,비웃으며,조롱하여
derisory : a,경멸의,비웃음의
deriv, : x,derivation,derivative,derived
derivable : a,끌어낼 수 있는,추론할 수 있는
derivation : n,유도,유래,기원
derivative : a,n,파생의,파생어
derive : vt,~에서  끌어내다,기원을 더듬다,기원을 발하다,...에  유래하다
derived : a,유래된,파생된(단어)
derm- : x,(연결형)(피부)의 뜻(모음앞에서는 derm-)
derma : n,피부,진피
dermat- : x,(연결형)(피부의)의 뜻(모음에서는 dermat-)
dermatitis : n,피부염
dermatology : n,피부병학
dermatopathia : n,피부병
dermatosis : n,피부병
dermic : a,=DERMAL
dermis : n,=DERMA
dermoid : a,피부 모양의
dermotropic : a,(바이러스가)피부에 기생하는,피부성의
dern : a,ad,=DERN
dernier : a,최후의,최근의
dernier cri : n,결정적(최종적)인 말,최신 유행
dernier resort : x,최후 수단
dero : n,낙오자,부랑자,(익살)녀석,사람
derogate : vi,명성을 떨어뜨리다
derogation : n,손상
derogative : a,손상시키는
derogatory : a,(명예,품격,가치 등을)손상하는,derogatoriness()a,n, derogatorily()a,ad
derrick : n,데릭 기중기
derriere : n,(고)필사적인 용기,대단한 행위
derringdo : n,대담한 행위
derringer : n,구경이 큰 소형 권총
derris : n,데리스(동인도 재도산 식물),그 뿌리에서 만든 살충제
derry : n,(오스,뉴질)혐오,폐옥(부랑자 등이 이용하는)
derss rehearsal : x,의상으리 입고하는 마지각 총연습
derust : vt,녹을 제거하다
derv : n,(영)디젤 엔진용 연료
dervish : n,탁발승
desalinate[d`i:s'4l5n`eit)=DESALT
desalinize : vt,=DESALT
desalt : vt,염분을 제거하다,담수화하다
descale : vt,물때를 벗기다
descant : vi,상설하다,노래하다,상설
Descartes : n,데카르트(프랑스의 철학자 수학자)
descend : vi,내리다,내려가다,전해지다,타락하다,급승하다
descendant : n,자손
descended : a,전해진,유래한
descendent : a,하행성의,강하(낙하)하는,전해 내려오는,세습의
descender : n,내려가는 사람(것),(이)하행 문자
descendible : a,(자손에게)전하여지는,유전되는,유증할 수 있는
descending : a,내려가는,강하하는 하향의
descending letter : x,DESCENDER
descending powers : x,(수)강멱,내림차
descent : n,하강,내리받이,상속
deschool : vt,(사회에서)(전통적인)학교를 없애다
describable : a,묘사(기술)할 수 있는
describe : vt,기술하다,그리다,묘사하다
descrier : n,발견자
description : n,서술,기술,묘사,특징
descriptive : a,서술적인,기술적인
descriptive geometry : x,도형 기하학
descriptive grammar : x,기술 문법
descriptor : n,서술자
descriptor linguistics : x,기술 언어학
descry : vt,발견하다
Desdemona : n,데스데모나(셰익스피어작 Othello 에서 Othello의 처)
desecrate : vt,~의 신성을 더럽히다
desecrator : n,신성 모독자
desegregate : vt,인종 차별대우를 그만두다
desegregation : n,흑인 차별 대우  폐지
deselect : vt,(미)훈련에서 해제하다
desensitize : vt,~의 감광도를 줄이다,과민성을 없애다
desert : n,a,상(벌)을 받을 만한 가치,불모 지대,불모 시대,사막같은,불모의,쓸쓸한
desert : vt,n,버리다,도망하다,사막의,당연한 응보
deserted : v,s,사람이 살지 않는,황폐한,버림받은
deserter : n,유기자,직장 포기자,도망자,탈영병,탈선자,탈당자
desertification : n,사막화
desertion : n,유기,탈당,탈함
desert service : x,디저트용 식기 한 벌
deserve : vt,~할 가치가 있다,~을  할만하다
deserved : a,당연한(상,벌,보상 등)
deservedly : ad,당연히
deserver : n,적격자,유자격자
deseving : a,당연히,...을 받아야 할 ,...할 만한,공적 있는
desex : vt,성기를 제거하다,거세하다
desexualize : vt,=DESEX
deshabille : n,=DISHABILLE
desi : n,(야구)지명 대타
desiccant : a,n,건조시키는(힘이 있는),건조제
desiccate : vi,건조하다
desiccation : n,건조(작용),탈수,마름
desiccative : a,=DESICCANT
desiccator : n,건조기,건조용 용기
desiderate : vt,소망하다,바라다,desideration()vt,n
desiderative : a,소망하는,바라는,(문법)(동사의)희구법
desideratum : n,필요를 느끼게 하는 것,꼭 바라는 것
design : n,vt,설계,디자인,구상,줄거리,도안,도안을  만들다,계획하다,...으로 예정하다,마음먹다
designate : vt,가리키다,명명하다,지명하다,임명하다
designated : a,지정된,관선의
designated hitter : x,(야구)지명 대타자
designation : n,명시,지정,임명,명칭
designator : n,지명(지정)인
designed : a,설계된,계획적인,고의의
designedly : a,계획적으로,일부러
designee : n,지명된 사람,피지명자
designer : n,설계자,도안자,디자이너,음모가
designer brand : x,유명 디자이너의 이름(상표)이 든 상품
designing : n,a,설계,의장,도안,음모,설계의,도안의 꿍심을 품은,뱃속이 검은,계획적인
desilt : vt,(강 등을)준설하다
desilverize : vt,...에서 은을 제거하다
desinence : n,(시의)끝,끝 행,(문법)어미,접미어
desipience : n,(문어)터무니 없음,어처구니 없음
desirability : n,욕구
desirable : a,바람직한,갖고 싶은
desire : vt,원하다,바라다,소원,욕구,바라는 것,정욕
desired : a,바랐던,희망했던,옳은,훌륭한,
desirous : a,바라는,원하는
desist : vi,단념하다,그만두다
desistance : n,중지,단념
desk : n,책상,편집부
desk clerk : x,(미)(호텔 등의)접수계원
desk copy : x,(채택 교재의 교수용)증정본
deskful : n,책상에 가득한 것(일)
deskill : vt,(작업을)기능이 필요없는 단순 분업으로 하다,(노동자의)기능을 시대에 뒤지게 하다
desk lamp : x,전기 스탠드
deskman : n,(신문사의)내근 기자,(기업체의)관리 직원
deskmate : n,(교실에서의)짝
desk pad : x,책상용 깔개(고무판 등)
desk policeman : x,내근 경관
desk secretary : x,(미)(협회 등의)내근 직원
desk study : x,(영)탁상 연구
desk theory : x,탁상공론
desktop : a,탁상용의
desktop calculator : x,탁상용 계산기
desk work : x,사무,책상에서 하는 일
desolate : a,황폐한,황량한,사람이 안 사는,고독한,음산한,황폐케하다
desolated : a,(사람이)쓸쓸한,외로운
desolater : n,황폐시키는 것(사람)
desolation : n,황폐,황량,쓸쓸함,서글픔,폐허
desorb : vt,흡수제로부터 흡수된 물질을 제거하다
despair : n,절망
despairing : a,
despatch : v,n,=DISPATCH
desperado : n,목숨 아까운 줄 모르는 흉한,무법자
desperate : a,절망적인,필사적인,자포자기의,터무니없는
desperately : ad,절망적으로,자포자기하여,필사적으로,생각다 못해,몹시,지독하게
desperation : n,절망,기를 씀,필사,자포자기
despicable : a,야비한,비열한
despin : vt,vi,...의 회전을 멈추다,회전 속도를 늦추다
despise : vt,경멸하다,despiser()vt,n
despite : n,prep,모욕,원한,증오,...에도 불구하고
despiteful : a,(고)=SPITEFUL,despitefully()a,ad
despoil : vt,약탈하다,despoilment()vt,약탈n
despoliation : n,약탈,강탈
despond : vi,낙담하다
despondency : n,낙담
despondent : a,기가 죽은,의기 소침한,낙담한
desponding : a,=DESPONDENT
despot : n,전제 군주,독재자,폭군
despotic : a,횡포한,포악한
despotic monarchy : x,전제 군주제(국)
despotism : n,전제론자
desquamate : vi,vt,(병리)(표피가)탈락하다,벗기다
desquamation : n,표피 탈락
dessert : n,디저트(dinner 끝에 나오는 과자,과일 따위)
dessertspoon : n,디저트스푼
dessertspoonful : n,디저트 스푼 하나의 분량
dessert wine : x,디저트 때나 식사중에 마시는 달콤한 포도주
destabilize : vt,불안정하게하다,동요시키다,destabilization()vt,n
destalinization : n,스탈린 격하운동
destalinize : vt,비 스탈린화하다
desterilize : vt,활용하다,~의 봉쇄를 풀다
destination : n,목적지,보낼 곳
destine : vt,운명짓다,예정하다,할당하다
destined : a,예정된,운명지어진,(문어)(목적지를)향하는
destiny : n,운명,천명
destitute : a,결핍한,~이 없는,군색한
destitution : n,결핍,빈궁
destress : vt,중압을 제거하다
destriction : vt,n
destrier : n,(사)군마
destroy : vt,파괴하다,멸하다,죽이다,폐하다
destroyer : n,파괴자,구축함
destroyer escort : x,대 잠수함용 호송 구축함
destroyer leader : x,향도 구축함
destroying angel : x,(식)광대버섯,독버섯
destruct : n,고의적 파괴,파괴용의
destructibility : n,(피)파괴성,파괴력
destructible : a,파괴할 수 있는
destruction : n,파괴,멸망
destructive : a,파괴적인,파멸시키는,유해한
destructive distillation : x,(화)분해증류,건류
destructivity : n,파괴 능력
destruct line : x,(미사일의)자폭선
destructor : n,파괴자,폐물 소각로,파괴 장치
desuete : a,시대(유행)에 뒤진
desuetude : n,폐지,폐용
desulfurize : vt,탈황하다,황을 제거하다
desultorily : ad,산만하게,종작없이,만연히,띄엄띄엄
desultory : a,산만한,종작 없는
DET : x,detachment
detach : vt,분리하다,분견하다
detachable : a,분리할 수 있는,파견할 수 있는
detached : a,떨어진,공평한,분견된
detachedly : ad,떨어져서,고립하여,사심 없이,공평하게,초연히
detached service : x,파견 근무
detachment : n,분리,초월,분견대
detail : n,vt,세부,부분도,상세한 내용,분견대,상술하다,선발하다
detail drawing : x,(건,기)상세도,세부 설계도
detailed : a,상세한
detailedly : a,d,상세하게
detail man : x,(제약 회사의)판매 촉진원
detain : vt,말리다,붙들다,억류하다
detainee : n,억류자
detainer : n,불법 점유
detect : vt,발견하다
detectaphone : n,전화 도청기
detection : n,발견,당지
detection station : x,(핵실험의)감시소
detective : a,탐정의,형사의
detective story : x,탐정 소설
detector : n,발견자
detector car : x,(철도)(선로의 균열을 찾아내는)디렉터차
detent : n,(기)(시계,기계 등을 멈추게 하는)멈춤쇠
detente : n,긴장 완화
detention : n,붙듦,억류,구류,소년원
detention barrack : x,(영군)영창
detention camp : x,포로 수용소,억류소
detention center : x,(영)단기 소년원,강제 수용소
detention home : x,(미)소년원,소년 구치소
detention hospital : x,격리 병원
deter : vt,방해하다,단념시키다
deterge : vt,(상처 등을)깨끗이 하다
detergency : n,세정성,정화력
detergent : a,n,깨끗하게 하는,세제
deteriorate : vt,악화시키다,저하시키다
deterioration : n,악화,저하,타락
deteriorative : a,악화하는 경향이 있는,타락적인
determent : n,방해,방지,단념시키는 사정
determinable : a,확정(결정)할 수 있는,(법)종결지어야 하는
determinant : n,결정자,결정 요소
determinate : a,일정한,확정적인,단호한
determination : n,결심,확정,판결,측정
determination : n,결심,확정,판결,측정
determinative : a,결정적인,확정적인
determinative : n,a,결정적인,한정사(관사,지시대명사 따위)
determine : vt,vi,결심시키다,결정하다,한정하다,측정하다,결심하다,결정하다
determined : a,결정된,단호한
determiner : n,결정하는 사람(것),(문법)한정사(the,a,this,your 등 명사를 한정하는 말)
determinism : n,결정론
deterministic : a,결정론(자)적인
deterrence : n,제지,저지,전쟁 억제력
deterrent : a,제지하는,방해하는
detersive : n,=DETERGENT
detest : vt,미워하다,싫어하다
detestable : a,몹시 싫은
detestation : n,혐오
dethrone : vt,폐하다
dethronement : n,폐위,퇴위
detinue : n,(법)(동산의)불법 점유,불법 점유 동산 반환 소송
detonate : vt,폭발시키다
detonation : n,뇌관,기폭약
detonator : n,퇴관,기폭약,신호용 뇌관
detour : n,우회로
detox : n,해독(알코올(마약)중독자의 치료에서)
detoxicant : a,n,해독성의,해독제
detoxicate : vt,...에서 독을 제거하다
detoxication : n,해독
detoxification : n,
detoxify : vt,~의 독성을 제거하다,~을 해독하다
detract : vt,손상시키다,떨어뜨리다
detraction : n,훼손,비방
detractive : a,험담하는,비난하는,욕하는,detractively()ad
detractor : a,훼손의,비방의
detractory : a,=DETRACTIVE
detrain : vi,vt,(문어)열차에서 내리(게 하)다,detrainment()vi,vt,n
detribalize : vt,종족의 인습에서 탈피시키다
detriment : n,손해
detrimental : n,유해한,탐탁지 않은 구혼자(차남,삼남 따위)
detrition : n,마멸,파손
detritus : n,쇄석
Detroit : n,미국 Michigan주 남동부의 대공업 도시(자동차 공업의 중심지)
de trop : a,(F=too many(much))군더더기의,쓸모 없는,도리어 방해되는
detrude : vt,밀어내다,밀치다
detruncate : vt,...의 일부를 잘라내다
Deucalion : n,(그 신)듀칼리온(Prometheus의 아들,처 Pyrrha와 홍수에서 살아남은 인류의 조상)
deuce : n,vt,2점,듀스,불운,재액,시합을 듀스로 만들다
deuceace : n,(주사위의)2와1(가장 나쁜 숫자),(고)불운
deuced : a,(영)정말 분한,저주스러운,굉장한,굉장히,몹시,deucedly()a,ad
deucedly : ad,지독히,지겹도록
deus ex machina : x,극,소설 속의 절박한 장면을 구해주는 사건,부자연한 해결책
Deut, : x,Deuteronomy
deuter- : x,(연결형)(제2의 재)의 뜻(모음 앞에서는 deuter-)
deuteragonist : n,(그리스 극)주역 다음가는 역
deuteranope : n,제2색맹
deuterium : n,중소수
deuterium oxide : x,(화)산화중수소(중수의 하나)
deuterogamy : n,재혼자
deuteron : n,준양자
Deuteronomy : n,신명기
Deutsche mark : n,독일 마르크(독일의 화폐 단위)
Deutsches Reich : n,(제2차 대전 전의)독일(국호)
Deutschland : n,도이치란트
deutzia : n,(식)말발도리나무
deuxchevaux : n,(F=two horses)2마력(짜리 소형 승형차)
Dev, : x,Devon,()x,Devonshire
deva : n,(힌두교,불교)제파(석가의 제자),천신,범천
devaluate : vt,~의 가치를 내리다,평가를 절하하다
devaluation : n,
devalue : vt,가치를 감하다
devastate : vt,약탈하다,망치다,황폐케하다
devastating : a,호된,아주 좋은,대단한
devastation : n,약탈한,망친
devastator : n,약탈(파괴)자
develop : vt,발달시키다,계발하다,전개시키다
developed : a,(국가 등)고도로 발달한,선진의
developer : n,발달하다,발전하다,전개하다
developing : a,발전도상의,개발도상국가
development : n,발달,발전,전개
developmental : a,개발(계발)적인,발달(발육)상의,발생의
developmental biology : x,발생 생물학
development area : x,산업 개발 지구
Development Assistance Committee : x,개발 원조 위원회(OECD소속 기관,약 DAC)
Development Decade : x,유엔(제3세계)개발의 10년
Development theory : x,(생)(라마르크의)진화론
deviant : a,n,(표준에서)벗어난,정상이 아닌,이상한,사회의 상식(습관)에서 벗어난 사람,(특히 성적)이상 성격자
deviate : vi,빗나가게하다
deviation : n,벗어남,일탈,오차,편차
deviationism : n,정당에서의 당규 일탈,주류에서의 이탈
deviationist : n,일탈자
deviator : n,일탈자,빗나가는 것
device : n,계획,고안,장치,도안,의장,기장,계략,혼자 힘으로 하게 내버려두다
devil : n,악마,악인,비상한 정력가,고기에  후추를 발라  굽다,짓찢다,괴롭히다,하청일을 하다
devil's advocate : x,반대를 위한 반대를 하는 사람,결점만 보는 사람,(천교도)시성 조사 심문 검사
devil's bedpost : x,(카드)클럽 5의 패(재수없다고 함)
devil's bones : x,주사위
devil's books : x,=DEVIL'S PICTURE BOOKS
devil's darning needle : x,잠자리
devil's dozen : x,13,13개
devil's food cake : x,초콜릿케이크
Devil's Island : n,악마의 섬,일뒤디아블,(프랑스령 Guiana 앞바다의 섬,원래 유형도)
devil's picture books : x,카드패
devil's tattoo : x,손가락(발끝)으로 책상(마루)을 똑똑 두드리기(흥분,초조의 동작)
Devil's Triangle : x,마의 3각 수역
devildodger : n,(큰 목소리를 내는)설교자
devil dog : x,(미)미국 해병대원(별명)
devildom : n,마계,악마의나라,악마의 지배력(신분)
deviled : a,맵게 한
devilfish : n,낙지
devilish : a,ad,악마같은,극악무도한,극도의
devilism : n,마성,악마 같은 짓,악마 숭배
devilkin : n,작은 악마
devilled : a,=DEVILED
devilmaycare : a,무모한,태평한
devilment : n,악행
devilry : n,무모한 장난,극악무도(한 짓),악마의 소행,마술,악마화,(집합적)악마
deviltry : n,악행,악마의 소행,마법
devil worship : x,악마 숭배
devious : a,우회하는,인륜을 벗어난,꾸불꾸불한
devisable : a,궁래해 낼 수 있는,(법)유증할 수 있는
devisal : n,연구,궁리,고안
devise : vt,n,궁리하다,안출하다,유증하다,유증(재산)
devisee : n,(부동산의)소유자
deviser : n,고안자
devisor : n,유증자
devitalization : n,활력(생명)을 빼앗기,활력(생명)상실
devitalize : vt,~의 생기를 빼앗다
devitaminize : vt,...에서 비타민을 없애다
devitrify : vt,...에서 투명성을 빼앗다,(유리를)불투명하게 하다
devocalize : vt,무성음화하다,devocalization()vt,n
devoice : vt,(유성음을)무성음화하다
devoid : a, ~을 결한,~이 전혀 없는
devoir : n,의무,경의,예의
devolution : n,상전,양도,계승
devolve : vt,맡기다,넘겨지다,넘어가다,돌아오다
Devon : n,잉글랜드 남서부의 주
Devonian : n,데번기
Devonshire : n,데번셔주(영국 남서부의 주)
devote : vt,바치다,~에 몰두하다,~에 전념하다
devoted : a,헌신적인,몸을 바친,골몰하여(하는),애정이 깊은,(고)저주받은,devotedly()a,ad,devotedness()a,n
devotee : n,귀의자,열성가
devotion : n,헌신,전념,귀의,애착
devotional : a,신앙의,기도의,헌신적인,devotionalism()a,,devotionalist()a,
devotionally : a,ad
devour : vt,개걸스럽게 먹다(먹어치우다),멸망시키다,탐독하다
devouring : a,게걸스레 먹는,사람을 괴롭히는,열중시키는,맹렬한,열렬한,devouringly()a,ad
devouringly : ad,게걸들린 듯이,탐하듯이
devout : a,경건한,열심인,성실한
devoutly : ad,독실하게,충심으로,절실히,devoutness()ad,n
dew : n,vi,vt,이슬방울,이슬이 내리다,이슬로 적시다,이슬이 내린다,dewless()n,vi,vt,a
DEW : x,Distant Early Warning
dewan : n,(인도)주 재무장관,(인도 독립 주의)수상
dewater : vt,...에서 물을 없애다(빼다),탈수(배수)하다,dewaterer()vt,탈수기
dewberry : n,(식)듀베리(나무딸기의 일종)
dewclaw : n,(개 발의)며느리발톱,(소,노루 등의)위제,퇴화한 발굽
dewdrop : n,이슬
Dewey : n,John(1859,1952)미국의 철학자,교육가
Dewey classification system : x,도서의 듀이 10진 분류법
dewfall : n,이슬이 내림(맺힘),이슬 맺힐 무렵(저녁 때)
dewily : ad,이슬처럼,조용히,덧없이
dewiness : n,이슬이 흠뻑 내린 상태,이슬에 젖은 상태
dewlap : n,목정,군턱
dewlapped : a,목 아랫살이 처진
DEW line : x,듀라인(북극권 북부에 있는 미국,캐나다 공동의 원거리조기 경보망)
dew point : x,(기상)(온도의)이슬점,노점
dew pond : x,(영)이슬 못(구릉 지방에서 이슬,안개의 수분을 모아 두는,가축용)
dewret : vt,(삼 등을)비,이슬에 맞혀 부드럽게 하다
DEWS : x,Distant Early Warning System(미)원거리 조기 경보망
dewy : a,이슬 맺힌,상쾌한,고요한(잠 등)
dewyeyed : a,(어린이처럼)천진난만한(눈을 가진),티없는,순진한
dex : n,덱스
dexed : a,덱스에 취한
Dexedrine : n,덱서드린(중추신경 자극제)
dexie : n,=DEX
dexter : a,오른쪽의,(방패 무늬바탕의),오른쪽의(마주 보아서 왼편),(고)운이 좋은,길조의
dexterity : n,영리
dexterous : a,능란한,기민한,영리한,
dexterously : a,ad,
dexterousness : a,n
dextr- : 
dextral : a,오른쪽의,오른손잡이의,(고등이)오른쪽으로 감긴
dextran : n,덱스트런
dextrin : n,호정
dextroamphetamine : n,덱스트로암페타민(각성제 및 식욕 억제약으로 씀
Dextrone : n,=DEXTRAN
dextrorse : a,(식)오른쪽으로 감아 올라가는(뿌리에서 보아)
dextrose : n,포도당
dextrous : n,=DEXTEROUS
dey : n,옛 알제리 지방장관의 칭호(프랑스가 점령한 1830년까지의)
DF, : x,direction finder 방위측정 장치
dft, : x,defendant,draft
dg, : x,decigram
DH : x,designated hitter(야구)지명 타자,dirham
dhal : n,달콩(동인도산,식용)
dharmap : n,(힌두교)덕,(불교)법,(지켜야 할)규범,계율
dhobi : n,(인도)(하층 계급의)세탁부
dhobie itch : x,(병리)도비 완선(습진의 일종)
dhole : n,(동)돌(인도의 사나운 들개)
dhoti : n,(인도)(남자의)허리에 두르는 천
Di : x,(화)didymium
DI : x,(미)Department of the Interior,diffusion index,(경)확산 지수,discomfort index불쾌지수
di : x,(연결형)(주로 화)(둘의,이중의)의 뜻
di : pref,...을 통해서,...을 가로질러서,...으로 이루어지는
di : n,디(do와 re의 중간음)
diabase : n,휘록암,농농
diabasic : n, a
diabetes : n,당뇨병
diabetes insipidus : x,(병리)요붕증
diabetes mellitus : x,(병리)진성 당뇨병
diabetic : a,n,당뇨병의,당뇨병 환자
diablerie : n,악마의 소행,요술,마력,악마 연구,악마의 세계
diabolic : a,악마인,극악 무도한,
diabolically : a,ad
diabolicalness : a,n
diabolism : n,마법,악마 숭배,diabolismlist()n,악마주의자,악마 신앙가,악마 연구가
diabolize : vt,n
diabolo : n,디아볼로,공중팽이(손에 든 두 막대 상이에  친실 위로 팽이를 던졌다 받았다 함)
diachronic : a,n
diachylon : n,(약)단연경고
diacid : a,(화)이산(성)의
diacidic : a,=DIACID
diaconal : a,부제(집사)의
diaconate : n,집사들
diacritic : a,구별하는,구별하기 위한
diacritical : a,구별을 위한,구별(판별)할 수 있는
diacritical mark : x,발음 구별 부호
diactinic : a,(물)자외선을 통과시키는
diadem : n,왕관,왕권,왕위
diademed : n,왕관을 쓴
diadem spider : x,무당거미
diaeresis : n,=DIERESIS
diag, : x,diagonal,diagram
diagnose : vt,진단하다
diagnosis : n,진단
diagnostic : a,진단상의,진단에 도움이 되는,(생)특징적인,특징,diagnostically()a,진찰(진단)에 의해서
diagnostician : n,진찰 전문 의사,진단자
diagnostic routine : x,(전산)진단 루틴(프로그램의 잘못,고장 부위를 찾아내는 프로그램)
diagnostics : n,진단학
diagonal : n,대각선의,비낀,diagonally()n,대각선으로,비스듬하게ad
diagonalize[dai'4g5n~5l`aiz,(수)(행렬을)대각선화하다
diagram : n,도표,도식
diagrammatic : a,도표의,도식의,개략의,윤곽만의
diagrammatize : vt,도표로 만들다,도해하다
diagraph : n,작도기,분도척,원도 확대기
dial : n,vt,vi,다이얼,문자반,지침반,다이얼을 도리다,전화를 걸다
dial, : x,dialect,dialectic,dialog
diala : x,(연결형)(전화 호출,전화 응답의 뜻)
dialabus : x,전화 호출 버스
dialaporn : n,전화섹스(전화에 의한 외설적인 회화 서비스)
dialect : n,방언,파생언어,통용어
dialectal : a,
dialect atlas : x,방언(분포)지도
dialectic : a,n,변증적인,변증법
dialectical : a,변증적인
dialectical theology : x,변증법적 신학
dialectician : n,변증가,논법가
dialectology : n,방언학
dialetical materialism : x,변증법적 유물론
dialing : n,다이얼을 돌림,해시계에 의한 시간측정,광산 컴퍼스에 의한 측량,(미)(전화의)국번,지역번호
dialing code : x,(영)(전화의)국번
dialing tone : x,(영)=DIAL TONE
dialog : n,문답,대화
dialogic : a,대화(체)의,문답(체)의
dialogist : n,대화자,대화(극)작가
dialogize : vt,대화하다
dialogue : n,vt,대화,문답,의견 교환,(극,이야기중의)대화 부분,대화하다
Dialogue Mass : x,(천주교)대화 미사
dial plate : x,(시계의)문자판,(계기의)지침(표시)판
dial telephone : x,(미)다이얼식 자동 전화
dial tone : x,전화의 발신인
dialup : a,(컴퓨터 단말기 등과의 연결이)전화 회선에 의한(을 이용한)
dialyse : vt,(영)=DIALYZE
dialytic : a,(화)투석(성)의,투막성의
dialyze : vt,(화)투석하다,여막 분석하다,dialyzable()vt,a
dialyzer : n,투석기,여막 분석기,인공 신장
diam : x,diameter
diamagnet : n,(물)반자성체
diamagnetism : n,반자성학
diameter : n,직경
diametics : n,다이어네틱스(해로운 심상을 제거함으로써 병을 치료하려는 심리요법)
diametral : a,직경의
diametric : a,직경의,정반대의,diametrically()a,ad
diametric : a,직경의,정반대의,완전히 대립하는
diametrically : ad,직경 방향으로,정반대로,바로
diamond : n,다이아몬드,금강석,마름모꼴,천연 그대로의 다이아몬드,거칠지만 실은 훌륭한 인물
diamond anniversary : x,(결혼 등의)60주년(때로는 75주년)기념일
diamondback : n,마름모 무늬가 있는 동물
diamondback moth : x,배추좀나방
diamondback rattlesnake : x,(동)방울뱀
diamondback terrapin : x,(동)(북미산 식용)후미남생이
diamondcut : x,마름모 꼴로 다듬은(자른)(보석 등)
diamondcutter : n, 금강석을 다듬는 사람
diamond drill : x,(광산용)검정 다이아 시추기
diamond dust : x,다이아몬드 분말(연마용)
diamondfield : n,다이아몬드 채굴지(산지)
Diamond Head : x,다이아몬드 헤드(하와이주 Oahu섬 남동부의 곶을 이룬 사화산)
diamondiferous : a,다이아몬드가 있는(산출되는)
diamond jubilee : x,60 또는 75주년 축전
diamond wedding : x,다이아몬드 혼식(결혼 75 또는 60주년 기념식)
Dian : n,(시)=DIANA
Diana : n,달의 여신(처녀성과 사냥의 수호신)
dianthus : n,(식)패랭이속의 각종 식물
diapason : n,선율,음역
diaper : n,마름모꼴
diaper cover : x,기저귀 커버
diapered : a,마름모꼴 무늬가 있는
diaper rash : x,(미)기저귀로 인한 헌데
diaper service : x,기저귀 대여업
diaphanography : n,(의)투과 검사(법)
diaphanous : a,투명한,비치는
diaphone : n,무적,안개 고동,(언)방언적인 이음
diaphoresis : n,(인위적인 다량의)발한,발한 요법
diaphoretic : a,발한 촉진성의,발한약
diaphragm : n,진동판,조리개
diaphragmatic : a,횡격막의,격막의,칸막이벽(모양)의
diapositive : n,투명 양화(포지)(슬라이드 등)
diarchial : a,양두정치의
diarchy : n,양두정치
diarial : a,일기(체)의
diarisric : a,일기식(체)의
diarist : n,일기를 쓰는 사람,일지 담당자,일기 작가
diarrhea : n,설사
diary : n,일기,일기장
Dias : n,디어스(포르투갈의 항해자,희망봉 발견자)
diascope : n,(투명한 물건을 보는)투영경,(의)유리 압진기
Diaspora : n,유대인의 분산
diastase : n,디아스타제,전분 당화효소
diastatic : a,(생화)디아스타제(성)의,당화성의
diastole : n,심장 확장
diastolic : a,심장 확장(기)의
diastolic pressure : x,(의)확장기 혈압(최소 혈압)
diastrophism : n,지각변동
diatessaron : n,(4복음서를 정리한)공관 복음서
diathermancy : n,(물)투열성,열이 통함
diathermanous : a,(물)투열성의
diathermic : a,(의)투열 요법의,(물)투열성의
diathermy : n,투열요법
diathesis : n,질병 체질(특정 병에 걸리기 쉬운 소질)
diathetic : a,(의)소질상의,특이 체질의
diatom : n,(식)규조(돌말)(식물)
diatomaceous : a,규조류의,규조토의
diatomic : a,2가의
diatonic : a,온음계의
diatribe : n,통렬한 비판,혹평
diazepam : n,(약)다이아제팜(진정제의 일종)
diazine : n,(화)다이아진
diazo : a,n,(화)2질소의,디아조 화합물,(특히)디아조 염료,=DIAZOTYPE
diazo dye : x,(화)디아조 염료(면,레이온용)
diazotype : n,다이아조타이프(사진 인화법의 일종)
dib : n,(lawn bowling에서)표적용 작은 백구,(영)(카드)잭 놀이,몫,1달러
dibasic : a,이염기의
dibber : n,=DIBBLE
dibber bomb : x,활주로(파괴용)폭탄
dibble : n,vt,구멍 파는 기구,구멍을 파다
dibbuk : n,=DYBBUK
dibs : n,(소액의)돈,(미)요구,청구권
dice : 주사위,작은 입방체,주사위  놀이를 하다,주사위 노름으로  잃다,야채 따위를 골패짝 모양으로 썰다
dicebox : n,(주사위를 흔들어 내는)주사위통
dicephalous : a,(의)쌍두의
diceplay : n,주사위놀이,도박
dicer : n,주사위놀이를 하는 사람,노름꾼,(미)중산 모자,헬멧
dich- : x,(연결형)(둘로 나뉜)의 뜻(모음 앞에서는 dich-)
dichlor- : x,(연결형)(염소 2원자를 함유한)의 뜻(모음앞에서는 dichlor-)
dichloride : n,(화)2염화물
dichlorophenlxyacetic acid : x,(화)디클로로페녹시아세트산(그 나트륨염은 제초제)
dicho- : x,(연결형)=DICH-
dichotic : a,(소리의 높이,세기가)좌우의 귀에 다르게 들리는
dichotomize : vt,2분하다
dichotomous : a,양분된,2분법의,(식)(가지,잎맥이)두 갈래로 갈라진
dichotomy : n,2분하는 일,2분법
dichroism : n,(결정,화)2색성(각도,농도에 따라 색이 달라 보이는)
dichromate : n,(화)중크롬산염
dichromatic : a,두 색의
dichromaticism : n,=DICHROMATISM
dichromatism : n,2색성,(동)2변색성,(안과)2색형 색맹
dichromic : a,(화)중크롬의,중크롬산의,중크롬산을 나타내는
dicing : n,=DICEPLAY,(가죽 표지의)마음모꼴 장식,주사위 모양으로 자름
dick : n,선서하다,형사,놈,녀석,
Dick : n,남자 이름,남자의 일반적인 명칭
dick charges : x,독 사용료
dickens : n,=DEVIL
Dickens : n,디킨즈(영국의 소설가)
Dickensian : a,Dickens(류)의
dicker : n,vi,조그마한 장사를 하다,물물 교환을 하다,값을 깍다
dickey : n,당나귀
dickeybird : n,(영)작은 새,(영)한마디 말
dick glass : x,시음용 큰 술잔
Dickinson : n,디킨슨
Dick test : x,(의)딕 테스트(성홍열 피부 시험)
dickty : a,n,=DICTY
diclimous : a,(식)자웅 이화의,암수딴꽃의,단성의
dicotyledon : n,쌍자엽 식물
dicoumarin : n,(화)디쿠마린,디쿠마롤(혈액 응고 방지제,혈전 치료용)
dict, : x,dictated,dictator,dictionary
dicta : n,dictum의 복수
dictabelt : n,구술 녹음기용 녹음 벨트
dictagraph : n,=DICTOGRAPH
Dictaphone : n,딕터폰(속기용 구슬 녹음기)
dictate : vt,받아쓰게하다,명령하다,명령,지령
dictation : n,수술,받아 쓰기,명령,지령
dictator : n,구술자,명령자,독재자
dictatorial : a,독재자의,독재적인,명령적인
dictatorship : n,독재정권
diction : n,말씨,용어
dictionary : n,사전,사서
dictionary catalog : x,(도서관)사서체 목록(저자,책명,건명 등 모든 기입과 참조를 알파벳 순으로 배열한 목록)
dictionary English : x,딱딱한 영어
Dictograph : n,딕토그래프(고성능 송화기로 별실의 대화를 몰래 청위 녹음해 두는 장치)
dictum : n,단언,명언,격언
dicty : a,n,(미)고급의,훌륭한,상류인체하는,거만한,귀족,부자
Dicumarol : n,디큐마롤
did : v,do의 과거
DID : x,densely inhabited district인구 밀집 지구
didactic : a,교훈적인
didacticism : n,교훈(계몽)주의,교훈적 경향
didactics : n,교수법(학),교훈,교의
didapper : n,(조)농병아리
diddle : vt,편취하다,낭비하다
Diderot : n,Denis(1713~1784)프랑스의 철학자,비평가
didie : n,(아기의)기저귀
didn't : x,did not의 단축형
dido : n,까불기
didst : v,=DID
didymium : n,디디뮴
didymous : a,쌍생의,쌍의
die : n,주사위,거푸집,나사틀,죽다,희미해지다,소멸하다
dieaway : a,n,힘 없는,풀이 죽은,(소리 등이)차차 멀어져 감
diecast : vt,DIE CASTING방법으로 주조하다
die casting : x,다이캐스팅,압력 주조,다이 주물
diecious : a,(생)=DIOECIOUS
diehard : a,끈덕진,끝까지 저항하는
diein : n,다이인(참가자가 죽은 것처럼 드러눕는 시위 행동)
dieldrin : n,디엘드린(살충제의 일종)
dielectric : a,n,유전성의,절연성의,(전도체와 구별하여)유전체,절연체
Dien Bien Phu,Dienbienphu : n,디엔비엔푸(인도지나 전쟁에서의 프랑스군 기지)
dieresis : n,분음기호
diesel : n,디젤차
dieselelectric : a,n,(기관차,배,자동차 등이)디젤 발전기의(를 갖춘),디젤 전기 기관차
diesel engine : x,디젤 엔진(기관)
dieseling : n,(가솔린엔진의)디젤링(스위치를 꺼도 엔진내의 과열점에 의해 자기 점화하여 회전을 계속하는 일
dieselize : vt,디젤 기관을 달다
diesel oil : x,디젤유
diesinker : n,찍어내는 틀을 만드는 사람
Dies Irae : n,(L=day of wrath)노여움의 날,최후의 심판날
diesis : n,=DOUBLE DAGGER
dies non : n,(L)(법)휴정일,유업일
diesohol : n,디젤유와 알코올의 혼합물(디젤 엔진의 연료)
diet : n,상식,규정식,규정식을 주다,정식회의,국회,의회
dietary : a,식사의
dietary fiber : x,음식 섬유
dietary law : x,(유대교)음식 금기(돼지 고기 등을 먹지 않는 일)
dietetic : a,식사의
dietetics : n,식이 요법,영양학
diet food : x,식이 요법 식품
dietist : n,=DIETITIAN
dietitian : n,영양사
diet Kitchen : x,(병원 등의)규정식 조리실
diet list : x,(식이 요법용의)규정식표
diet pill : x,(미)(약)다이어트 정(호르몬,이뇨제 등의 체중 감량제)
Dieu et mon droit : n,(F)신과 나의 권리(영국 왕실 문장에 쓰여진 표어)
dif, : x,difference,different,differential
dif- : pref,=DIS(f 앞에 올때)
differ : vi,다르다,의견을 달리하다
difference : n,다름,차이점,불화
different : a,다른,여러가지의
differentia : n,차이점,(특히)본질적 차이,(논)종차,특이성
differential : a,차별의,차별적인,특징의,미분의,미분,차동장치,차별 관세,협정 임금차
differential analyzer : x,(전산)미분 해석기(아날로그 계산기의 한 가지)
differential calculus : x,(수)미분학
differential equation : x,(수)미분방정식
differential gear : x,(기)차동 장치
differential rate : x,(철도 등의)특정 운임률
differentiate : vt,차별하다,분화시키다,미분하다
differentiation : n,구별,분화,변이,특수화,미분
differently : ad,다르게,같지 않게,따로,별도로
difficile : a,남과 어울리지 않는,성미가 까다로운,
difficult : a,어려운,까다로운,다루기 힘든
difficulty : n,곤란,난국,지장,이의,논쟁,궁박
diffidence : n,자신 없음,암띰,망설임
diffident : a,자신없는,수줍은,자신없음,암띰,망설임
diffluence : n,유출,유동성,용해,융해
diffluent : a,유출성의,녹아 흐르는,융해(용화)의
diffract : vt,회절시키다
diffraction : n,회전
diffraction grating : x,(광)회절 격자
diffractive : a,회전하는,분해하는
diffusate : n,(물)확산체,(화)투석물
diffuse : vi,발산하다,유포시키다,퍼진,유포한,산만한
diffused : a,확산된,널리 퍼진
diffusely : ad,산만하게,장황하게,널리(보급하여)
diffuseness : n,산만,장황,확산(성)
diffuser : n,유포(보급)시키는 사람,(기체,광선,열 등의)확산기,방산기,살포기
diffusibility : n,보급(분산)력,(물)확산율(성)
diffusible : a,퍼지는,보급(확산)할 수 있는,(물)확산성의
diffusion : n,산포,유포,보급,산만
diffusion index : x,확산 지수,경기 동향 지수
diffusion pump : x,확산 진공  펌프(가스의  확산을 이용하여 높은 진공도를 만듦)
diffusive : a,잘 퍼지는,보급되기쉬운,보급력 있는,확산성의,산만한,장황한
dig : 파다,캐내다,탐구하다,찌르다,주의를 기울이다,알다,좋아하다,파다,파서 뚫다,파나가다,탐구하다,꾸준히 공부하다,한번 찌르기,쿡 찌르기
digamist : n,재혼자
digamma : n,디감마
digamous : a,재혼의
digamy : n,재혼
digenesis : n,세대 교번
digest : vt,vi,n,소화하다,이해하다,납득하다,참다,요약하다,간추리다,소화되다,삭다,요약
digestant : n,(의)소화제
digester : n,소화자,소화(촉진)제,(요리)수프 끓이는 냄비,다이제스트 기자(편집인),요약정리자
digestibility : n,소화성
digestible : a,소화되기 쉬운,요약할 수 있는
digestion : n,소화,소화 작용,소화제
digestive : a,n,소화의,소화제
digestive system : x,(해)소화기 계통(입,위,장 등)
digger : n,파는 사람,갱부,음식물을 도르는 따위의 봉사를 하는 히피
digger wasp : x,나나니벌
digging : n,채굴지,채광,금광
dight : vt,(고시)차리다,갖추다
digit : n,손가락,아라비아 숫자
digital : a,손가락의,계수형인,디지털형의
digital clock : x,디지털 시계
digital computer : x,계수형 전자 계산기
digitalis : n,디기탈리스
digitalize : vt,(전산)디지털화하다,계수화하다
digital recording : x,디지털 녹음
digitate : a,손가락이 있는,손가락 모양의
digitation : n,(생)지상 분열,지상 조직(돌기)
digiti- : x,(연결형)(손가락)의 뜻
digitiform : a,손가락 모양의
digitigrade : a,n,(동)발가락으로 걷는,지행 동물(개,고양이 등)
digitize : vt,~을 디지탈화하다,계수화하다,digitization()vt,n
digitizer : n,디지털(계수화)장치
diglossia : n,(언)두언어 변종 사용
diglot : a,n,2개 국어로 쓰인(말하는),2개 국어판(로 된 책)
dignified : a,위험 있는,고귀한
dignify : vt,위엄을 부여하다
dignitary : n,소위 성직자,고승,귀인,고관
dignity : n,위엄,존엄,관록,품위,체면에 관계되다,위신을 손상 시키다)
digraph : n,겹자
digress : vi,탈선하다,본론에서 벗어나다
digression : n,지엽으로 흐름,여담,탈선,(천)이각
digressive : a,본론을 떠난,지엽적인
digs : n,(영)하숙
dihedral : a,이면으로 된,이면각,상반각
dihydr- : x,(연결형)(화)(수소 원자 2개를 포함한)의 뜻
dihydrostreptomycin : n,(화,약)다이하이드로 스트렙토마이신(결핵 특효약)
dikdik : n,(동)작은 영양(아프리카산)
dike : n,둑,둑을 쌓다,도랑을 만들다
diktat : n,(패자 등에 대한)절대적명령,일방적 결정,강권 정책
dil, : x,dilute
Dilantin : n,(약)다일랜틴
dilapidate : vt,vi,(건물 등을)헐다,헐어지다,황폐하다,(가산을)탕진하다,낭비하다
dilapidated : a,황폐한,황랑한
dilapidation : n,황폐,무너짐,사태,허물어진 것(암석 등).(영법)(가구 딸린 셋집의)손모료
dilatability : n,팽창력(성,률)
dilatable : a,부풀어 오르는,퍼지는,팽창성의
dilatancy : n,(물)다일레이턴시(입자가 강력한 외력에 의해서 액체를 흡수하여 부풀어 굳어지는 현상)
dilatant : a,팽창성의,확장성의,(물)다일레이턴시의(를 나타내는)
dilatation : n,확장,팽창
dilatative : a,=DILATIVE
dilate : vt,넓게 펴다,팽창시키다,확장시키다,부연하다,상세히 말하다,부여하다
dilation : n,=DILATATION,(몸 일부의)팽창
dilative : a,팽창성의
dilatometer : n,팽창계
dilator : n,확장근
dilatory : a,완만한,느린,
dilatoriness : a,지연,늑장,꾸물거림
dilatorily : a,느리게
dildo : n,남근 모양으로 만든 성구
dilemma : n,진퇴양난,궁지,딜레마
dilemmatic : a,딜레마의(같은),진퇴 양난이 된,양도 논법적인
dilettante : n,a,예술 애호가,아마추어 예술가,딜레탕트풍의
dilettantish : a,도락 기분의,딜레탕트적인
dilettantism : n,예술 애호,서투른 기예,도락
diligence : n,부지런함,근면,승합마차
diligent : a,부지런한
diligently : ad,부지런히,열심히,애써
dill : n,(식)이논드(미나리과,열매나 잎은 향료,성경에서 일컬어지는 anise)
Dillon's Rule : x,(미법)딜론의 원칙(지방 자치체의 권한은 주헌법 또는 법에 명기된 것에 한한다는 원칙)
dill pickle : x,시라로 양념한 오이지
dilly : n,a,멋진 것,놀랄 만한 것,어리석은
dilly bag : x,(음식을 담아 다니는)망태기,바구니(원래는 갈대,목피제)
dillydally : vi,꾸물대다,빈둥거리다
diluent : a,n,묽게하는,희석용의,(의)희석액
dilute : vt,묽게하다,희석하다,약하게하다,묽게 한,약한,dilutive()vt,a
dilutee : n,비숙련공
dilution : n,묽게 함,희석,(영)노동 희석(과히 숙련이 필요없는 일에 임시로 비숙련공을 쓰는 일)
diluvia : n,DILUVIUM의 복수
diluvial : a,홍수의,홍적기의
diluvial formation : x,홍적층
diluvial theory : x,(지질)홍수설(노아의 홍수를 지구 역사상 최대의 사실로 보며 화석을 홍수로 사멸한 생물의 유체로 봄)
diluvium : n,홍적층
dim : 어둑한,어슴푸레한,희미한,둔한,비관적인,어둑하게  하다,어둑해지다,둔하게 하다,둔해지다,흐려지다,흐리게 하다
dim, : x,dimension,diminuendo,diminutive
dime : n,10센트 은화
dimeadozen : a,헐한,값싼,서투른
dime museum : x,간이 박물관,싸구려 구경거리
dime novel : x,삼문(저질)소설
dimension : n,치수,차원,용적,규모,크기
dimensional : a,(종종 복합어를 이루어)치수의,...차원의,dimensionally()a,ad
dimensionless : a,크기가 없는(길이도 폭도 두께도 없는 점)
dimerous : a,두 부분으로 갈라진,(식)(꽃 등)이수성의 기관을 가진,
dime store : x,(미)10센트(싸구려)잡화점
dimeter : n,이보구(각운 두개로 이루어지는 시행)
dimethylnitrosamine : n,(화)디메틸니트로사민(담배 연기 등에 함유된 발암 물질)
dimidiate : a,둘로 나뉜,양분된,절반의
dimin, : x,diminuendo,diminutive
diminish : vt,줄이다,감소시키다
diminished : a,감소(감손)된,권위(위신)가 떨어진,(악)반음 줄인
diminished responsibility : x,(법)한정 책임 능력(감형 대상이 되는,정신 장애로 인한 판단력 감퇴 상태)
diminished seventh : x,감 칠화음
diminishing : a,점감하는
diminishing returns : x,(경)수익 체감,
diminuendo : ad,점점여리게
diminution : n,김소,축소
diminutival : a,축소적인,지소사(성)의,(문법)축소형 어미
diminutive : a,작은,지소의,지소사
dimissory : a,쫓아내는,떠나게 하는,떠나는 것을 허가하는
dimissory letter : x,(기독교)(감독이 내는)목사의 전임허가장
dimity : n,돋을 줄무늬 무명
dimly : ad,어스레하게,어둑하게,어렴풋이,희미하게
dimmer : n,제광기,조광기
dimmer call : x,식사 신호,(미)(만찬 대접에 대한)답례 방문
dimmish : a,어스레한
dimness : n,어스레함,어둑함,희미함
dimocceras : n,(고생)공각수
dimorphic : a,동종 이형의,동질 이상의
dimout : n,등화 관제
dimple : n,보조개,보조개가 생기다,움푹 들어가다,잔물결이 일다
dimply : a,보조개가 있는,잔물결이 이는,파문이 많은
dimsighted : a,시력이 약한
dim sum : x,점심(밀가루 반죽으로 고기,야채 등을 싸서 찐 중국요리)
dimwit : n,멍청이,얼간이
dimwitted : a,바보의
din : n,소음,소음이 나다,뇌고 되뇌이다
DIN : x,Deutsche Industrie Normen(G=German Industry Standard)독일 공업품 표준 규격
din- : x,(연결형)(무서운)의 뜻(모음 앞에서는 din-)
Dinah : n,여자 이름
dinar : n,디나르,요르단,튀니지,유고슬라비아의 화폐 단위,디나르(7세기 말 이래 수세기 동안 회교국의 화폐 단위)
dinch : vt,(담배를)비벼 끄다
dindin : n,=DINNER
dine : vi,식사를 하다,정찬을 들다
diner : n,식사하는 사람,정찬의 손님,(미)식당차,
Diner's Cl'ub : x,다이너스 클럽(회원제 신용 판패 조직)
dinerout : n,자주 (초대되어)밖에서 식사하는 사람
dinette  : n,(미)(가정의)작은 식당
dineutron : n,이중 중성자
ding : vi,땡땡 울리다,시끄럽게 말하다,자꾸 뇌까리다,되풀이하여 일러주다
dingaling : n,바보,얼간이,괴짜
Ding an sich : x,(G)(철)물 자체
dingbat : n,(미)...하고 하는 것,(미)바보,미치광이,장치,고안,장식 활자,장식괘
dingdong : n,ad,a,땡땡(종소리),부지런히,접전의
dinge : n,a,흑인(의)
dinger : n,결정적 요소,결정타,홈런,방랑자,쓸모없는 인간,아는 체하는 사람
dinghy : n,작은 배
dingily : ad,거무죽죽하게,그을려
dinginess : n,구중중함,거무죽죽함,더러움
dingle : n,깊은 협곡
dingo : n,(동)(오스트레일리아산)들개,(미)게으름뱅이,배반자,비겁자
dingus : n,이름을 알수 없는 것
dingy : a,거무스름한,더러운,지저분한,그을은
dining : n,식사
dining room : x,식당
dining table : x,식탁
dinitrobenzene : n, (화)디니트로벤젠(매염제)
dink : n,음경,베트남사람
dinkey : a,n,작은,왜소한,빈약한,미숙한,청초한,멋진,예쁜,소형 기관차
dinkum : a,진짜의,믿을 수 있는,훌륭한
dinkum oil : x, 사실 그대로의 진상,진실
dinky : a,(영)말쑥한,귀여운,산뜻한,(미)작은,사소한
dinkydi : n,=DINKUM
dinner : n,정찬,만찬,오찬
dinner bell : x,정찬을 알리는 종
dinner clothes : x,(정찬용)정식 야회복
dinner coat : x,=TUXEDO
dinner dress : x,(여자용)약식 야회복
dinner hour : x,정찬 시각
dinner jacket : x,(남자용)약식 야회복,그 상의
dinner knife : x,(식사의)메인 코스용 나이프
dinnerless : a, 정찬이 없는,단식하는
dinner party : x,만찬회,축하연
dinner plate : x,정찬용 접시(식사 때 주요한 음식을 담는 크고 편편한 접시)
dinner service : x,정찬용 식기 한 벌
dinner table : x,식탁
dinner theater : x,디너 시어터,극장식 식당
dinner time : x,정찬 시각
dinner wagon : x,(바퀴 달린)이동 식기대
dinnerware : n,식기류
dinng hall : x,대식당
dinning car : x,식당차
dino- : x,(연결형)=DIN-
dinosaur : n,공룡,dinosauric()n,
dinosaurian : n,a,공룡(의)
dinothere : n,(고생)공수(제 3기 신생대의 코끼리 비슷한 포유 동물)
dint : n,vt,두들겨 움푹 들어간 곳,두들겨서 자국을 내다
dioc, : x,diocesan,diocese
diocesan : n,주교 관구의
diocese : n,주교 관구
diode : n,다이오드,2극 진공관
dioecious : a,자웅 이주의
dioecism : n,(생)자웅 이주,암수딴그루
dioestrum : n, (생)(동물,특히 암컷의)발정기
Diogenes : a,디오게네스(통속에서 알몸으로 살았다느니 하는 그리스의 철인)
Diomede : n, (그신)디오메데스(트로이 전쟁 때의 그리스의 용사)
Dionysia : n, (옛그리스)디오니소스제,주신제
Dionysiac : a,DIONYSUS(제)의
Dionysius : n,그리스의 Syracuse의 참왕
Dionysiussos : n,=BACCHUS
Diophantine equation : x,디오판투스 방정식(부정방정식의 해법을 연구한 그리스 수학자의 이름에서)
diopside : n,투휘석(준 보석)
diopter : n,디옵터(렌즈 굴절유리 등의 단위)
dioptric : a,굴절의,광학의
dioptrics : n,굴절 광학
Dior : n,디오르(프랑스의 패션 디자이너)
diorama : n,디오라마
dioramic : a,디오라마의(적인),투시화의
diorite : n,섬록암
Dioscuri : n,(제우스의 아들들)의 뜻에서,(그신)디오스쿠리
dioxide : n,이산화물
dioxin : n,(화)다이옥신(독성이 강한 유기염소 화합물,제초제 등)
dip : vt,담그다,적시다,살짝 적시다,살충액에 담그어 씻다
DIP : x,(전자)dual inline package
Dip, : x,diploma
Dip,A,D, : x,(영)Diploma in Art and Design
diphase : a,(전)이상성의
diphasic : a,=DIPHASE
diphosphate : n,이인산염
diphtheria : n,디프테리아
diphtheritic : a,(병리)디프테리아성의,디프테리아에 걸린(점막 등)
diphthong : n,2중 모음
diphthongal : a,(음성)2중모음(성)의
diphthongize : vt,(음성)2중모음화하다
dipl, : x,diplomacy,diplomat,diplomatic
dipl- : x,(연결형)(이중...,복...)의 뜻
diplex : a,(통신)이중 통신의,이신의
diplococcus : n,쌍구균
diploid : a,2중의,배성의,배수의
diploma : n,졸업 증서,힉위 증서,면허장
diploma'd : a,DIPLOMA를 가진
diplomacy : n,외교 수완
diplomaism : n,학력주의,학력 편중
diploma mill : x,(미)학위 남발 대학,삼류 대학
diplomat : n,외교관
diploma tax : x,고등 교육을 받은 소련 시민이 외국 이주시에 부과되는 세금
diplomate : n,(위원회로부터 인증을 받은)자격 취득자,전문가,전문 의사
diplomatic : a,외교상의,외교에 능한,고문 서학의
diplomatic bag : x,=DIPLOMATIC POUCH
diplomatic corps : x,외교단
diplomatic immunity : x,외교관 면책 특권
diplomatic pouch : x,(본국 정부와 재외 공관간의)외교 통신 문서낭,외교 파우치
diplomatics : n,고문서학,(고)외교술
diplomatic service : x,외교관 근무,(집합적)공관원
diplomatic shuttle : x,(왕복 외교에 있어서의)왕복
diplomatist : n,(영)=DIPLOMAT
diplomatize : vi,외교술을 쓰다,외교적 수완을 발휘하다
diplopia : n,(안과)복시
dip needle : x,경침(지자기의 복각을 측정하는 자침)
dipnoan : a,n,(어)폐어류의(물고기)
dipolar : a,(전,화)2극성의(자석,분자 등)
dipole : n,쌍극자,2극 안테나
dipper : n,적시는 사람,국자,북두칠성
dipping needle : x,=DIP MEEDLE
dippy : a,미친,환장한,멍청한,바보 같은
dipso : n,a,알코올 중독자,대주가,알코올 중독의
dipsomania : n,발작성 음주광
dipsomaniac : n,음주광,술미치광이
dipstick : n,유량계(탱크 등의 속에 넣어  재는)
dip switch : n,방현 스위치(헤드라이트를 숙이는)
dipt : v,dip의 과거
Diptera : n,쌍시류
dipteral : n,=DIPTEROUS,(건)이중 열주당
dipteran : n,a,쌍시류(의)
dipteros : n,(건)이중 열주당
dipterous : a,쌍시(류)의,날개가 둘 달린
diptych : n,둘로 접힌 물건,(고대 로마의)둘로 접힌 글판(서책),(제단 뒤에 세우는)둘로 접힌 그림(조각)
dir, : x,director
dircct primary : x,직접 예선
dire : a,무서운,극도의,긴급한
direct : vt,리더하다,관리하다,감독하다,연출하다,돌리다,똑바른,솔직한
direct action : x,직접 행동 권리를 위한 파업(데모,시민적 저항 등)
direct current : x,직류
direct discourse : x,(미)(문법)=DIRECTNARRATION
directed : a,유도된,지시받은,규제된
directedenergy weapon : x,(군)(대 핵미사일용)빔무기
direct evidence : x,(법)(증인이 되는)직접 증거
direct initiative : x,(정)직접 발의권
direction : n,방위,방향,경향,지휘,명령,지도
directional : a,방향(방위)(상)의
direction finder : x,방향 탑지기,방위 측정기
direction indicator : x,방향 지시기
directive : a,지시하는,지도적인
directly : ad,곧바로,직접으로,즉시
direct method : x,(외국어의)직접 교수법(외국어만으로 가르치며 문법 교육도 하지 않음)
direct narration : x,직접 화법
directness : n,똑바름,직접적임,솔직함
direct object : x,(문법)직접 목적어
Directoire : n,a,집정부(시대의)
director : n,지휘자,지도자,중역,감독
director's chair : x,(캔버스제의)접는 의자
directorate : n,간부회
director general : x,총재,장관(비영리 단체의)회장,사무총장
directorial : a,지휘자의,관리자의
directorship : n,DIRECTOR의 직(임기)
directory : n,주소 성명록,인명부,지령서,예배 규칙서
direct proportion : x,정비례
direct ratio : x,(수)정비,정비례
directrix : n,=DIRECTRESS,(수)준선,(군)주선(포화 사계의 중심선)
direct speech : x,(문법)=DIRECT NARRATION
direct tax : x,직접세
directtress : n,DIRECTROR의 여성형
diredt mail : x,다이펙트 메일(직접 개인이나 가정으로 보내지는 공고 우편물)
direful : a,무서운,무시무시한
direttissima : n,(등산)수직 등반
dirge : n,만가,애도가
dirgeful : a,장송의,구슬픈
dirham : n,디램(모로코 등의 화폐 단위)
dirigibility : n,조종 가능성
dirigible : a,조종할 수 있는,비행선
dirigisme : n,(경)통제 경제 정책
dirily : ad,=dryly
diriment : a,(법)무효로 하는
diriment impediment : x,(법)(혼인을 무효로 하는)절대 장애
dirk : n,단검
dirndl : n,여성복
dirt : n,쓰레기,먼지,오물,진흙,흙,토지,비열한 언사,욕,굴욕을 참다,욕을 하다)
dirt bed : x,(지질)이토층
dirtbike : n,(비포장 도로용)오토바이
dirt cheap : a,똥값으로
dirteater : n,흙을 먹는 사람
dirteating : n,(야만인의)흙을 먹는 풍습,(병리)(어린애의)토식증
dirt farm : x,(미)(낙동장 등에 대하여)보통 농장,밭
dirt farmer : x,자작농
dirtheap : n,쓰레기 더미
dirtily : ad,불결하게,상스럽게,비열하게
dirtiness : n,불결,상스러움,비열
dirt pie : x,(아이들이 만든)진흙떡
dirt poor : x,몹시 가난한
dirt road : x,포장하지 않은 도로
dirt track : x,진흙이나 석탄재 등을 깐 트랙(오토바이 등의 경주로)
dirt wagon : x,(미)청소차,쓰레기 운반차
dirty : a,더러운,추잡한,비열한,날씨가 엄청 더운
dirty dog : x,비열한 놈,신용할 수 없는 자
dirty linen : x,집안의 수치,남부끄러운 일
dirty look : x,(미)보기 흉한(싫은)얼굴
dirtyminded : a,속마음이 더러운,치사한,앙큼한
dirty money : x,부정한 돈
dirty old man : x,색골 영감,호색 노인
dirty pool : x,치사한 행위,부정한 방법
dirty story : x,(미)음탕한 이야기
dirty trick : x,비겁한 짓(선거 운동 방해,정부 전복 등을 목적으로 한)부정 공작
dirty wash : x,=DIRTY LINEN
dirty word : x,야비(음란)한 말,입에 담을 수 없는(담아서는 안 될)말
dirty work : x,사기,속임수,싫은(구차스러운)일
Dis : n,(로신)디스(저승의 신,(그신)의 Pluto),하계,지옥
dis : (동사에 붙여서)(반대동작)의 뜻,(명사에 붙여서)(없애다,벗기다,빼앗다)등의 뜻의 동사를 만듦,(형용사에 붙여서)(...않게 하다)(명사,형용사에 붙여서)(불,비,무)의 뜻,(분리)의 뜻,부정의 뜻을 강조함,di-의 변형,dissyllable
dis, : x,discharge,disciple,discipline,discount,distance,distant,distribute
disability : n,무력,무능,불구,무자격
disable : vt,무력하게하다,불구로 만들다,무자격하게 만들다
disabled : n,불구가 된,신체 장애자
disablement : n,무력화
disabuse : vt,~의 어리석음을 깨닫게 하다
disaccharide : n,(화)이당(류)
disaccord : n,vt,불화,일치하지 않다
disaccredit : vt,...의 자격을 뺏다,...에 대한 인정을 취소하다
disaccustom : vt,...에게 습관을 버리게 하다
disadapt : vt,적응 못하게 하다
disadvantage : n,불리한 입장,불편
disadvantaged : a,불리한 조건을 가진,(사회적,경제적으로)혜택을 받지 못한
disadvantageous : a,
disaffect : vt,(사람)에게 불만을 품게 하다,(실망하여)배반케 하다
disaffected : a,싫어진,불만스러운,정떨어진,마음이 떠난,배반한
disaffection : n,불평,(특히 정부에 대한)불만,민심 이탈
disaffiliate : vt,(단체에서)...을 제명하다,(...와)인연을 끊다,탈퇴하다
disaffirm : vt,부정(거부)하다,(앞서 한 말을)취소 하다,(법)부인하다,(전의 판결을)파기하다
disaffirmance : n,거부,부정,(법)부인,파기
disafforest : vt,(영법)(삼림법의 적용을 해제하여)보통 토지로 만들다,(삼림지를)개척하다
disafforestation : n,(영법)삼림법 적용 해제,삼림 벌채
disaggregate : vt,vi,(집적물등)성분(구성 요소)으로 분해하다(되다)
disagree : vi,일치하지 않다,맞지 않다,의견을 달리하다,다투다
disagreeable : a,불쾌한,까다로운(hard to please)
disagreement : n,불일치,의견 차이,논쟁
disallow : vt,허가하지 않다,부인하다,각하하다(reject)
disallowance : n,무효로하다
disambiguate : vt,(문장,서술 등의)애매한 점을 없애다,명확하게 하다,disambiguation()vt,
disamenity : n,(영)(장소 등의)불쾌,불편
disannul : vt,취소하다
disappear : vi,안 보이게 되다,소실하다,소멸하다
disappearance : n,소멸,소실,실종
disappoint : vt,실망시키다,기대를 어기다,그에게 실망했다,좌절시키다,꺾다
disappointed : a,실망한
disappointing : a,실망시키는
disappointment : n,실망
disapprobation : n,=DISAPPROVAL
disapprobative : a,=DISAPROBATORY
disapprobatory : a,불만의 뜻(비난)을 나타내는,찬성하지 않는,못마땅해 하는
disapproval : n,불찬성,비난,부인
disapprove : vt,~을 안된다고 하다,인가하지 않다,비난하다
disapprovingly : ad,못마땅하여,불찬성의 뜻을 나타내어,비난하여
disarm : vt,vi,무기를 거두다,무장 해제하다,군비를 해제하다
disarmament : n,무장,해제,군비 축소
disarming : a,흥분(노염,두려움,적의(등))을 가라앉히는,천진한
disarrange : vt,어지럽게 하다,난잡하게 하다,어수선하게 하다
disarrangement : n,환란,난맥
disarray : n,난잡,흐트러지다,벌거벗기다
disarticulate : vt,vi,관절이 어긋나(게 하)다,해체하다
disarticulation : n,(관절)탈구
disassemble : vt,분해하다
disassembly : n,분해,분해한 상태
disassociate : vt,=DISSOCIATE
disassociation : n,=DISSOCIATION
disaster : n,천재,재해,재난,참사
disaster area : x,(미)재해 지역,(재해구조법이 적용되는)비상 재해 지구
disaster film : x,대재해 영화
disastrous : a,재해의,비참한
disavow : vt,부인하다,거부하다
disavowal : n,거부,부인
disband : vt,해산하다,군인을 제대시키다,해산하다
disbandment : n,해산
disbar : vt,변호사 자격을 빼앗다
disbelief : n,불신,의혹
disbelieve : vt,믿지않다,의심하다
disbeliever : n,믿지 않는 사람,회의하는 사람,신앙을 부인하는 사람
disbench : vt,(영법)법학원 간부의직(자격)을 빼앗다
disbenefit : n,이익이 없음,불이익,손실
disbetologist : n,당뇨병 전문의사
disbosom : vt,털어놓다,고백하다
disbound : a,떼어낸
disbranch : vt,가지를 잘라내다,가지를 치다,꺽다
disbud : vt,(쓸데없는)싹(봉오리)을 따다
disburden : vt,짐을 내리다,무거운 짐을 벗다,한시름 놓다
disburse : vt,지불하다,지출하다
disbursement : n,지불,지출,지불금,출비,(법)영업비
disc : n,=DISK
disc, : x,discount,discover,discoverer
disc- : x,(연결형)(원반,레코드)의 뜻(모음 앞에서는 disc-)
discaire : n,(디스코의)레코드 담당자
discal : a,원반 모양의
discalced : a,맨발의
discant : vi,n,=DESCANT
discard : vt,요없는 패를 버리다,버리다,해고하다,버림 받은 사람
disc brake : x,원판 브레이크,디스크 브레이크
discern : vt,인식하다,지각하다,분간하다
discernible : a,인식 할 수 있는
discerning : a,분별력이 있는,명민한
discernment : n,인식
discerptible : a,분리할 수 있는
discharge : 발사하다,방출하다,짐을부리다,해고하다,이행하다,탈색 하다,방전하다,취소하다,짐을	부리다,발사하다,번지다,퍼지다,발사,방전,해고,해임
dischargee : n,소집 해제자
discharge lamp : x,방전 램프(수은등 등)
discharger : n,방전자
discharge tube : x,(전)방전관
disc harrow : x,원판 써레(트랙터용)
disci : n,discus의 복수
disciple : n,제자,사도
Disciples of Christ : x,사도 교회
disciplinable : a,훈련할 수 있는,징계해야 할(죄 등)
disciplinarian : a,n,훈련의,규율의,훈육가,엄격한 사람
disciplinary : a,훈육상의,징계의
discipline : vt,훈련,훈육,제어,규율,징계,훈련하다,징계하다
disc jockey : x,=DISK JOCKEY
disclaim : vt,포기하다,관계를 부인하다,포기
disclaimer : n,포기자,부인자
disclamation : n,부인(행위),거부,(권리의)포기
disclimax : n,(생태)방해극상(사람이나 가축의 끊임없는 방해를 받아 생물 사회의 안정이 무너짐)
disclose : vt,나타내다,노출시키다,폭로하다,털어놓다,발표하다
disclosure : n,발포,폭로,노출
disco : n,=DISCOTHEQUE
disco- : x,(연결형)=DISC-
discobolus,-los : n,(고대의)원반 투수
discographical : n,
discography : 수집가가 하는 레코드 분류(기재법),(작곡,연주가 별)취입 레코드 일람표,레코드 음악 연구(해설,역사),dixcographer()n,
discoid : a,원반모양의
disco jockey : x,디스코 자키(디스코의 사회자,아나운서)
discolor : vt,변색하다
discoloration : n,변색,퇴색
discolorment : n,=DISCOLORATION
discombobulate : vt,(미)혼란시키다,당황하게 하다
discomfit : vt,계획을 뒤업다,쳐부수다,당황케하다
discomfiture : n,(계획 등의)실패,쩔쩔맴,당황,괴멸,대패주
discomfort : n,불쾌하게 하다,불편을 주다
discomfort index : x,불쾌지수
discommode : vt,괴롭히다,폐를 끼치다
discommon : (법)(공유지를)울로 막아 사유지로 하다,불하하다,...의 입회권을 빼앗다,(영)(Oxford Cambridge 대학에서)(상인에게)재학생과의 거래를 금하다
discompose : vt,마음을 어지럽히다,불안케 하다
discomposed : a,침착(평정)을 잃은,마음이 산란해진
discomposedly : ad,침착(평정)을 잃고,조바심하며
discomposingly : ad,마음이 뒤숭숭하게,불안을 느끼도록
discomposure : n,불안,당황,낭패
disconcert : vt,당황하게하다,좌절시키다,혼란시키다
disconcerted : a,당혹한,당황한,disconcertly()ad,disconcertedmess()n
disconcerting : a,당황케하는,혼란케 하는,불안하게 하는,disconcertingl()ad
disconcertion : n,교란,혼란(상태),당황,좌절
disconcertment : n,=DISCONCERTION
disconfirm : vt,...의 부당성을 증명하다,(명령을)거절하다
disconfirmation : n
disconformity : n,(고)불일치,불복종,(지질)평행 부정합
disconnect : vt,~와 연락을 끊다,자르다,떼다,분리하다,연락이 없는
disconnected : a,따로따로 떨어진,연락이 끊긴,disconnectedly()ad,disconnectedness()n
disconnection : n,분리,절단
disconsolate : a,쓸쓸한,허전한,서글픈
discontent : n,불만,불만을 품게하다
discontented : a,불만스러운
discontentment : n,불만,불평
discontiguous : a,접촉해 있지 않은
discontinuance : n,
discontinuation : n,=DISCONTINUANCE
discontinue : vt,중지하다,정지하다,구독을 그만 두다,취하하다
discontinuity : n,불연속,중단,끊어짐
discontinuous : a,중단된,중도에서 끊어진
discophile : n,레코드 수집가
discord : n,vi,불일치,일치하지 않다,불화하다
discordance : n,불화,부조화,불협화(음),(지질)(지층의)부정합
discordant : a,조화하지 않는,충돌하는,불화한
discotheque : n,레코드에 맞추어 춤을 추는 나이트 클럽
discount : n,vt,할인,할인하다
discountable : a,할인할 수 있는
discount broker : x,어음 할인 중개인
discount company : x,채권 감정 할인 회사
discountenance : vt,싫은 내색을  하다,반대하다,창피를 주다,낭패케 하다
discounter : n,할인하는 사람,싸게 파는 사람,DISCOUNT HOUSE의 경영자
discount house : x,싸게 파는 가게
discount market : x,어음 할인 시장
discount rate : x,어음 할인율,재할인율
discount store : x,할인 점포,싸구려 가게
discourage : vt,용기를 잃게하다,낙담시키다
discouraged : a,낙담한,낙심한,(미)술에 취한
discouragement : n,낙담,낙심,기를 죽이는 것,방해,단념시킴,반대
discouraging : a,낙담시키는,시원찮은,신이 안나는
discouragingly :  ad
discourse : n,강연,설교,논설,이야기,담화,강연하다,논술하다
discourteous : a,무례한
discoutesy : n,무례,실례,무례한 언행
discover : vt,발견하다,찾아내다,나타내다,밝히다
discover : n,발견자
discoverable : a,발견할 수 있는,(효과 등이)눈에 보이는
Discover America : x,(미)미국을 발견하자(국내 관광 진흥책으로 쓰는 표어)
discoverer : n,발견자,미국 공군의 인공 위성
discoverist : a,발견 학습법을 지지하는
discovert : a,(법)남편 없는 신분의(미혼(이혼)여성 또는 과부의)
discovery : n,발견물
Discovery Day : x,(미)=COLUMBUS DAY
discovery method : x,발견 학습법(학생에게 자주적인 지식 습득,문제 해결을 시키는 교육법)
discredit : n,불명예,불신,의혹,신용하지 않다,신용을 잃게하다
discreditable : a,불명예스러운
discreet : a,사려가 깊은,신중한,분별 있는
discrepance : n,=DISCREPANCY
discrepancy : n,모순,불일치,어긋남
discrepant : a,어긋나는,상위하는
discrete : a,분리한,구별된,개별적인,불연속의,추상적인
discretion : n,사려,분별,신중,행동의 자유,자유 재량,분별 연령,마음대로,신중히)
discretional : a,=DISCRETIONARY
discretionary : a,임의,무조건의
discretionary account : x,매매 일임 계정(증권(상품)시장에서의 매매를 대리업자의 자유 재량에 일임하는계정)
discretionary income : x,(경)재량 소득(가처분 소득에서 기본 생활비를 뺀 잔액)
discriminance : n,식별법,판별 수단
discriminant : a,=DISCRIMINATING
discriminate : vt,분간하다,식별하다
discriminating : a,식별있는,차별적인,명확한
discrimination : n,구별,차별,식별
discriminative : a,구별적인,식별하는,구별을 나타내는
discriminator : n,식별하는 사람,(전자)판별 장치(주파수,위상 등을 판별하는)
discriminatory : a,식별력이 있는,차별을 나타내는
discrown : vt,...의 왕관을 빼앗다,퇴위시키다
disct, : x,discount
discursive : a,산만한
discursively : ad,막연히
discus : n,원반
discuss : vt,음미하다,토론하다,논하다,상의하다,서로 이야기하다,맛있게 먹다,토론자
discussant : n,토론자
discusser : n,논의하는 사람,토론자
discussible : a,논의할 수 있는
discussion : n,토론,토의,논의,변론,논문
discus throw : x,투원반
discus thrower : x,원반 던지기 선수
disdain : n,경멸,경멸하다,경멸적인
disdainful : a,경멸적인,거만한
disease : n,병
diseased : a,병의,병적인
disease germ : x,병원균
diseconomics : n,마이너스 경제 정책,불경제 성장,부의 경제학
diseconomy : n,불경제,비용 증대(의 요인)
disedge : vt,...의 날을 없애다,(날카로운 것을)무디게 하다
disembargo : vt,(선박의)억류를 해제하다,출항(입항)금지를 해제하다,통상을 재개하다
disembark : vt,양륙하다,상륙시키다
disembarkation : n,양륙,상륙
disembarkation card : x,(여행자 등의)입국 카드
disembarrass : vt,벗어나게 하다,안심시키다
disembarrassment : n,해방,이탈
disembodied : a,육체가 없는,(목소리 등이)모습이 안 보이는 사람에게서 나온
disembody : vt,육체에서 분리시키다
disembogue : vt,vi,(강이 물을 바다,호수로)흘려 보내다,방출하다,(강이 바다,호수 등으로)흘러 들어가다
disemboguement : n
disembosom : vt,(비밀 등을)털어놓다
disembowel : vt,창자를 빼내다
disembroil : vt,...의 엉킨 것을 풀다,...의 혼란을 진정시키다
disemplane : vi,비행기에서 내리다
disemployed : a,(기술,교육을 못받아)직업이 없는,미취업의
disenable : vt,무능력하게 하다,무력하게 하다,...에게서 자격을 박탈하다
disenchant : vt,미몽에서 깨어나게 하다,마법을 풀다
disencumber : vt,괴로움을 제거하다
disendow : vt,(특히 교회 등의)기부 재산(기본 재산)을 몰수하다
disenfranchise : vt,=DISFRANCHISE
disengage : vt,풀다,해방하다,~와의 싸움을 중지하다,떨어지다,관계를 끊다
disengaged : a,자유로운,한가한,약속이 없는
disengagement : n,해방,이탈,파혼,여가
disengaging action : x,(군)교전 회피,자발적 철수
disentail : vt,(법)(재산의)한정상속 지정을 해제하다
disentangle : vt,엉킨것을 풀다
disenthral : vt,=DISENTHRALL
disenthrall : vt,(노예 등을)해방하다
disenthrallment : n
disenthrone : vt,=DETHRONE
disentitle : vt,...에게서 권리(자격)를 박탈하다
disentomb : vt,무덤에서 파내다,발굴하다
disentombment : n
disentrance : vt,...을 황홀(몽환)상태에서 깨어나게 하다
disentwine : vt.vi,...의 꼬인 것을 풀다,풀리다
disequilibrium : n,불균형,불안정
disestablish : vt,폐지하다,국교제를 폐지하다
disestablishmentarian : n,a,국교제도 폐지론자,국교제도 폐지론의
disesteem : n,vt,경시,경시하다,깔보다
diseuse : n,(F)여자 화술가(낭송자)
disfavor : n,소외,냉대,싫어함,인기없음
disfeature : vt,=DISFIGURE
disfigure : vt,모양을 손상시키다,보기 흉하게 하다
disfluency : n,눌변,말더듬
disforest : vt,=DEFOREST
disfranchise : vt,공민권을 빼앗다
disfranchisement : n,공민(선거권) 박탈
disfrock : vt,=UNFROCK
disfunction : n,vi,=DYSFINCTION
disgonorable : a,불명예스러운,부끄러운(shameful)
disgorge : vt,토해내다,게우다,게워내다
disgrace : n,창피,치욕,욕보이다
disgraceful : a,수치스러운,욕된
disgracefully : ad,불명예스럽게(도),면목 없게(도)
disgrunt : vt,내뱉듯이 말하다
disgruntle : vt,불만을 품게하다
disgruntled : a,시무룩한,불평을 품은
disguise : vt,n,변장하다,거짓 꾸미다,속이다,감추다,변장,가장복,거짓꾸밈,구실
disguised : a,변장한,속임수의,(미)술취한
disgust : vt,n,역겹게하다,정떨어지게 하다,역겨움,혐오
disgustedly : ad,메스꺼워져서,넌더리나서
disgustful : a,메스꺼운,너더리나는,지긋지긋한
disgustfullu : ad 
disgusting : a,구역질나는,지겨운
dish : n,접시,푼주,요리,식품,성적 매력이 있는 여자,접시에 담다,움푹해지다
dishabille : n,평복,평상복,약복
dishabituate : vt,...에게 (...한)습관을 버리게 하다
dishallucination : n,착각(환각),파괴,환멸
dish antenna : x,(통신)접시형 안테나
disharmonious : a,조화되지 않는,불협화의
disharmonize : vt,vi,...의 조화를 깨뜨리다,조화가 깨지다
disharmony : n,부조화,불협화
dishcloth : n,행주
dishcloth gourd : x,(식)수세미의
dishclout : n,(영)=DISHCLOTH
dish cover : x,접시 뚜껑
dishearten : vt,낙담시키다,실망시키다
disheartening : a,낙담시키는
dishearteningly :  ad
dished : a,움푹 들어간,꺼진,(기)(바퀴,핸들이)접시형인,(차바퀴 한 쌍의 간격이)집지점보다도 위쪽이 더 넓은,지쳐빠진
dishevel : vt,(머리카락을)부수수하게 늘어뜨리다,(물건을)난잡하게 하다
dishvelment : n,
dishevelled : a,헝클어진,주제가 단정치 못한
dishful : n,(한)접시 가득
dishonest : a,부정직한
dishonestesty : n,
dishonor : n,불명예,치욕,경멸,부도,치욕을 주다,이름을 더럽히다,치욕을 주다
dishorn : vt,(짐승의)뿔을 자르다
dishouse : vt,(거주자를)집에서 쫓아내다,집에서 퇴거시키다
dishpan : n,개수통,사발 모양의 대형 안테나
dishpan hands : x,(미)취사,세탁 등으로 거칠어진 손
dishrag : n,(미)=DISHCLOTH
dish towel : x,(씻은 접시를 닦는)행주
dishware : n,접시류,식기류
dishwash : n,(고)=DISHWATER
dishwasher : n,접시 닦는 사람
dishwater : n,개숫물,맛없는 스프,멀건 코피
dishy : a,(영)(사람이)성적 매력 있는
disillusion : n,환멸,미몽,환멸을 느끼게 하다,잘못을 깨우치다
disillusioned : a,환멸을 느낀
disillusionize : vt,=DISILLUSION
disillusionment : n,환멸(감)
disillusive : a,환멸적인
disimpassioned : a,냉정한,침착한
disimprison : vt,(감금에서)석방하다
disimprisonment : n
disincentive : a,행동을 방해하는
disinclination : n,싫증,마음없음,꺼림
disincline : vi,싫증나다,마음이 내키지 않게하다
disinclined : a,...하고 싶지 않은,내키지 않는
disincorporate : vt,...의 법인 조직을 해체하다,...에서 합동(공동)성을 빼앗다
disinetgrable : a,붕괴할 수 있는,분해할 수 있는
disinfect : vt,소독하다,살균하다
disinfectant : a,n,소독하는,소독제
disinfection : n,소독,살균
disinfest : vt,~에서 해충,쥐 따위를 없애다
disinflate : vt,(물가의)인플레이션을 완화하다
disinflation : n,디스인플레이션
disinform : vt,...에게 허위 정보를 흘리다
disinformation : n,그릇된 정보(특히 적의 간첩을 속이기 위한)
disingenuous : a,부정직한,음흉한
disinherit : vt,폐적하다,상속권을 박탈하다,의절하다
disinheritance : n,(법)폐적
disinsectization : n,(항공기에서 하는)곤충(해충)구제,구충
disintegrant : n,정제 분해 물질,붕괴제
disintegrate : vi,분해하다,붕괴하다
disintegration : n,
disintegrator : n,분해기
disinter : vt,발굴하다
disinterest : n,이해 관계가 없음,무관심
disinterested : a,사심이 없는,공평한,무관심한
disinterestedly : ad,
disinterestedness : n,사심,무관심
disintermediation : n,(증권 시장에 직접 투자하기 위한)은행 예금에서의 고액 인출
disinterment : n,발굴
disintoxicate : vt,술을 깨게 하다,의존 상태에서 벗어나게 하다
disintoxication : n,
disinvest : vt,~에서 해외 투자를 회수하다
disinvite : vt,초대를 취소하다
disject : vt,...을 산란케 하다,이산시키다
disjecta membra : n,(F)(문학 작품 등의)(흐트러진)단편,단편적 인용
disjoin : vt,분리하다
disjoint : vt,관절을 퉁기다,탈구시키다,뿔뿔이 해체하다,질서를 어지럽히다
disjointed : a,관절이 삔,흐트러진,disjointedly(),ad
disjunct : a,분리된
disjunction : n,분리,분열,선언,이접
disjunctive : a,n,분리의,선언적인,선언 명제,선택 접속사
disk : n,평원반 레코드,원반 레코드,자기 디스크 기억 장치
disk brake : x,=DISC BRAKE
diskette : n,=FLOPPY DISK
disk flower : x,(식)(국화과 식물의)중심화
disk harrow : x,트랙터용 원판 쟁기
disk jodkey : x,디스크 장치
disk pack : x,(전산)디스크팩
dislike : vt,싫어하다,미워하다,혐오,증오
disliking : n,=DISLIKE
dislocate : vt,관절을 삐다,탈구시키다,순서를 어지럽히다
dislocation : n,탈구,단충
dislodge : vt,쫓아내다,격퇴하다,떼어내다
disloyal : a,불충한,불충실한,불성실한
disloyalty : n,불충실,신의 없음
dislysis : n,(의,화)투석,여막 분석,분해,분리
dismal : a,음침한,어두운,쓸쓸한,무시무시한,참담한
dismal science : x,음울한 학문(경제학의 별칭)
Dismal Swamp : n,디즈멀 디습지(Virginia 주 및 North Carolina주의 연안 습지대)
dismantle : vt,옷을 벗기다,철거하다,분해하다
dismask : vt,=UNMASK
dismast : vt,(폭풍이)돛대를 앗아 가다
dismay : vt,깜짝 놀라게 하다,근심시키다,당황,경악
dismember : vt,손발을 자르다,분할하다
dismemberment : n,분할
dismiss : vt,면직시키다,떠나게하다,물러가라고 말하다,물리치다,기각하다
dismissal : n,
dismissible : a,해고할 수 있는
dismission : n,(고)=DISMISSAL
dismissive : a,무시하는 듯한,깔보는 듯한(태도,말 따위)
dismount : vi,내리다,말에서 떨어뜨리다,떼어내다,분해하다
Disney : n,Walt(1901,66)미국의 (만화)영화 제작가
Disneyesque : a,(사람,사물,태도 등이)디즈니 만화(유원지)같은
Disneyland : n,디즈니랜드(Walt Disney가 Los Angeles에 만든 유원지)
disobedience : n,불순종,위반,반칙
disobedient : a,순종치 않는,따르지 않는,불효한
disobey : vt,vi,반항하다,듣지 않다
disoblige : vt,불친절하게 하다,바라는 대로 안해주다,노하게 하다
disobliging : a,불친절한
disoperation : n,(생태)상해 작용
disorder : n,무질서,혼란,혼란시키다,병들게하다
disordered : a,혼란된,고장난,병에 걸린
disorderliness : n.a,무질서,혼란,난폭,무질서한,(법)공안 방해의,풍기 문란의
disorderly : a,무질서한,어수선한,난잡한
disorderly conduct : x,(법)치안(풍기)문란 행위(경범죄)
disorderly house : x,매음굴,도박장
disorganization : n,
disorganize : vt,조직을 파괴하다,질서를 파괴하다,혼란시키다
disorganized : a,조직이 문란한,엉터리의,지리멸렬한
disorient : vt,~에게 방향감각을 잃게하다,~의 머리를 혼란케하다
disorientate : vt,=DISORIENT
disorientation : n,방향감각의 상실,혼미
disown : vt,부인하다,의절하다
disp, : x,dispensary
disparage : vt,얕보다,헐뜯다
disparaging : a,얕보는,험담하는,비난하는,disparagingly()ad
disparagingly : ad,경멸하여,비난하여
disparate : a,본질적으로 다른
disparity : n,다름,상이,불균형
dispark : vt,(개인의 정원,수렵지를)개방하다
dispart : vt,vi,분열하다,분리하다,분할하다(되다)
dispassion : n,냉정,공평
dispassionate : a,냉정한,공평한
dispatch : vt,급송하다,급파하다,재빨리 처리하다,해치우다,발송,급송
dispatch boat : x,공문서 송달용 쾌속선
dispatch box : x,(공문서의)송달함
dispatcher : n,(열차,버스,트럭 등의)배차원,발송 계원
dispatch money : x,에누리한 돈,선적할인 환급료
dispatch note : x,국제 우편 소화물에다는 꼬리표
dispatch rider : x,전령,급사
dispatch tube : x,기송관
dispeace : n,평화 부재
dispel : vt,쫓아 버리다,흩뜨리다
dispensable : a,없어도 좋은,과히 중요하지 않은,특면 될수 있는
dispensary : n,약국,무료 진료소,양호실
dispensation : n,분배,시여,섭리,하늘의 뜻,하늘이 준 것
dispensator : n,(고)=DISPENSER 1,2,지배자
dispensatory : n,약품 해설서,약국법 주해서,분배의,시여하는
dispense : vt,vi,분배하다,조제하다,실시하다,면제하다,특면하다
dispenser : n,약제사,조제사,분배자,시여하는 사람
dispensing chemist : x,조제 약제사
dispeople : vt,~의 주민을 전멸시키다,~의 인구를 감소시키다
dispersal : n,=DISPERSION
disperse : vi,흩어지다,흩뜨리다,분산하다
dispersed : a,흩어진,분산된
dispersedly : ad,분산하여,뿔뿔이,산산이 흩어져
dispersion : n,산란,분산,분포
dispersive : a,흩어지는
dispirit : vt,낙담시키다
dispirited : a,기가 꺾인,낙심한,dispiritedly()ad
dispiriting : a,낙심시키는
dispiteous : a,(고)무자비한,잔혹한
displace : vt,바꾸어 놓다,이동시키다,면직하다,~대신 들어서다,대치하다
displaced homemaker : x,(이혼,별거,남편의 사망,무능력 등으로)생활 수단을 잃은 주부
displaced person : x,(전쟁,압제 때문에 고국에서 추방된)난민,유민
displacement : n,바꿔 놓음,이동,대체,면직,배수량,배기량,감정 전이
displacement tonnage : x,배수 톤수
displacer : n,(조제용)여과기
display : vt,보이다,진열하다,울리다,펼치다,과시하다,진열,전시,표시
display advertising : x,신문,잡지의 대형 광고
display artist : x,(실내,쇼 윈도의)디스플레이 광고 제작자
displayed : a,(새가)날개를 펴고 다리를 벌린
display key : x,디스플레이 키(호텔 등의 객실용 키)
display type : x,표제,광고용의 대형 활자
display window : x,(정면)진열창
displease : vt,불쾌하게 하다,성나게 하다
displeased : a,화난
displeasing : a,불쾌한,싫은
displeasure : n,불쾌
displume : vt,(시)...의 깃털을 뽑다,허식을 없애다,...의 명예를 박탈하다
disport : vi,n,놀다,즐겁게 하다,즐거움,놀이
disposable : a,처리할수 있는,마음대로 할수 있는
disposable income : x,가처분 소득,세금 뺀 실수입
disposal : n,배치,처리,처분,양도
disposal bag : x,여객기 내에 비치된 구토용의 종이 봉지
dispose : vt,배치하다,~할 마음이 내키게 하다
disposed : a,~하고 싶어하는,~한 기분의
disposer : n,처리자,(부엌,싱크대에 부착된)찌꺼기처리 장치
disposes : vi,일은 사람이 꾸미되 성패는 하늘에 달렸다
disposition : n,배치,처리,성질,성향
dispossess : vt,박탈하다,빼앗다,몰아내다
dispossessed : a,쫓겨난,토지,가옥을 빼앗긴
dispossession : n,몰아내기,강탈,탈취,(법)부동산 불법 점유
dispossessor : n,(토지)침탈자
dispraise : n,비난
disprize : vt,(고)얕보다,경시하다,업신여기다
disproduct : n,(생산자의 태만에 의한)유해 제품,불량품
disproof : n,반증
disproporrional : a,어울리지 않는
disproportion : n,vt,불균형,어울리지 않음,불균형하다,어울리지않게 하다
disproportionate : a,불균형한
disprove : vt,반증하다,반박하다,논박하다
disputable : a,논의의 여지가 있는,의심스러운
disputant : n,논쟁자
disputation : n,논쟁
disputatious : a,논쟁적인,논쟁을 좋아하는,disputatiously()ad
disputative : a,의논을 좋아하는,논쟁인
dispute : vt,의논하다,싸우다,다투다,논쟁하다,논쟁,분쟁
disqualification : n,불합격,실격,그 이유
disqualified : a,자격을 잃은,실격이 된
disqualify : vt,자격을 빼앗다
disquienting : a,불안하게 하는,걱정하게 하는
disquiet : n,불안,불안하게 하다
disquietude : n,불안한 상태,불온,동요,걱정
disquisition : n,논문,논설
Disraeli : n,디즈레일리(영국의 정치가,소설가)
disrate : vt,(해)(사람,배 등의)등금을 낮추다)
disregard : n,무시,경시,무시하다,경시하다
disrelish : n,혐오,혐오하다
disremember : vt,~을 잊다,생각이 안 나다
disrepair : n,파손
disreputable : a,평판이 나쁜,불명예스러운
disrepute : n,악평,불명예
disrespect : n,실례,무례
disrespectable : a,존경할 가치가 없는,disrespectably()ad,disrespectableness()n
disrespectful : a,무례한,실례되는,disrespectfully()ad,disrespectfulness()n
disrobe : vi,옷을 벗기다
disroot : vt,뿌리 뽑다
disrupt : vi,찢어 발기다,분열하다,분열시키다
disruption : n,붕괴,분열,파열
disruptive : a,분열적인,혼란을 일으키는,disruptively()ad
diss, : x,dissertation
dissatisfaction : n,불만,불만의 원인
dissatisfactory : a,불만(족)스러운
dissatisfied : a,불만인의
dissatisfy : vt,~에게 불만을 주다
dissave : vi,(저금,자본금을 인출하여)수입 이상의 돈을 쓰다
dissect : vt,해부하다,분석하다
dissection : n,절개,해부,해부체,정밀한 분석,(영)(상)(상품의)분류 구분,(지질)개석
dissector : n,해부학자,해부기구
disseise : vt,(법)(사람에게서)(부동산의)점유권을 침탈하다
disseisin : n,(법)(부동산의)점유,침탈
dissemblance : n,(고)닮지 않음,상이
dissemblance : n,시치미뗌,속임,위장
dissemble : vt,숨기다,속이다,무시하다,시치미 떼다,본심을 안 보이다
dissembler : n,위선자,시치미떼는 사람
disseminate : vt,흩뿌리다,퍼뜨리다
dissemination : n,씨뿌리기,산포,보급,선전
disseminative : a,파종성의
disseminator : n,씨 뿌리는 사람,퍼뜨리는 사람,선전자,살포기
dissension : n,의견의 차이,충돌,불화
dissent : vi,n,의견을 달리하다,이의를 말하다,영국 교회에 반대하다,이의,국교 반대
dissenter : n,반대자
dissentient : a,불찬성의
dissenting : a,방대하는,비국교파의
dissenting opinion : x,(법)반대의
dissepiment : n,격막,격벽,자방격막
dissert : vi,논하다,논문을 쓰다
dissertation : n,논문,학위 논문
disserve : vt,...에게 해로운 짓을 하다,해를 입히다
disservice : n,학대,박해
dissever : vt,가르다,분리하다,분할하다
disseverance : n,분리,분할
dissidence : n,불일치
dissident : a,의견을 달리하는
dissimilar : a,같지 않은
dissimilarity : n,
dissimilate : vt,이화시키다
dissimilation : n,이화 작용
dissimilitude : n,같지 않음,부동,차이,차이점
dissimulate : vt,숨기다
dissimulation : n,감정,의지등의  위장,위선,위장(정신이상자가 보통인을 위장하는 일)
dissimulator : n,위선자,시치미떼는 사람
dissipate : vt,흩뜨리다,몰아내다,낭비하다,사라지다,방탕하다
dissipated : a,방탕한,난봉부리는
dissipation : n,소산,소실,낭비,산재,난봉,방탕
dissipative : a,소산적인,낭비적인
dissociable : a,분리할 수 있는,조화하지 않는,비사교적인
dissocial : a,반사회적인,비사회적인,비사교적인
dissocialize : vt,비사교적으로 만들다,교제를 싫어하게 하다
dissociate : vt,분리하다,분리해서 생각하다,의식을 분열시키다
dissociation : n,분리
dissociative : a,분리적인,분열성의,(화)해리적인
dissolubility : n,분리성,해소할 수 있음
dissoluble : a,용해할 수 있는,해산할 수 있는
dissolute : a,방탕한,난봉 피우는
dissolution : n,용해,분해,해산,해체,붕괴,사멸,해소,해약
dissolvable : a,분해할 수 있는
dissolve : vt,녹이다,녹다,분해하다,해산하다,해소시키다,취소하다,깨치다
dissolved gas : x,유통성 가스(원유에 용해하여 존재하는 천연 가스)
dissolvent : a,n,용해력이 있는,용해제
dissonance : n,부조화,불협화
dissonancy : n,=DISSONANCE
dissonant : a,불협화의,dissonantly()ad
dissuade : vt,단념시키다
dissuasion : n,그만두게 함,말림
dissuasive : a,말리는,말리기 위한,dissuasively()ad
dissyllabic : a,2음절의
dissyllable : n,2음절어
dissymmetrical : a,균형이 안 잡힌,반대 대칭의
dissymmetry : n,비대칭,불균형,반대 대칭(사람의 자우 손 따위)
dist, : x,distant,distinguish,district
Dist,Atty, : x,District Attorney
distaff : n,실감는 막대
distaff side : x,모계,어머니 쪽
distain : vt,(고)변색시키다,더럽히다,명예를 손상하다
distal : a,말초부의
distance : n,vt,거리,간격,사이,먼데 사이를 두다,앞 지르다,능가하다
distance pole : x,(경마)주정표
distant : a,먼,어렴풋한,쌀쌀한
Distant Early Warning line : x,=DEW LINE
distantly : ad,멀리,떨어져서,희미하게,에둘러,간접적으로
distant signal : x,(철도)원거리 신호기
distaste : n,=DISLIKE
distasteful : a,맛 없는,싫은
distemper : vt,디스템퍼,사회적 불안,소동,탈나게 하다,어지럽히다
distemper : n,vt,디스템퍼(끈끈한 채로)
distemperature : n,(심신의)부조,(고)절제의 결여
distend : vi,부풀다
distensibility : n,팽창성
distensible : a,팽창시킬 수 있는,팽창성의
distension : n,팽창,확대
distermediate : vt
distich : n,=COUPLET
distichous : a,(식)대생(마주나기)의,distichously()ad
distill : vt,vi,증류하다,~의 증수를 뽑다,듣게 하다,뚝뚝 듣다
distilland : n,증류물
distillate : n,증류물
distillation : n,증류법,증류액
distillatory : a,증류용의
distilled : a,증류한,증류하여 얻은
distilled water : x,증류수
distiller : n,증류기,증류수 제조업자
distillery : n,증류소,증류수 제조장
distillment : n,(고)=DISTILLATION
distinct : a,명백한,명확한,별개의,다른
distinction : n,차별,구별,특질,탁월,명예,쓸데없는 구별짓기,유명해지다
distinctive : a,독특한,특수한
distinctively : ad,(다른 것과)구별하여
distinctly : ad,뚜렷하게
distingue : a,(F)(태도,용모,복잗 등이)기품있는,고귀한
distinguish : vt,분간하다,구별하다,분류하다,두르러지가하다,이름을 떨치다,수훈을 세우다
distinguishable : a,구별할 수 있는
distinguished : a,저명한,고귀한,상류의,수훈의
Distinguished Service Medal : x,(미군)(군인 일반에 대한)수훈장
Distinguished Service Order : x,(영군)수훈장
distinguishing : a,다른 것과 구별되는,특색 있는
distn, : x,distillation
distoma : n,(동)디스토마
distort : vt,찡그리다,비틀다,일그러뜨리다
distorted : a,일그러진,뒤틀린,곱새긴
distortion : n,일그러진,왜곡,억지맞춤
distortional : a,찌그러진,변형의
distortionist : n,만화가,=CONTORTIONIST
distr, : x,distribute,distribution,distributor
distract : vt,딴 데로 돌리다,어지럽히다,착란시키다
distracted : a,어수선한,광란의
distracter : n,(선다형 시험에서)정답 이외의 선택지
distractingly : ad,마음 산란하게,미치도록
distraction : n,정신의 홀어짐,주의 산만,기분 전환,오락,광기
distractive : a,주의를 산만하게 하는,미치게 하는
distrain : vt,압류하다
distrainee : n,피압류자
distrainment : n,(법)(동산)압류
distrainor : n,동산 압류인
distraint : n,동산 압류
distrait : a,(F)(불안,근심으로)멍한,넋나간
distraught : a,몹시 고민한,마음이 상한,마음이 산란한,정신이 돈
distrbutively : ad,분배하여,따로따로
distress : n,vt,심통,고통,고민,비탄,고난,빈궁,피로,압류,괴롭히다,피로하게 하다
distress call : x,조난 호출
distressed : a,궁핍한,피로한
distressed area : x,재해 지구,빈민 지구
distress flag : x,조난 신호기(마스트 중간에 달거나 거꾸로 닮)
distressful : a,고난 많은,비참한,고통스런
distress gun : x,조난 실호포
distressing : a,괴롭히는,비참한
distress merchandise : n,흠이 있어 싸게 파는 불량 상품
distress rocket : x,(해)조난 신호의 불꽃
distress selling : x,출혈 무매
distress signal : x,조난 신호(sos 따위)
distress warrant : x,압류 영장
distributable : a,분배할 수 있는,구분할 수 있는
distributary : n,본류에서 흘러나온 지류
distribute : vt,분배하다,배급하다,분류하다,분포하다,확충하다,주연하다
distributed : a,(통계)분포된
distributee : n,(법)(유언 없는 사망자의)유산 상속권자
distributing : a,분배의,배급의
distribution : n,분류,분포,산포
distribution curve : x,(통계)분포 곡선
distribution function : x,(통계)분포 함수
distribution satellite : x,배급 위성(지상국에 신호를 재발송하기 위한 소형 통신 위성)
distributive : a,분배의,배포의,배분적인,배분사
distributive education : x,직업 실습 교육
distributiveness : n,판매자
distributive peonoun : x,(문법)배분대명사
distributor : n,분배자,배급,판매자
district : n,구역,지구,지방,county를 나눈 구,미국 콜럼비아 특별 행정구 미국 수도의 소재지)
district attorney : x,지방 검사
district council : x,(영)지방 자치구(준 자치도시)의회
district court : x,(미)지방 법원
district heating : x,지역 난방
district judge : x,(미)지방 법원 판사
district leader : x,(미)정당의 지방 지부장
district nurse : x,(영)지구 간호원,보건원(특정 지구에서 환자의가정을 방문함)
District of Cilumbia : n,(미)컬럼비아 특별구
district superintendent : x,(감리 교회의)교구 감독(자)
district visitor : x,(영)교구 목사보(여성)
distringas : n,(법)간접 강제적 압류 영장
distrust : n,vt,불신,의혹,의심하다
distrustful : a,선용치 않는,의심 많은,의심스러운
distubed : a,교란된,(마음이)사란한,정신장애자
disturb : vt,어지럽히다,소란하게 하다,방해하다,불안하게 하다
disturbance : n,소동,방해물,불안
disturbing : a,불안하게 하는,교란시키는
disulfide : n,(화)2황화물
disunion : n,분리,분열,불화
disunionist : n,분리주의자
disunite : vt,분리하다,분열시키다
disunity : n,불통일
disuse : vt,사용을 그만두다,쓰이지 않음
disused : a,(영)(이제는)사용되지 않는
disutility : n,비효용,무익,유해
disvalue : n,vt,(가치의)부인,경시하다,얕보다
disyllabic : a,2음절의
disyllable : n,=DISSYLLABEL
dit : n,딧,돈(모스 신호 등의 단음)
ditch : n,vt,vi,도랑,죽을 때까지 분전하다,~에  도랑을파다,도랑에 빠뜨리다,~을 버리다
ditchdigger : n,도랑을 파는 사람,중노동자
ditchwater : n,도랑에 괸 물
ditheism : n,(선악)이신론
dither : n,떨림,전율,몸을 떨다,전율하다,착란상태
dither : vi,(걱정,흥분으로)벌벌 떨다,당황하다
dithyramb : n,열광시,바커스의 찬가
dithyrambic : a,주신 찬가의,열광적인,=DITHYRAMB
dittany : n,(식)꽃박하
dittied : a,소가로 작곡된
ditto : a,ad,vt,동상,같은것,같이,마찬가지로,복제하다,되풀이하다
dittograph : n,(실수로)중복해서 쓴 글자,중복 어구
dittographic : a,실수로 중복해서 쓴
dittography : n,중복 오사
ditto machine : x,복사기
ditto mark : x,중복 부호
ditty : n,소가곡,소곡
ditty bag : x,(선원이 바늘,실,세면 도구 등을 넣는)잡낭
ditty box : x,(선원의 도구용)작은 상자,손궤
diuresis : n,(의)이뇨
diuretic : a,이뇨의,이뇨제
diurnal : a,매일의,낮의,주간의
div, : x,divergence,diversion,divide,dividend,divine,divinity,division,divisor,divorced
diva : n,여성의 명오페라 가수
divagate : vi,(문어)헤매다,(이야기 등이)본론에서 벗어나다
divalent : a,이가의
divan : n,법정,긴의자의 일종,흡연실,국정회의
divaricate : vi,두 갈래로 갈라지다,분기되다
divarication : n,분기(점),의견의 차이
dive : n,잠수,다이빙,급강하,몰두,탐구,짐수하다,뛰어들다,갑자기없어지다,몰두하다
divebomb : vt,급강하폭격하다
dive bomber : x,급강하 폭격기
dive bombing : x,급강하 폭격
diver : n,잠수부,해녀,잠수업자,자맥질하는 새
diverge : vi,갈리다,빗나가다,벗어나다,차이지다
divergence : n,분기,일탈,(의견 등의)차이
divergent : a,갈리는
diverger : n,DIVERGE하는 사람,(심)확산적 사고형의 사람,상상력이 풍부한 사람
diverging : a,=DIVERGENT
diverging lens : x,(광)발산 렌즈
divers : a,여러가지의,약간의
diverse : a,다른,다양한,여러가지의
diversely : ad,여러 가지로,다양하게
diversification : n,다양화,다양성,(사업의)다각화
diversified : a,변화가 많은,여러 가지의,다각적인
diversiform : a,다양한,여러 가지 모양의
diversify : vt,변화를주다,다양하게하다
diversion : n,전환,기분 전환,오락,견제
diversionary : a,(군)견제적인,양동의,주의를 딴데로 돌리는
diversionism : n,편향
diversionist : n,(정치적)편향(일탈자)
diversity : vt,다름,다양성
divert : vt,돌리다,전환하다,기분을전환하다,즐겁게하다,전용하다,...으로 기분을 푸다)
divertimento : n,자유로운 기악의 모음곡
diverting : a,기분 전환이 되는,즐거운,재미있는
divertissement : n,오락,가벼운기악곡,막간의 여흥
divertive : a,(고)=DIVERTING
Dives[d'aivi:z,(성)부자
Dives costs : x,(영)통상적 소송 비용
divest : vt,옷을벗다,빼앗다
divestiture : n,박탈
divi : n,=DIVVY
dividable : a,=DIVISIBLE
divide : vt,vi,n,가르다,갈라지다,나누다,분리하다,분배하다,대립시키다,표결하다,분수계
divided : a,분할된,갈라진,(식)열개한
divided highway : x,(미)중앙 분리대가 있는 고속도로
divided skirt : x,(여자 승마용의)바지 치마
divided usage : x,분할 어법
dividend : n,배당금,피제수
dividend account : x,배당금 계정
dividend stripping : x,(영세법)(납세자와 과세자가 공모해서 하는)배당 과세 면제
dividend warrant : x,배당금 지불증
divider : n,분배자,분할자,간막이
dividing : a,나누는,구분적인
dividivi : n,(식)열대 아메리카 산 콩과 식물(의) 꼬투리)(무두질에 씀)
diviednd check : x,(영)배당 수표,배당권
Divina Commedia : n,신곡(Dante의 장편 서사시)
divination : n,점,예언,전조,예감
divinatory : a,점의,예견져인,직관적 인지의,본능적 예지의
divine : a,n,vt,vi,신의,신성의,신성한,종교적인,비범한,신수의,신에게바친,신학자,성직자,목사,점치다,예언하다,알아채다
Divine Comedy : n,=DIVINA COMMEDIA
divinely : ad,신의힘으로,신처럼,거룩하게
diviner : n,점쟁이,(점 막대기로)수맥,광맥을 찾아내는 사람
divine right : x,(사)(백성과 관계 없는)신수왕권,
divine service : x,예배식,전례
diving : a,잠수의,잠수업,다이빙
diving beetle : x,물방개
diving bell : x,종 모양의 잠수기
diving board : x,다이빙대
diving helmet : x,잠수모
diving suit : x,잠수복
divining : a,점(의)
divining rod : x,지하의 물,석유,광맥 따위를 찾아내는 데 쓰던 점지과이
divinity : n,신성,신학,신
divinity calf : x,암갈색의 송아지 가죽(신학책 표지용)
divinity school : x,신학교
divinize : vt,신격화하다,신으로 모시다,...에 신성을 부여하다
divisible : a,나누어지는,분할 할 수 있는,분류 할 수 있는
division : n,분할,분배,의견의 차이,분열,구획,눈금,나눗셈,학부,사단,분대,포기나누기,분업,삼권 분립
divisional : a,분할하다,분배하다
divisionary : a,=DIVISIONAL
division bell : x,(영국 의회의)표결 신호종
Divisionism,d- : n,(미)분할 묘법
division lobby : x,(영의회)표결 대기 로비
division sign : x,(수)나눗셈 부호,분수를 나타내는 사선
divisive : a,의견의 불일치를 일으키는,분파적,분열을 일으키는
divisiveness : n,불화,대립
divisivility : n,나눌 수 있음,가분성,나뉘어 떨어짐
divisor : n,제수
divorce : n,vt,이혼,별거,분리하다,이혼하다
divorce : n,(F)이혼한 남자
divorce court : x,이혼 재판소
divorcee : n,이혼한 여성,미혼자
divorcement : n,이혼,분리
divot : n,(한 조각의)잔디,뗏장,(골프)(클럽에 맞아서)뜯긴 잔디의 한 조각
divulgate : vt,(비밀을)누설하다,폭로하다
divulgation : n,
divulge : vt,비밀을 누설하다,폭로하다
divulgence : n,비밀 누설,폭로
divulsion : n,잡아 찢음,(외과)열개
divvy : vt,n,~을 나누다,~에게 몫을주다,분할,몫,분할
diwan : n,=DIWAN
Dixican : n,(미)남부 출신의 공화당원
dixie : n,(야영용)큰 냄비,반합
Dixie : n,(미)남부 여러 주의 별명,딕시(남북 전쟁 때 남부에서 유행한 쾌활한 노래)
Dixiecrat : n,(미)미국 남부의 민주당 탈당파(의 사람)
Dixie Cup : x,자동 판매기용 종이 컵
Dixieie : n,미국 남부 제주의 별칭
Dixie Land : x,=DIXIE 1
Dixieland : n,=DIXIE 1,재즈 음악의 한 형식
dixy : n,(병사의 캠프용)큰 쇠냄비
dizen : vt,치장하다
dizzily : ad,현기증나게,어지럽게
dizziness : n,현기증
dizzy : a,현기증나는,어질어질한,당혹케하다,현기증나게하다
dizzying : a,현기증이 날 것 같은,dizzyingly()ad
Djakarta : n,=JAKARTA
Djibouti : n,지부티(아프리카 동부의 공화국)
djin : n,=JINN
dk, : x,dark,deck,dock
dkg, : x,decagram
dkl, : x,decaliter
dkm, : x,decameter
dks, : x,dicaster
DL : x,Delta Air Lines
dl, : x,deciliter
D layer : x,(통신)D층(이온권의 최하층)
DLM : x,double long meter
DLP : x,Democratic Labor Party
dlr, : x,dealer
dlvy, : x,delivery
dm, : x,decameter,decimeter
DM, : x,Deutsche mark
DMA : x,(전산)direct memory access,Doctor of Musical Arts
DMN, : x,(화)dimethylnitrosamine
DMT : x,dimethyltryptamine(환각제)
DMZ : x,demilitarized zone비무장지대
DNA : n,(생화)디옥시리보 핵산
DNase : n,(생화)DNA분해 효소
DNB, : x,Dictionary of National Biography영국 인명 사전
DNF : x,did not finish
Dnieper : n,드네프르 강(소련 서부의 강,흑해로 흐름)
Dnotice : n,(기밀보전을 위한)공표금지 요청
do : 행하다,하다,수행하다,처리하다,풀다,~의  도움이되다,해주다,요리하다,활동하다,매만져  가지런히하다,꾸미다,손질하다,여행하다,행하다,일하다,활동하다,소용되다,사기
do : n,(장음계의)도
do,d : x,ditto
doable : a,(행)할 수 있는
doall : n,허드레꾼
doat : vi,DOTE
dob : vt,배반하다,밀고하다
Dob : n,남자 이름
DOB : x,date of birth
dobber : n,(미방)낚시찌
dobberin : n,밀고자,배반자
dobbin : n,농사말,짐말
dobe : n,=ADOBE
Doberman pinscher : x,도베르만(털이 짧은 테리어의 개의 일종)
Dobro : n,도브로(금속의 반향판이 달린 음향 기타,상표명
dobson : n,=HELLGRAMMITE
dobsonfly : n,뱀잠자리
doc : n,=DOCTOR
doc, : x,document
docent : n,비상근강사,안내원
docile : a,유순한,가르치기쉬운
docility : n,온순,유순,다루기 쉬움
dock : n,vt,vi,선거,도크,선창부두,격납고,무대장치창고,dock에 넣다(들어가다),우주선이 결합하다
dock : n,법정의 피고속
dock : n,참소투쟁이속의 식물
dock : n,동물 꼬리의 심,짧게 자르다
dockage : n,도크설비,배를입거시킴,잘라냄,삭감
docker : n,부두노동자
docket : n,vt,소송사건표,판결요록,사무예정표,협의 사항,내용 적요,꼬리표,소송 사건표에 써넣다,꼬리표를 달다
docking : n,입거,결합,도킹의,입거의
docking adapter : x,도킹한 두 우주선의 연결통로
dockize : vt,(하천,항만 등에)선거를 설비하다
dockland : n,(영)선창 지역,그 부근의 주택 지구(특히 런던의)
dockmaster : n,선거 현장 주임
dockside : n,a,선창(부근)의
docktailed : a,꼬리를자른
dockwalloper : n,(미)둑(부두)의 임시 노동자,부두(선창)부랑자
dock warrant : x,(영)항만 창고 증권
dockyard : n,조손조,해군공창
doctor : n,vt,의사,박사,수선하는사람,치료하다,수선하다
doctor's degree : x,박사 학위,명예 박사 학위
doctor's stuff : x,(경멸)약
doctoral : a,박사의,학위있는
doctorate : n,박사 학위
doctor book : x,가정용 의학서
doctorial : a,=DOCTORAL
Doctor of Philosophy : x,박사 학위
Doctors' Commons : x,(런던시의)민법 박사회관
doctorship : n,=DOCTORATE,(고)DOCTOR의 지위(자격)
doctress : n,여의사,여박사
doctrinaire : n,공론가,순이론가,공론적인
doctrinal : a,교의의,학리상의
doctrinarian : n,=DOCTRINAIRE
doctrine : n,교의,교리,주의,학설
doctrinism : n,교리지상주의
docudrama : n,다큐멘터리 드라마
document : n,문서,서류,증서,기록문헌,증거,문서로 증명하다,자료를 제공하다
documental : a,=DOCUMENTARY
documentarian : n,(특히 사진,영화 등에서)다큐멘터리적 수법을 주창하는 사람
documentarily : ad,
documentary : a,문서의,기록물의,증서에 의한
documentary bill : x,화환 어음
documentation : n,문서조사,증거 자료,문서 자료의 분류 정리,(선박의)선적 서류 비치)
DOD : x,Depatment of Defense,(미)국방성
dodad : n,(미)=DOODAD
dodder : vi,흔들리다,비틀거리다,비실거리다
doddered : a,(고목이)웃동(가지 끝)이 떨어져 없는
doddering : a,비틀거리는
doddery : a,DODDERING
doddle : n,(영)손쉬운 일
dodec- : x,(연결형)12의 뜻(모음 앞에서는 dodec-
dodecagon : n,12각형
dodecahedron : n,(결정)12면체
dodecaphony : n,12음 작곡법
dodecasyllable : n,12음절의 시행(단어)
dodge : vi,vt,n,홱 몸을 피하다,살짝숨다,속이다,날쌔게 피하다,말을 둘러대다,몸을 돌려피함,속임수,묘안
Dodge : n,다지(미국제 승용차)
dodge ball : x,도지볼,피구
dodgem : n,꼬마전기 자동차의 충돌놀이
dodger : n,몸을 홱 비키는 사람,속임수를 잘하는 사람,(배의 브리지의)파도막이,(미,오스)삐라,전단,(미 남부)DORN DODGER
dodgy : a,교묘히 도망치는,속임질 잘하는,교활한,교묘한
dodo : n,도도,구식사람,얼간이
dodrmeuse : n,(F=sleeper),(영)침대차
doe : n,암컷
Doe : n,John Doe
doek : n,두크(여자가 머리에 쓰는 4각형 두건)
doer : n,행위자,실행가
does : v,do의3인칭 단수,직설법 현재
doeskin : n,암사슴 가죽,무두질한 암사슴 가죽,도스킨(암사슴 가죽 비슷한 나사)
doesn't : n,does not의 단축
doest : v,DO의 2인칭 단수 직설법 현재형
doeth : v,DO의 3인칭 단수형
doff : vt,벗다,버리다
dofunny : n,(미)싸구려,부속품,장치
dog : n,개,수캐,수컷,망나니,허세,겉꾸밈,과시
dog's age : x,오랫동안
dog'sbane : n,=DOGBANE
dog'sbody : n,(영)쫄자,뼈빠지게 일하는 사람
dog's breakfast : x,뒤죽박죽,엉망
dog'sdinner : x,먹다 남은 음식,엉망 진창
dog'seared : a,=DOGEARED
dog's grass : x,=DOUCH GRASS
dog's letter : x,견음 문자
dog's meat : x,개에게 주는 고기(말고기 등)
dog's nose : x,맥주와 진과의 혼합주
dog'sstongue : n,(식)큰꽃마리
dog'stooth violet : x,=DOGTOOTH VIOLET
dog ape : x,=BABOON
dogate : n,DOGE의 직
dogbane : n,개정향풀
dogberry : n,(식)층층나무,마가목,그 열매(식용에 부적)
Dogberry : n,도그베리,어리석은 관리
dog biscuit : x,도그비스킷(개먹이),(미)야전용 비스킷
dog box : x,(영)개 수송용  화차
dogcart : n,2륜마차의 일종,개가끄는 수레
dogcatcher : n,(미)들개 포획인
dogcheap : n,개값의
dog clutch : x,(기)맞물리는 클러치
dog collar : x,개의 목걸이
dog days : x,산복,복종
doge : n,총독
dogear : n,=DOG'SEAR
dogeared : a,책장 모서리가 접힌,써서 낡은,초라한
dogeatdog : a,먹느냐 먹히느냐의
dog end : x,담배 꽁초
dogface : n,군인,보병
dogfall : n,(레슬링)무승부,비김
dog fancier : x,애견가,개장수
dog fennel : x,(식)개꽃의 일종
dogfight : n,개싸움,치열한 공중전,난전,난투
dogfish : n,돔발상어
dog food : x,개의 먹이
dogfoot : n,(미)보병
dog fox : x,수여우
dogged : a,완고한
dogger : n,네덜란드의 쌍돛대 어선
Dogger Bank : n,도거 뱅크(영국 북쪽 북해 중앙부의 해역,세계 유수의 대어장)
doggerel : n,a,서투른시,빈약한,서투른
doggery : n,개 같은 행동,(집합적)개,하층민,(미)대폿집
doggie : n,강아지,멍멍개의
doggie bag : x,식당 등에서 손님이 먹고 남은 음식을 넣어 주는 종이 봉지
dogginess : n,개 같음,개를 좋아함,개 냄새
doggish : a,개의,개 같은,심술궂은,딱딱거리는
doggo : ad,몰래 숨어서,남의눈을 피하여
doggone : n,ad,(미)저주함,괘씸함,비참함,괘씸하게,지긋지긋하게
doggoned : a,ad,(미)=DOGGONE
dog grass : x,(식)COUCH GRASS
doggy : a,개의,개를 좋아하는
doghole : n,누추한곳
doghood : n,개임,개의 성질
doghouse : n,개집(in the doghouse 인기를 잃고 체면이 깎여)
doghutch : n,개집,누추한 곳
dogie : n,(미)(목장의)어미 없는
dog Latin : x,변칙 라틴어
dog lead : n,개줄,개사슬
dogleg : a,급각도로 휜
doglegged : a,(개의 뒷다리 처럼)굽은
dog letter : x,=DOG'S SETTER
doglike : a,개 같은,충실한
dog louse : x,개이(기생충)
dogma : n,교의,교조,교리,독단론
dogmatic : a,독단적인,교의의,교리의
dogmatics : n,(기독교)교리론,교의학
dogmatism : n,독단론,교조주의
dogmatismtist : n,독단론자
dogmatismtize : vi,vt,독단적으로 주장하다
dognap : vt,(실험용으로 팔기 우해)개를 훔치다
dogood : a,(공상적인)사회 개량을 꾀하는,dogooder()n,doggoding()
dogooder : n,사회개량가
dogoodism : n,(공상적)사회 개량주의
dog paddle : x,개헤엄
dogpoor : n,몹시 가난한
dog racing : x,개 경주
dog rose : x,찔레의 일종
dogsear : n,페이지 귀퉁이의 접힘,페이지 모서리를접다
dogshore : n,(진수할 때까지 배를 떠받치는)버팀 기둥
dog show : x,개 전람회
dogsick : a,몹시 편찮은
dogskin : n,개가죽,무두질한(모조의)개가죽
dog sledge : x,개썰매
dogsleep : n,겉잠,풋잠
dog soldier : x,고참병
dogstail : x,(식)왕바랭이 무리
Dog Star : x,=SIRIUS=PROCYON
dogtag : n,감출,인식표
dogtail : n,=DOGSTAIL,벽돌용 흙손
dog tick : x,(동)개진드기
dogtired : a,녹초가된
dogtooth : n,송곳니
dogtooth violet : x,얼레지속의 식물
dog tour : x,지방 순회 공연
dog train : x,(캐나다)(한 떼가 끄는)개 썰매
dogtrot : n,종종걸음
dog violet : x,향기 없는 야생 제비꽃
dog wagon : x,전차(버스)를 개조한 식당
dogwatch : n,절반직
dogweary : a,아주 지친
dog whip : x,개 채찍
dogwood : n,말채나무
dogy : n,=DOGIE
doh : n,=DO
Doha : n,도하(Qatar의 수도)
doily : n,도일리(꽃병 따위 받침용의 레이스 또는 종이 냅킨)
doing : n,행위,실행,소행,행동
doit : n,옛네덜란드의동전
doited : a,(스코)노망한
doityourself : a,손수하는,자작의
doityourselfer : n,손수 만드는 사람
Dol : x,여자 이름
dol, : x,dollar
dolar area : x,(경)달러 지역
Dolbyized : a,돌비 방식의
Dolby system : x,돌비방식(녹음 테이프의 잡음을 줄이는 방법)
dolce : a,달콤한,감미로운
dolce far niente : n,안일,일락
dolce vita : n,나태하고 방종한 생활,달콤한 생활
doldrums : n,무풍대,의기소침,침울
dole : n,시여물,실업수당,운명,짤름거리다,비탄
doledrawer : n,실업 수당을 받는 사람
doleful : a,슬픔엘 잠긴,음침한
dolerite : n,조립현무암
dolesman : n,구호품을 받는 사람
dolesome : a,=DOLEFUL
dolichocephalic : a,장두의
doline : n,(지질)돌리네(석회암 지대의 움푹 패인 땅)
dolittle : n,a,게으름뱅이,나태한 사람,게으른
doll : n,vt,vi,인형,인형같은미녀,젊은여자,차려입다,멋내다
Doll : x,여자 이름
doll's house : x,(영)=DOLLHOUSE
dollar : n,달러(bet one's bottom dollar 전재산을 걸다,확신하다)
dollar averaging : x,(증권)정액 정기 매입(시세와 관계없이 정기적으로 일정 총액의 증권을 사는 투자법)
dollarayear man : x,(미)언달러맨(거의 무보수로 연방 정부에서 일하는 민간인)
dollar crisis : x,수입 초과로 인한 달러 위기
dollar diplomacy : x,달러 외교
dollar gap : x,(경)달러 위기
dollar imperialism : x,달러 제국주의
dollarsandcents : a,금전의,금전만을 고려한
dollar sign : x,달러 기호
dollar spot : x,(식)달러 스폿(갈색 부분이 서서히 퍼져 가는 잔디의 병)
dollarwatcher : n,검약가
dollarwise : ad,달러로,달러로 환산하여,금전적으로
doll carriage : x,인형의 탈 것
dollhouse : n,인형의집,장난감같이 작은집
dollish : a,인형 같은,새침한,아름다우나 표정이 없는
dollop : n,(치즈,버터같이 말랑말랑한)덩어리,소량
dolly : n,인형,이동식촬영대
Dolly : n,=DOLL
dolly bird : x,(영)젊고 매력적인 여자
dolly dancer : x,(미)장교의 환심을 사서 편한 자리를 얻는 병사
dolly shop : x,(간판이 검은 인형인 데서)(뱃사람 상대의)고물상 겸 전당포
dolly shot : x,이동 촬영
Dolly Varden : x,꽃무늬의 여자용 사라사옷과 모자(19세기 스타일)
dolman : n,케이프식 소매가 달린 여성요 망토,터키의 외투,경기병용 재킷
dolman sleeve : x,돌먼 슬리브(소맷부리쪽에서 좁아지는 헐렁한 소매)
dolmen : n,돌멘(소매가 케이프 같이 넓은 여성용 망토),고인돌
dolomite : n,백운석
Dolomites : n,돌로미테 알프스
dolor : n,비애
Dolores : n,여자 이름
dolorimeter : n,(의)통각계
dolorimetry : n,(의)통각 측정
dolorology : n,통각학,동통학
dolorous : a,슬픈
dolphinarium : n,돌고래 수족관
dolphin kick : x,버터플라이의 발놀림
dolphin striker : x,(해)돛단배 이물에 붙인 창모양의 원재
dolpin : n,돌고래
dols, : x,dollars
dolt : n,얼간이,바보
doltish : a,우둔한
Dom : n,베네딕트회 등의 수도사의 존칭,돈(포르투갈이나 브라질의 귀인,고위 성직자의 세례명에 붙이던 경칭)
dom, : x,domian,domestic,dominion
dom, : suf,...으로서의 지위,위계,...권,...의 세력 범위,추상적 관념
domain : n,영토,영역,토지,개인 소유지,범위,변역,영역,자구
domanial : a,영지의,소유지의
dome : n,둥근천정,둥근꼭대기,반구형의것
dome car : x,(철도)전망차(유리 천장의)
domed : a,둥근 지붕의(으로 덮은),둥근 천장의,반구형의
dome light : x,차내등
domesday : n,(고)=DOOMSDAY
Domesday Book : x,토지 대장(1086년 William I세가 만들게 한 잉글랜드 전역)
domestic : a,가정내의,가사의,가정에충실한,가정적인,국내의,국산의,길들여진,하인,하녀
domesticable : a,길들이기 쉬운,가정에 정들기 쉬운
domestic affairs : x,가사
domestically : ad,가정적으로,가사상,국내에서,국내 문제에 관해서
domestic animal : x,가축
domesticate : vt,길들이다,이민,식물 등을 토지에 순화 시키다,가정에 익숙케 하다
domestication : n,길들임,교화
domesticcontent bill : x,(미)국내 부품 조달(의무화)법안
domestic demand : x,국내수요,내수
domestic economy : x,가계
domestic fowl : x,가금
domestic industry : x,가내 공업
domesticity : n,가정적임,가정생활,가사
domestic relatios court : x,가정 법원
domestic science : x,가정학
domestic system : x,가내 공업 제도
domestic violence : x,(사회)가정내 폭력
domic, : a,둥근 지붕식의 돔이 있는
domicile : n,주소,주거,어음지급지
domiciled : a,지불지 지정의
domiciliary : a,주소의,가택의,어음 지불지의
domiciliary register : x,호적
domiciliary search : x,(법)가택 수색
domiciliate : vt,=DOMICILE,살다,정주하다
domiciliation : n,주소를 정함,정주
dominance : n,우세,우성
dominant : a,우세한,지배적인,우성의,딸림음의,속음의
dominant character : x,(생)우성 형질
dominant gene : x,(생)우성 유전자
dominate : vt,vi,지배하다,억제하다,우뚝솟다,우세하다,위압하다
domination : n,지배,억제
dominative : a,지배적인,우세한
dominator : n,지배자
domineer : vi,권력을 휘두르다
domineering : a,횡포한,거만한,domineeringly()ad
Dominic : n,Saint(1170~1221)스페인의 수도사,도미니크 교단의 개조
Dominica : n,서인도 제도의 한 섬
Dominical : n,주의,예수의,주일의,주일,일요일,주일 문자,교회력에서 그해의 일요일을 표시하는 A에서 G까지 중의 한자
dominical letter : x,주일 문자(교회력에서 일요일을 표시하는 A-G의 일곱자 중 하나)
Dominican : n,도미니크 교단의 수도사,도미니크 공화국의 주민
Dominican : a,n,성 도미니코의,도미니카 공화국의,도미니코회의 수도사
Dominican Order : x,도미니코 수도회(로마 카톨릭 소속)
Dominican Republic : n,도미니카 공화국(수도 Santo Domingo)
dominie : n,(주로 스코)선생,(미)목사
dominion : n,통치권,주권,소유권,통치,지배
Dominion Day : x,(캐나다의)자치 기념일(7월 1일)
Dominique : n,여자 이름,(종)미국산 닭의 일종
domino : n,후드가 붙은 겉옷,무도회용 가면,도미노 놀이,도미노패
dominoed : a,도미노 가장복을 입은
domino efect : x,도미노 효과
domino paper : x,대리석 무늬 종이(벽지 등)
domino theory : x,도미노 이론(한 나라가 공산화되면 인접 국가들도 공산화된다는)
domminical year : x,서력,서기
domsat : n,국내(용)통신 위성
domy : a,돔(모양)의
don : vt,걸치다,입다,명사,능수꾼
Don : n,남자이름
don't : n,do not의 단축,금지조항서
don'tcare : x,부주의한 사람
don'tknow : n,(앙케이트 조사에서)모른다고 대답하는 사람
dona : n,=DONA
dona : n,귀부인
dona : n,(영)여자,애인
Donald : n,남자 이름
Donald Duck : x,도널드 덕
Donald Duck effect : x,도널드 덕 효과(우주 비행중의 음성의 고음화 현상)
donate : vt,기증하다,기여하다,주다
donated embryo baby : x,수정란 이식아
donation : n,기증품,기부금
donation party : x,(미)손님이 선물을 주는 파티)
donative : a,기증물,기부금,기증의(을 위한)
donator : n,기부자
Donau : n,도나우강
Doncaster : n,잉글랜드 중부의 도시
done : v,do의 과거분사
donee : n,수증자
doneness : n,음식이 알맞게 요리된 상태,(요리의) 만듦새
dong : n,큰 종이 뎅 하고 울리는 소리,강타,
dong : n,동(베트남의 화폐단위
donga : n,(남아프리카의)협곡,산협
donjon : n,아성,내성
Don Juan : n,돈환,스페인의 방탕한 귀족
donke's yesrs : x,매우 오랜동안
donkey : n,당나귀,멍텅구리,고집통이
donkey boiler : x,(기)보조 보일러
donkey engine : x,소형의 중기기관
donkey jacket : x,두꺼운 방수 작업복
donkeyman : n,동키맨
donkey work : x,단조롭고 고된 일
donna : n,(이탈리아에서의)귀부인
Donne : x,John(1573~1631)영국의 종교 시인
Donnie : n,=DON 1
donnish : a,학생감 같은,
donny : n,(어린아기에게) 손,손!
donnybrook : n,(종종)떠들썩한 언쟁
donor : n,기증자,기부자
donor card : x,(혈액 장기 제공자가 휴대하는)제공자 카드
donothing : a,아무것도 하지않는,게으름뱅이
Don Quixite : x,돈키호테(Cervantes작 풍자 소설의 주인공)
dontopedalogy : n,경솔한 말을 하는 버릇
donut : n,=DOUGHNUT
doobie : n,(미)대마초 담배
doodad : n,싸구려 장식품
doodah : n,흥분,당황
doodle : n,낙서
doodlebug : n,개미귀신
doodoo : n,응가
doofunny : n,=DOFUNNY
doojee : n,(미)헤로인(마약)
doojigger : n,(미)자질구레한 물건,싼 물건
doolie : n,(미)(공군 사관학교)1학년생
dooly : n,(인도)간이 들것
doom : n,vt,운명,파멸,죽음,운명짓다,선고하다
doomed : a,운이 다한,불운한
doomsayer : n,(큰 재난 등)불길한 일을 예언하는 사람
doomsday : n,세계의 종말,최후의 심판일
Doomsday Book : x,=DOMESDAY
doomsdayer : x,=DOOMSAYER
Doomsday Machine : x,인류 파멸의 흉기
doomsday scenario : x,(군)지구 최후의 날 시나리오
doomster : n,재판관,=DOOMSAYER
doomwatch : n,환경 파괴 방지를 위한 감시
door : n,문,문짝,출입구,문간,한집,손님 맞으려 나가다,집안에서
door alarm : x,현관의 경보장치
doorbell : n,초인종
doorbell pusher : x,선거 따위의 운동원
doorcase : n,문틀
door chain : x,도언 체인(방범용 문의 쇠사슬)
door check : x,도어체크(문이 천천히 닫히게 하는 장치)
doordie : a,(목적을 위해)결사적인,총력을 다한,위기에 처한
doorframe : n,=DOORCASE
door handle : x,(영)=DOORNOB
door jamb : n,문설주
doorkeeper : n,문지기
doorkey child : x,부모가 맞벌이 하는 집안의 아이
doorknob : n,문의손잡이
doorknocker : n,노커(방문객이 두들겨 알리는 문에 달린 쇠)
doorless : a,문 없는
doorman : n,문열어주는 사람
doormat : x,신흙 털개,억울해도 잠자코 있는 사람
door mirror : x,(자동차의)도어(사이드)미러
door money : x,입장료
doornail : n,(옛날 문의) 징모양의 큰 못
dooropener : n,잠겨진 문을 여는 기구,호별 방문 외판원이 집에 들어가기 위해 하는 선물
doorplate : n,문패
doorpost : n,=DOORHAMB
door prize : x,(미)참가자 상(입장 때 받은 표로 당첨된 상품)
door roller : x,(미닫이의)호차
doorscraper : n,(현관문 밖에 두는 금속제)흙긁개
doorsill : n,문지방
door starter : x,(유개 화차의)도어 시동 장치
doorstep : n,현관계단
doorstone : n,문 앞의 섬돌
doorstop : n,문짝이 열려있도록 하는 것
doortodoor : a,집집마다의,호별의,
door track : x,미닫이의 레일
doorway : n,문간,입구
doorwop : n,두왑(연주에 맞추어 코러스가 뒤얽히는 팝스)
dooryard : n,문 앞 뜰
doozer : n,(미)출중한 것
dopa : n,아미노산의일종
dopamine : n,도파민(뇌신경의 전달 작용에 필요한 물질)
dopant : n,doping을 위해 반도체에 첨가하는 소량의 화학적 불순물
dope : n,도프도료,미취약,흥분제,경마정보,도프를 바르다,~에 마약을 먹이다
dope check : x,(선수의)흥분제(약물)검사
dope fiend : x,마약 상용자
dope nik : n,마약 상용자
dope pusher : x,(미)마약 밀매자
doper : n,마약 상용자
dopesheet : n,경마 신문,(경마 등의)예상지
dopester : n,예상가
dope story : x,=THINK PIECE1
dopey : n,멍한,얼간이의,마약에 마취된것 같은
doping : n,(물)도핑(반도체에 불순물을 첨가하여 전기적 특성을 얻기),(스포츠)도핑,금지 약물 복용
doping test : x,금지 약물 검사
Doppelganger : n,(G=doublegeor),생령(본인에게만 보이는)
Doppler effect : x,도플러 효과
Doppler Lidar System : x,도플러 효과를 이용한 광학식 속도계
Doppler shift : x,(물)도플러 편이
Dopplershift : vt,(물)(주파수 등에)도플러 편이를 일으키다
dopy : a,=DOPEY
dor : n,붕붕거리며 나는 곤충
Dora : n,여자 이름
dorado : n,(어)만새기,(천)황새치자리
dorbeetle : n,=DOR
Dorcassociety : x,도커스회(빈민에게 옷을 지어 주는 자선 여성 단체)
doremi : n,(미)돈
Dorian : a,고대 그리스의 DORIS의 사람의,검소하고 건실한
Doric : a,도리아식의
Doris : n,여자 이름
dork : n,(미)음경,유행에 뒤진 사람,바보
Dorking : n,a,(영국의 원산지 명에서),도킹종의 닭
dorm : n,=dormito
dormancy : n,휴면 상태
dormant : a,잠자는,활동휴지중인
dormant partner : x,=SILENT PARTNER
dormant window : x,DORMER
dormer : n,지붕창
dormice : n,DORMOUSE의 복수
dormie : a,(골프)(매치 플레이에서)남은 홀수만큼 이기고 있는,도미의
dormitory : n,기숙사,교외택지
dormitory car : x,(승무원용)침대차
dormitory ship : x,(단체 학생 등을 위한)숙박 시설을 갖춘 배
dormitory suburb : x,=DORMITORY 2
Dormobile : n,(영)도모빌(생활 설비가 있는 여행용 차,상표명)
dormouse : n,산쥐류
dormy : a,남은 홀수만큼 이겨나가고 있는
doron : n,유리 섬유제 방탄복
dorotha : n,여자 이름
Dorothy bag : x,(영)아가리를 끈으로 죄는 여자용 핸드백
dorp : n,작은 부락,소촌락
Dors : x,Dorsetshire
dors- : x,_ (연결형)(등과,등의,의 뜻
dorsal : a,지느러미
dorsal fin : x,(어)등지느러미
dorsal vertebra : n,(각)흉추
Dorset : n,영국 남서부의 주
Dorsetshire : n,영국 남부의 주
dorsum : n,등,등부분,(음성)혀의 등
dorter : n,(고)(수도원 등의)합숙소
Dorvhester : n,잉글랜드 Dorset주의 주도
dory : n,(대구잡이용)평저 어선
dory : n,(어)달고기류
DOS : x,(전산)disk operating system
dosados : n,등을 맞대고,(미)등을 맞대고 둘이서 추는 댄스
dosage : n,투약,조제,약의 복용량(X선방사 등의)적응량,포도주의 품질개량을 위한 당밀,브랜디 따위의 첨가,주어진 분량
dose : n,약의 1회분,~에 투약하다,복용시키다
dosimeter : n,약량계,선량계
dosimetry : n,약량 측정,선량 측정(방사선의)
Dos Passos : n,도스 패소스(미국의 작가)
doss : n,(여인숙의)침대
dossal : n,(제단 뒤쪽 도는 목사 자리 앞의)휘장,장막
dosseat : vt,=UNSEAT
dossected : a,절개한,(식)전열의,(지질)개석된
dossecting : a,해부의,절개용의
dosser : n,등에 메는 짐바구니
doss house : x,(영)값싼 여인숙
dossier : n,일건 서류
dossy : a,(영)맵시있는
dost : v,(고)DO의 2인칭 단수,직설법,현재형
Dostoevski : n,도스토예프스키(러시아의 소설가)
dot : n,점,점재,점을찍다,점재시키다,세세한데 까지 소홀히 않고 분명하게 하다)
Dot : n,여자 이름
DOT : x,(미)Department of Transportation
dotage : n,노망,익애
dotanddash : a,점과 선으로 된,모스식 부호의
dotard : n,노망든 사람
dote : vi,노망들다,익애하다
doth : v,(고)DO의 3인칭 단수,직설법,현재형
doting : a,맹목적으로 사랑하는,(자식을)지나치게 귀여워하는,노망한
dot man : x,(미)(캐나다의)운수성 공무원
dot pattern : x,망점(사진,도판의)
dot printer : x,(전산)도트 프린터(점을 짜맞춰 문자를 표현하는 인쇄장치)
dotted : a,점이있는,점을찍은,점재한
dotted line : x,점선,(지도에 적어 넣은)예정 코스,무조건 동의하다
dottel : n,=DOTTLE
dotter : n,점 찍는 기구,(특히)점묘 기구
dotterel : n,(어)물떼새의 일종,(영)바보
dottle : n,담뱃진(골통대에 남아 굳은)담뱃진
dotty : a,정신이 이상한,~에 열중한,다리를저는,휘청휘청하는,점이많은,점투성이의
Dotty : n,여자 이름
dot wheel : x,점선 내는 기구
doty : a,(나무가)썩어 가는,썩은,(미)늙어빠진
douane : n,(F)(국경의)세관
Douay : n,프랑스 북부의 도시
Douay Bible : x,두에잉 성서(Latin Vulgate로 부터의 영역)
double : a,2배의,2중의,쌍의,표리가 있는,거짓의,모호한,2배하다,겹치다,접다,2배가되다,달리다,일을겸하다
doubleacting : a,(기)복동(식)의
double agent : x,이중 간첩
double ax : x,양날 도끼
doublebagger : n,(미)추녀,추남
doublebank : vt,(해)(보트를)쌍죄에서 젓다,(밧줄을)양쪽에서 잡아당기다
doublebanked : a,(해)쌍좌의(보트)
double bar : x,(악보의)겹세로줄
doublebarrdled : a,쌍총열의,2연발의,이중목적의,애매한
doublebarrel : n,2연발총
double bass : x,=CONTRABASS
double bassoon : x,더블바순,콘트라 바순
double bed : x,더블베드,2인용 침대
doublebedded : a,침대가 2대 있는,2인용 침대가 있는
double bill : x,영화,연극의 2편 동시 상영
double bind : x,(정의)2중 구속(어린이 등이 2개의 모순된 명령,요구를 받은 경우),딜레마
double blind : a,(의)(약의 효과를 판정하는 방법에서)2중 맹검의
doublebline test : x,이중맹 검사법(신약 효과의 검사법)
doublebly : ad,2배로,2중으로
double bogey : x,(골프)더블보기(파 보다 2타 더 쳐서 홀에 넣기)
doublebogey : x,(골프)(어떤홀을)더블보기로 오르다
double boiler : x,이2중 냄비
double bond : x,(화)이중 결합
doublebook : vt,(호텔에서 취소에 대비하여)(한방에)이중으로 예약을 받다
double bottom : x,(상자,배 등의)겹바닥
doublebreasted : a,상의가 더블인
double burden : x,(사회)이중 부담(여성의 가사 책임과 직업인으로서의 책무 등)
double character : x,이중 인격
doublecheck : vt,vi,재확인하다
double chin : x,이중턱
doublechinned : a,이중 턱의
double cloth : x,이중직
doubleclutch : vi,(미)(자동차에서)더블 클러치를 밟다
double consonant : x,(음성)이중 자음
doublecover : vt,=DOUBLETEAM
double cream : x,(영)농도 높은 크림
doublecrop : vt,혼작하다,혼작으로 사용하다
double cropping : x,혼작
double cross : x,배반
double dagger : x,=DBGGER
double date : x,(미)남녀 두쌍의 데이트
doubledate : vi,vt,(미)(...와)더블데이트를 하다
doubledeal : vi,속이다
doubledealer : n,언행에 표리가 있는 사람,협잡꾼
doubledealing : a,표리가있는 언행,사기,표리가 있는,불성실한
doubledeck : a,2층 갑판의,2층으로 된
doubledecker : n,2중갑판의 배,이층버스
doubledeclutch : vi,(영)=DOUBLECLUTCH
double decomposition : x,(화)복분해
double digit : x,두자리의
doubledip : vi,(미)(퇴역 군인 등이)이중 벌이를 하다(연금을 받으면서 별도로 정부 기관의 일을 하며 급료를 받기)
doubledome : n,(미)=EGGHEAD
double door : x,양쪽으로 여닫는 문
double Dutch : x,통 알아 들을 수 없는 말
double duty : x,두가지 임무
doubleduty : a,두가지 (역할)을 가진
doubledyed : a,두번 염색한,악에 깊이 물든,철저한(악한 등)
double eagle : x,쌍두의 독수리,(미)20달러 금화,(골프)더블 이글
doubleedged : a,양날의,모호한
doubleended : a,양 끝이 닮은,양 끝이 앞이 되는,앞뒤가 없는(배,전차)
doubleender : n,머리가 둘 있는것,양두 기관차(배)
doubleentendre : n,두가지 뜻의 어구
double entry : x,복식 부기법
double exposure : x,(사)이중 노출
doublefaced : a,양면의,언행에 표리가있는,위선적인
double fault : x,(정구)더블 폴트(서브를 두번 연속해서 실패하기)
doublefault : vi,(정구)더블 폴트하다
double feature : x,(영)두편 동시 상영
doublefigure : a,(특히 영)=DOUBLEDIGIT
double first : x,(영대학)(졸업시험의)2과목 최고 득점(자)
double flat : x,(악)겹내림표
doublegaited : a,(미)양성(애)의,남녀 양용의
doubleganger : n,DOPPELGANGER
doubleglaze : vt,(창문에)이중 유리를 끼우다
doubleglazing : n,이중 유리
double harness : a,쌍두 마차용 마구,결혼 생활,협력,맞벌이하다
doubleheader : n,더블헤더,기관차를 둘 단 열차
doublehearted : a,두 마음(표리)이 있는
doublehelical : a,(생화)(DNA의)이중 나선의
double helix : x,(생화)(염색체의 DNA분자 내의)이중 나선(구조)
double house : x,(미)현관 양 앞에 방이 있는 집,2세대 연립 주택
doublehung : a,내리닫이의 (창문)
double image : x,이중상(산이 잠자는 사자로 보이는 등)
double insurance : x,(보험)중복 보험
double jeopardy : x,(법)이중의 위험(동일 범죄로 피고를 재차 재판에 회부하는 일)
double jobber : x,(영)(봉급에 보태기 위해)부업을 하는 사람
doublejointed : a,(전후 좌우 자유로이 움직이는)이중 관절을 가진
double knit : x,겹으로 싼 천
doubleleaded : a,(인)이배 행간으로 한
double letter : x,(인)합자
doublelock : vt,이중으로 자물쇠를 채우다,단단히 문단속하다
double meanng : x,=DOUBLEENTENDRE
doubleminded : a,결단을 못 내리는,딴 마음을 가진
double negative : x,2중 부정
doubleness : n,중복성,이중,2배크기,(행동의)표리
double nickel : x,(미)시속 55마일(제한 속도)
double note : x,배온음표
doubleo : n,(미)엄중한 조사,시찰 여행
doublepacked : a,(식품 등이)이중으로 포장된
doublepage : a,두 페이지 크기의
doublepark : vi,나란히 주차하다
double personality : x,(심)이중 인격
double play : x,병살
double pneumonia : x,(의)양측 폐렴
double possessive : x,(문법)이중 소유격
double precision : x,(전산)2배 정밀도(한수를 나타내기 위해 컴퓨터의 두 워드를 쓰기)
doublequick : a,ad,매우 급한(하게)
double quotes : x,(인)이중 인용 부호
double reed : x, (악)더블 리드(오부에,바순처럼 혀가 두 개 달린 악기)
doublereed : a,(악)더블 리드의
doublerefine : vt,두 번 정련하다
double refraction : x,(광)복굴절
double reverse : x,더블 리버스
double rhyme : x,이중 압운
double rhythm : x,더블 리듬(약음부가 강음부의 2배 길이의 운율)
double rifle : x,복식 라이플총
doubleripper : x,(미)2대의 연결 썰매
double role : x,(영)1인 2역
double room : x,(호텔 등의)2인용 방
double salt : x,(화)복염
doubleseater : n,(공)복좌식 비행기
double sharp : x,(악)겹올림표
doublespace : vi,한줄씩 띄어서 타자하다
doublespeak : n,=DOUBLETALK
doublespread : n,(신문 등의)2페이지 크기의 광고,양면 광고
double standard : x,이중 표준(여성보다 남성에게 관대하게 된 성도덕률),복본위제(bimetalism)
double star : x,이중성
double steal : x,(야구)더블스틸,중도
double stem : x,(스키)속력을 늦추기 위해 양쪽 스키의 뒤쪽을 벌리는 자세
doublestop : vi,n,(악)(현악기의)2현을 동시에 누르고 켜다(켜기)
double suicide : x,정사
Double Summer Time : x,이중 서머타임(표준시간보다 2시간 빠름)
doublet : n,꼭끼는 남자용 상의
double tackle : x,이중 도르래
double take : x,희극 배우가 처음엔 무심히 듣다가 뒤늦게 깨닫고 깜짝 놀라는 체하는 짓
double talk : x,횡설수설,조리가 안서는 말
doubleteam : vt,2명이 1명의 상대방 선수를 동시에 방해하다
Double Ten : x,쌍십절(중국 건국 기념일,10월 10일)
doublethink : n,이중 신념
double time : x,구보
doubleton : n,(카드)두 장만 짝이 맞는 손에 잡은 패
doubletongue : vi,vt,(악)(취주 악기로)(빠른 템포의 스타카토 악절을)복절법으로 연주하다
doubletongued : a,일구 이언하는,거짓말의
double track : x,(철도)복선,(공)더블 트랙
doubletrack : vt,(철도)복선으로 하다
double transplant : x,(의)(동시)이중 장기 이식(가령 심장과 간장의)
doubletree : n,(수령,쟁기 따위의)가로대
double truck : x,신문의 좌우 양면광고 기사
doublewedding : x,두 쌍의 합동 결혼식
double wing : x,(미)더블 윙(백 포메이션)(양쪽 위에 백을 한 사람씩 배치한 공격 진형)
doubling : n,배가,배증,이중으로 하기,접어 넣기
doubloon : n,옛 스페인의금화
doubly : ad,두 곱으로,2중으로
doubt : n,vt,vi,의심,의문,의심하다(geyond doubt의심할 여지가 없이)
doubtable : a,의심할 여지가 있는,불확실한
doubtful : a,의심스러운
doubtfully : ad,확실히
doubting : a,의혹을 품고 있는,불안한
doubting Thomas : x,의심많은 사람
doubtless : ad,확실히
douce : a,(주로 스코)조용한,침착한,착실한
douceur : n,(F)팁,뇌물
douche : n,vt,vi,관수,주수기,관수하다
Doug : n,남자 이름
dough : n,반죽,생빵
doughboy : n,보병
doughface : n,(미)줏대(패기)없는 사람
doughfaced : a,(미)얼굴이 핏기 없고 푸석푸석한,줏대(패기)없는
doughfoot : n,(미)보병
doughhead : n,(미)바보,멍청이
doughnut : n,도넛
doughnut foundry : x,(미)값싼 음식점,공짜로 식사할 수 있는 곳
doughty : a,용감한,굳센
doughy : a,생빵의,생짜의,설구운,창백한,투미한
Douglas : n,남자 이름
Douglas fir : x,미송(미국산 커다란 소나무)
Doukhobor : n,영혼의 전사,두호보르(파)(18세기 후반 남러시아의 무정부주의적,무교회적 기독교도)
Douma : n,=DUMA
doum palm : x,(식)이집트 종려
dour : a,뚱한,부루퉁한,엄한,가혹한
douroucouli : n,(동)(열대 아메리카산)밤원숭이
douse : vt,vi,(물속에)처박다,(물을)끼얹다,(해)(돛을)내리다,(등불을)끄다,=DOWSE
dove : n,비둘기,온유한사람
dove'sfoot : n,매발톱꽃무리(야생 식물)
dove color : x,비둘기색(엷은 홍회색)
dovecolored : a,비둘기색의
dovecote : n,비둘기장,비둘기집
doveeyed : a,눈매가 부드러운
dovehouse : n,비둘기장
dovelet : n,새끼비둘기
dovelike : a,비둘기 같은,온화한,유순한
Dover : n,도버해협
Dover's powder : x,도버산,아편토근산(진통,발한제)
dovetail : n,꼭들어 맞음,열장이음
dovetail joint : x,(목공)열장이음
doveward : ad,비둘기파 쪽으로
dovish : a,비둘기 같은,비둘기파와 같은,온건 평화파의
dow : n,도우선(인도양,아라비아해 등의 연안 무역 범선)
dow : n,=DHOW
Dow : n,=DOW JONES AVERAGE
Dow : x,dowager
dowager : n,vt,vi,귀족의 미망인,기품있는 노부인,공작 미망인,황태후
dowdy : a,초라한,단정치못한,시대에 뒤떨어진
dowdyish : a,볼품 없는,험수룩한
dowel : n,장부촉
dower : n,과부산,지참금,천부의 재능,재능을 부여하다
dowitcher : n,(조)큰부리도요(도요새 비슷한 새,북미 동해안산)
DowJones average : x,(증권)다우 존스 평균(주가)
DowJones industrial average : x,다우 존스 공업주(주) 평균
dowlas : n,(영)올이 굵은 옥양목의 일종
down : n,솜털,배내털,언덕,사구,밑으로,아래쪽에,가라앉아,하류에,~을 따라서,내려가는
downanddirty : a,(성,정치등이) 타락하고 더러운,부도덕한
downandout : a,영락한,다운당한
downatheel : a,구두 뒤축이 닳아빠진,가난한,초라한
downbeat : n,강박,우울한,불행한
downcast : a,풀이죽은,눈을 내리뜬,고개를 숙인,파멸,풀죽은 모습
downcomer : n,(기) 물건을 아래로 보내는 파이프
downcycle : n,(경기 순환의) 하강기,하강 사이클
downdraft : n,하강기류
down east : x,(미)동부 연안지방으로(에서,의),(특히)Maine 주로(에서,의)
down easter : x,(미)뉴잉글랜드 사람
downed : a,(미)(진창,눈 속 등에) 빠져든
downer : n,진정제,지겨운 경험(사람)
downfall : n,낙하,호우,몰락,멸망
downfallen : a,몰락한,(집등)무너진,황폐한
downfield : n,(미)다운필드(공격측에서 보아 수비측이 위치한 온 구역)
downgrade : a,vt,내리받이의,좌천시키다
downhaul : n,(해)(돛)내림밧줄
downhearted : a,낙담한
downhill : n,내리받이,쇠퇴,쇠퇴하는,편한,비탈을내려서
downhiller : n,(스키)활강선수
downhold : n,vt,(미)삭감하다,억제하다
downhole : ad,땅 속에,파내려가고
down home : x,(미)남부,시골
downhome : a,(미)남부(특유)의,남부적인,시골풍의,소박한,싹싹한
downiness : n,솜털 같은,유모질,폭신함,부드러움
Downing Street[d'auni7다우닝가(런던의 관청가),영국정부
down jacket : x,다운(오리털)재킷(솜털을 속에 넣어 누빈 재킷)
downland : n,넓은 고지,경사진 목초지,(특히 오스트레일리아,뉴질랜드의)기복이 있는 초원
downlead : n,옥내 도입선
downlink : n,다운링크(우주선,위성등으로부터 지구에의 데이타(정보)송신)
downmarket : a,ad,(영)저소득자용의(으로),대중용의(으로),싼(싸게)
down payment : x,(분할불의)계약금,첫불입금
downplay : vt,얕보다,가볍게 말하다
downpoint : vt,가짓수를 줄이다
downpour : n,억수,호우
downppipe : n,(영)수직 낙수 홈통
downpress : vt,억압하다,종속상태에 두다
downprice : vt,가격인하하다,값을 내리다
downrange : ad,a,(미)(미사일등이)사정을 따라,(미사일의)사정지역의
downranking : n,격하
downrate : vt,중시하지 않다,경시하다,낮추어 보다
downright : a,솔직한,명확한,철저히,완전한,아주
downry death : x,(인도)지참금살인(지참금 지불 불이행을 이유로 신부를 죽임)
Downs : n,잉글랜드 남부 및 동남부의 구릉지대,(영국 Kent주 동해안에 있는) 다운스 정박지
downscale : vt,n,a,규모를 축소하다,저소득층(의),하층 그룹(의)
downshift : vi,vt,n,(자동차 운전에서)저속 기어로 전환하다,시프트다운하다,저속 기어에의 전환,시프트다운
downside : n,a,아래쪽,(그래프 등의)하강 부분,아래쪽의,하강의
downsize : n,a,(차를)소형화하다,소형(의)
downslide : n,저하,하락
down south : x,(미)(일반적으로)남부 제주(에)
downspin : n,급락
downspout : n,(미)수직 낙수 홈통,(영)전당포
downstair : a,=DOWNSTAIRS
downstairs : a,n,아래층에,아래층,아래층에 사는 사람들
downstate : n,a,ad,(미)주의 남부,주남부의(에)
downstream : a,ad,하류의(에)강 아랫녘의(에)
downstroke : n,(피스톤 등의)위에서 밑으로의 작동,아래로의 운필
downsweep : vt,vi,아래로 커브시키다(하다)
downswing : n,(경기등의)하강,(골프)다운스윙
downtheline : a,ad,완전한(히),전면적인(으로),철저한(히)
downthrow : n,(지질)(단층에 의한 지반의)침강,저하,OVERTHROW 1
downthumb : vt,거부하다
downtime : n,휴지(중단),시간(사고,수리등으로 인한 공장,기계의)
downtoearth : a,철저한,더할나위 없는,현실적인,실제적인
downtown : n,도심지,중심가,상가의
downtowner : n,(미)상가(도심지)의 사람
downtrain : n,하행열차
downtrend : n,하락세,하향세
downtrod : a,(고)=DOWNTRODDEN
downtrodden : a,짓밟힌,압박된
downturn : n,하강,침체
down under : n,호주,뉴질랜드,호주와 뉴질랜드 지역,대척지
downward : a,내려가는,내리받이의,아래쪽으로,이래,이후,쇠미한,쇠잔하여
downwards : ad,쇠미한,쇠잔하여
downwarp : n,vi,지질,하향요곡(지층이 습곡이나 단층을 수반하지 않을 만큼 완만히 구부러지기),하향 요곡하다
downwash : n,(공)내려 씻음,세류(날개가 아래로 내리미는 공기),(산에서)내려씻기는 토사
downwind : a,바람불어 가는쪽으로 향한,순풍의
downy : a,솜털의,솜같은,교활한
downy mildew : x,(식)노균병
dowry : n,=dower
dowse : vt,vi,=DOUSE,점치는 막대기로 수맥(광맥)을 찾다,dowsing()n
dowser : n,수맥(광맥)을 점쳐 찾는 사람
dowsing rod : x,=DIVINING ROD
Dow theory : x,다우 이론(시장의 가격 변동에 입각한 증권 시세의 예상법)
doxology : n,송영(예배때 부르는 짧은 찬송)
doxy : n,(특히 종교상의) 설,교리
doxy : n,(고속)정부,갈보,행실이 나쁜여자
doyen : n,고참,장로
doyenne : n,(F)DOYEN의 여성형
doyle : n,도일(영국의 추리 소설가,명탐정)
doyley : n,=DOILY
doz, : x,dozen(s)
doze : n,졸기,졸다,졸며시간을 보내다
dozen : n,1다스,12개
dozens : n,)미)상대방 가족에 대한 농담을 하는 게임(흑인의 게임)
dozenth : n,=THELFTH
dozer : n,=BULLDOZER
dozy : a,졸음이 오는,졸리는,(영)어리석은
DP : n,=DISPLACED PERSON
DPA : x,Deutsche Presse Agentur(서독의 통신사)
dpe : x,developing printing and enlargement
dpt, : x,department,deponent
dr, : x,debit,debtor,drachm(s),dram(s),drawer
Dr, : x,Drive
Dr, : x,Doctor의 약어
Dr,Feelgood : x,각성제를 정기적으로 먹여 환자를 기분 좋게 만드는 의사
Dr,Strangelo ve : x,=STRANGELOVE
drab : n,담갈색,담갈색의,단조로운,허튼계집,매춘부
drabbet : n,((영)갈색 즈크천
drabble : vt,끌어더럽히다
dracaena : n,(식)용혈수
drachm : n,=DARCHMA,=DRAM
drachma : n,옛그리스은화
Draco : n,(천)용자리,(동)날도마뱀
Draco : n,드라콘(기원전 7세기 말의 Athens의 입법가,그의 법률은 매우 가혹했음)
Draconian : a,드라콘식의,엄격한,가혹한,Dracomianism()엄격주의
Draconic : a,=DRACONIAN,(천)용자리의
Dracula : n,드라큘라
draeadfully : ad,지독하게,몹시
draff : n,찌끼,(특히 맥주의)재강,(돼지에게 주는)음식 찌꺼기,draffy()찌꺼기의,가치없는
draft : n,끌기,견인,중량,한그물,뽑아냄,선발,징병,빼기,도면,설계안,초안,초고
draft allowancd : x,(운반중의)상품 감량에 대한 공제
draft beer : x,=DRAUGHT BEER
draft board : x,징병 위원회
draft card : x,(미)징병 카드
draft chair : x,WING CHAIR
draft dodgerl : x,징병 기피자
draftee : n,소집병
draft engine : x,(광산의)배수 기관
drafter : n,기초
draftette : n,여군
draft evad : x,징병 기피자
draft furnace : x,통풍로
draft gear : x,(철도)(차량의) 연결기
draft horse : x,복마,짐말
drafting : n,기안(기초),제도,(미)(징병의)선발
drafting room : x,제도실
draft net : x,예인망
draftnik : n,징병 반대족
draftsman : n,기초자,입안자,제도자
draft tube : x,(물 터빈의) 흡출관
drafty : a,외풍이들어오는
drag : vi,n,끌리다,발을 질질 끌며걷다,느릿느릿 나아가다,당기다,흙다,써레,바퀴 멈추개
drag anchor : x,=DRIFT ANCHOR
drag bunt : x,(야구)드래그 번트
drag chain : x,(기)바퀴 멈추는 쇠사슬,(차량의)연결 사슬,(비유)장애물,방해물
dragee : n,(F)사탕,당과,(케이크 장식에 쓰이는)은빛의 작은알,당의정
dragging : a,질질 끄는,(시간,일,행사 등이)오래 걸리는
draggin wagon : x,(미)레커차
draggle : vi,질질끌다,뒤쳐져서 따라가다,질질끌어 더럽히다
draggletail : n,지저분한사람,칠칠치못한여자
draggletailed : a,(여자가)옷자락을 질질 끄는,행실 나쁜
draggy : a,느릿느릿한,활기 없는,지루한
drag hunt : x,인공적인 냄새를 사용하는 사냥
dragline : n,=DRAGROPE,드래그라인(버킷 달린 토사 굴착기)
dragnet : n,저인망,수사망,대얀검거
dragoman : n,안내자,통역
dragon : n,용,용자리,엄격한 샤프롱,감시인
dragon's blood : x,기린혈(용혈수)의 열매에서 채취한 수지,와니스 등의 착색제)
dragon's teeth : x,내분의 씨,대전차 방어 설비
dragonet : n,작은용,용새끼,(어)동갈양태과의 물고기
dragonfly : n,잠자리
dragonnade : n,vt,(사)용기병의 박해,무력박해,무력으로 박해하다
dragoon : n,용기병,난폭하사람
drag parachute : x,감속 낙하산
drag party : x,(미)이성 복장으로 벌이는 파티,호모의 파티
drag queen : x,(미)(여자 차림을 좋아하는)남자 동성애자,여장 남자
drag race : x,(HOT ROD에 의한)자동차의 가속 경주
dragrope : n,(포차,기구를)끄는 줄,유도 로프
dragster : n,(미)DRAG RACE용 자동차,드래그레이스 참가자
drag strip : x,DRAG RACE용 직선 코스
dragsville : n,지루한 것
drail : n,(미)(낚시용의)굴림낚시,쟁기
drain : vt,vi,n,배수하다,빼내다,말리다,다 써버리다,들이켜다,마시다,비우다,흘러없어지다,뚝뚝듣다,배수,하수,유실,출비
drainage : n,배수,설비,배수법,하수,오수
drainage basin : x,배수 분지
drainage tube : x,(외과)배액관
drainage work : x,배수 공사
drainboard : n,(미)(개수대 앞의)그릇 건조대
drain cock : x,(기)(보일러의)배수 꼭지
drained weight : x,(통조림 등의)수분 제외 중량,고형(고체)량
drainer : n,하수(배관)공사하는 사람,배수기,배수구
draining : n,배수 (작용(공사))
draining board : x,(영)=DRAINBOARD
drainless : a,배수 설비가 없는,(시)마르는 일이 없는
drainpipe : n,하수관
drain pump : x,배수 펌프
drain trap : x,(수채의)냄새 막는 뚜껑
drake : n,수오리
Drake : n,드레이크(영국의 제독)
dram : n,드램,미량,한잔
DRAM : x,(전자)dynamic random access memory
dram, : x,dramatic,dramatist
dram,pers, : x,(극)dramatis personae
drama : n,극,희곡,각본,극적사건
Dramamine : n,드라마민,멀미약
dramatic : a,연극의,극적인
dramatically : ad,희곡(연극)적으로,극적으로
dramatic irony : x,(극)극적 아이러니(관객은 알고 있는데 등장 인물은 모르고 행동함으로써 생기는 아이러니)
dramatic monologue : x,(문학)극적 독백
dramatics : n,연기,연출법,소인극,신파조의 몸짓
dramatic unities : x,(극)(때,장소,행동의)3일치
dramatis personae : n,등장 인물
dramatist : n,극작가
dramatization : n,각색(작품)
dramatize : vt,극화하다,각색하다
dramaturge : n,극작가
dramaturgic : a,극작의,희곡(각본)연출 상의
dramaturgy : n,극작술(법),각본(극)의 상연(연출)법
dramshop : n,술집,목로주점
dramshop law : x,(미법)주류 제공자 책임법(음주자가 교통 사고 등을 낸 경우에 대한)
drank : v,drink의과거
drape : vt,곱게주름잡아 걸치다,주름잡아 드리운천,드레이프
draper : n,피륙상,포목상
drapery : n,휘장,커튼,포목,피륙,주름
drape suit : x,드레이프 수트(긴 상의와 좁은 바지)
drastic : a,철저한,과감한
drastically : ad,맹렬히
drat : vt,저주하다,귀찮다
dration : n,야전용 긴급휴대식량
dratted : a,지긋지긋한
draught : n,v,=draft
draught beer : n,생맥주
draughtboard : n,(영)=CHECKERBOARD
draught horse : x,=DRAFT HORST
draughts : n,(영)=CHECKERS
draughtsman : n,=DRAUGHTSMAN
draughty : a,=DRAFTY
drave : v,(고)DRIVE의 과거
Dravidian : a,n,드라비다 사람의,드라비다 사람,드라비다 말
Dravidic : a,=DRAVIDIAN
draw : vt,vi,n,끌다,당기다,이끌다,자아내다,이끌어내다,뽑아내다,그리다,묘사하다,접근하다
drawandfire : n,(미)(권총)속사
drawback : n,결점,약점,장애,핸디캡,환부
drawback lock : x,노브식 자물쇠(밖에서는 열쇠로 열고 안에서는 손잡이로 여는)
drawbar : n,(철도)차량 연결봉,트랙터의 연결봉
drawbridge : n,도개교
Drawcansir : n,드로캔서,적에게나 자기편에게나 강한 인물,몹시 거만하게 구는 사람
draw curtain : x,(좌우로)당기는 커튼
drawdown : n,삭감
drawee : n,어음수취인
drawer : n,발행인,제도사,서랍
drawers : n,드로어즈,속옷,팬츠,속바지
drawing : n,그림,선화,데상,제도,발행,달여내기
drawing account : x,(상)인출금 계정,(세일즈 맨의)선불액 계정,(미)=CURRENT ACCOUNT
drawing block : x,떼어 쓰게된 스케치 북
drawing board : x,제도판,그림판
drawing card : x,(대성황이 확실한)인기 프로,인기 있는 극
drawing compasses : x,제도용 컴퍼스
drawing instrument : x,제도 기구
drawing knife : x,=DRAWKNIFE
drawing master : x,미술 교사
drawing paper : x,도화지,제도용지
drawing pen : x,제도용 오구
drawing pin : n,제도용 핀,압정
drawing right : x,(경)인출권
drawing room : n,응접실
drawingroom : a,상류사회에 적합한(를 다룬),고상한,객실의,(미)특별 객차
drawing string : x,=DRAWSTRING
drawing table : x,제도용 책상
drawknife : n,당겨깎는칼
drawl : vt,n,느릿느릿 말하다,느린말투
drawling : a,느리게 질질 끄는,우물쭈물하는,뜸직뜸직한
drawman : n,플라스틱 성형 조립공
drawn : v,a,draw의 과거 분사,잡아뽑은,빼낸,찡그린,속을빼낸,비긴
drawn butter : x,(소스용의)녹인 버터
drawn game : x,드론게임,무승부
drawn glass : x,압연한 판유리
drawn net : x,올이 성긴 새그물
drawnthread : a,실을 뽑아 얽어 만든
drawn work : x,올을 뽑아 읽은 레이스의 일종
drawplate : n,(철사 제조용의 다이스 철판)
draw play : x,(미)드로 플레이
drawshave : x,=DRAWKNIFE
drawstring : n,(자루,옷자락 등을 졸라매는 끈
draw well : x,두레우물
dray : n,큰짐마차,화물자동차
drayage : n,짐마차 운반(삯)
dray horse : x,짐마차 말
drayman : n,짐미차꾼
drbbuk : n,(유대전설)(사람에게 들어가는)사망자의 악령
dread : vt,n,두려워하다,걱정하다,두려움,공포
dreadful : a,무서운,몹시 불쾌한,지겨운,따분한
dreadnought : n,대형전함,노급함,용감한사람
dream : n,꿈,몽상,꿈꾸다,공상하다
dream analysis : x,꿈 분석
dreamboat : n,차지하고 싶은 이성,욕심나는 것,아주 좋은 것
dreamer : n,꿈꾸는 사람,공상가
dream factory : x,영화스튜디오,영화 산업
dreamful : a,꿈 많은
dreamily : 꿈결같은a,
dreaminess : n,꿈꾸듯 황홀함 어렴풋함
dreamland : n,꿈나라
dreamless : a, 꿈이 없는,꿈꾸지 않는
dreamlike : a,꿈결같은
dream machine : x,텔레비젼 산업
dream reader : x,해몽가
dreamscape : a,n,꿈과 같은(초현실적인)정경(의 그림)
dreamstick : x,(미)아편 정제
dreamt : v,dream의 과거 분사
dreamworld : n,꿈의세계
dreamy : a,꿈결같은,어렴풋한,공상적인
drear : a,=DREARY
drearily : ad,쓸쓸하게,적막하게
drearisome : a,(방)=DREARY
dreary : a,황량한,쓸쓸한,처량한,울적한,음울한,지루한
dreck : n,똥,쓰레기,잡동사니,넝마
dredge : n,준설기,~에 가루를 뿌리다
dredger : n,준설기,가루를 뿌리는 기계
dredger : n,밀가루(설탕)뿌리는 기구(용기)
dredging : x,준설기
dree : vt,vi,참다,(스코)=DREICH
dreep : n,칠칠치 못한 사람
dreg : n,찌끼,앙금,지스러기,미량,남김 없이 다 마시다,쓴맛 단맛 다 보다
dreggy : a,찌꺼기가 있는 ,찌꺼기가 많은,탁한,더러운
Dregion : n,D층(이온권의 최하층)
dreich : a,(스코)쓸쓸한,침울한,오래끄는,시간이 걸리는,지루한,태만한
Dreiser : n,Theodore(1871~1945)미국의 소설가
drek : n,=DRECK
drench : vt,흠뻑적시다,물약을 먹이다
drencher : n,호우,폭우,(마소용의)물약 먹이는 기구
drenching : n,a,흠뻑 젖음,억수로 쏟아지는
Dresden : n,드레스덴(독일 동부의 도시)
Dresden porcelain : x,드레스덴 도자기
dre shield : x,여성의 겨드랑 밑에 대는 땀받이
dress : 입히다,치장하다,정장시키다,꾸미다,다듬다,무두질하다,치료하다,정열시키다,조리하다,옷을입다,정장하다,정렬하다,원피스형의 여성복,드레스,의복,의상,예복,정장
dressage : n,(F)말을 길들임
dress cap : x,(군)정장용 군모
dress circle : x,극장의 특등석
dress coat : n,예복,연미복
dressed : v,a,DRESS의 과거,과거분사,옷을 입은,손질을 한,요리 준비가 된(닭 등)
dresser : n,옷입는 사람,의상 담당자,장식하는 사람,멋쟁이
dresser set : x,화장 도구 세트(빗,거울 등)
dress form : x,(양재용)인체 모형
dress goods : x,옷감,양복감
dress guard : x,(여성용 자전거 등의)의복 보호 장치
dress improver : x,(영)(여성복의)허리받이
dressiness : n,옷치장을 좋아함,(복장이)맵시있음,화려함
dressing : n,마무리,장식,몸치장,드레싱
dressing bell : x,(만찬 등을 위해)몸치장할 것을 알리는 종
dressing case : x,여해용 화장품 그릇
dressing down : x,엄한 질책,꾸지람,구타
dressing gown : x, 화장옷,실내복
dressing jacket : x,(영)=DRESSING SACK
dressing maid : x,화장을 맡아보는 시녀
dressing robe : x,=DRESSING GOWN
dressing room : x,극장의 분장실,흔히,침실겸의 화장실
dressing sack : x,(미)(여성용의)짧은 화장복
dressing station : x,전방 치료소
dressing table : x,화장대,경대
dressmaker : n,양재사,양장점,여성복다운,장식이많은
dressmaking : n,양재업
dress parade : x,사연식,열병식
dress shirt : x,예복용 와이셔츠
dress shoe : x,예복용 구두
dress suit : x,남자용 야회복
dress sword : x,예복에 차는 칼
dress tie : x,예복용 넥타이
dress uniform : x,예복
dressup : a,정장을 요하는,정식의
dressy : a,옷차림에 마음을 쓰는,맵시있는,멋진
drest : v,dress의 과거분사
drew : v,draw의 과거
Drew : n,남자 이름
drey : n,다람쥐 집
drft angle : x,편류각,배가 침로를 벗어나는 편차
drib : n,(방)한 방울,소량
dribble : vi,뚝뚝떨어지다,군침을 흘리다,드리블하다,물방울,가랑비,드리블
dribbler : n,DRIBBLE하는 사람
driblet : n,조금,소량
dribs and drabs : x,적은 양
dried : a,건조한(a dried fish 건어물)
dried beef : x,말린 쇠고기,육포,(미)진부한 글귀
dried milk : x,DRY MILK
driedout : a,마약을 완전히 끊은
driedup : a,바싹 마른,(늙어서)쭈글쭈글한
drier : n,말리는사람,건조기
drift : n,흐름,조류,표류,표류물,떼밀어,동향,추세에 맡기기
driftage : n,표류 작용,밀려 내려가는 거리,(선박의)표정,(바람에 의한 탄알의)편차,표류(표적)물
drift anchor : x,=SEA ANCHOR
drift bottle : x,표류(해류)병(해류 연구자나 표류자의 통신문을 넣은)
drift current : x,풍조(풍력 때문에 생기는 조류)
drifter : n,표류자(물),유망 어선,(유망이 달린)소해선,유랑 노동자
drift ice : x,성엣장,유빙
drift indicator : x,(공)편류계
drifting mine : x,(해군)부류 기뢰
drift net : x,유망
drift sand : x,(토목)유사,표사
driftway : n,(광산)갱도,(해)편류,(영,미)가축을 모는 길
driftweed : n,표류 해초(다시마 등)
driftwood : n,유목,부목
drifty : a,표류성의,떠내려 가는,표적물의,(눈 등이)바람에 날려 쌓인,눈더미의
drill : n,훈련,교련,송곳,천공기,훈련하다,구멍을 뚫다,능직무명
drill bit : x,(기)드릴에 끼우는 날
drill book : x,(군)교련 교범,연습장
drill corps : x,=DRILL TEAM
driller : n,구멍파는 사람,천공기,훈련교관,고랑파는 사람
drill ground : x,연병장
drilling : n,교련,훈련,연습,송곳질,구멍 뚫기,(씨의)조파법,=DRILL
drilling machine : x,드릴링 머신,보르반,천공기,시추기
drilling rig : x,(해양공학)드릴링 리그(해양 석유의 굴착(시추)장치)
drillion : n,a,(미)막대한 수(의)
drillmaster : n,훈련교관
drill press : x,(기)드릴 프레스,천공반
drillship : n,해저 굴착선,시추선
drill team : x,(군)시범 부대
drinamyl : n,(영)(약)드리나밀(합성 마취약,각성제)
drink : vt,마시다,~을 위해서 축배를들다,흡수하다,술에 소비하다,마시다,취하다
drinkable : a,n,마실 수 있는,마시기에 적합한,음료,마실 것
drinker : n,마시는 사람,(특히 상습적인)술꾼,(가축용)급수기
Drinker respirator : x,(의)드링커 호흡 보호기,철폐
drinking : a,마시기의,음주의,음용의
drinking bout : x,주연,통음
drinking cup : x,술잔
drinking fountain : x,음료 분수
drinking horn : x,뿔잔
drinking song : x,주연(연회석)의 노래
drinkingup time : x,마지막잔 시간(폐점 후의 짧은 영업 연장 시간)
drinking water : x,음료수
drink money : x,(고)술값,술밑천
drink offering : x,제주
drip : n,물방울,똑똑 떨어지다,적하
drip coffee : x,드립 커피(드립식으로 뺀 커피)
dripdrip : n,낙숫물,물방울
dripdry : vi,n,a,짜지않고 그냥마르다,속건성의 천으로 만든
dripfeed : n,a,vt,점적(의),점적 주입(주사)의,(환자에게)점적 주입하다
drip grind : x,드립 커피용으로 간 고운 커피
drip irrigation : x,=TRICKLE IRRIGATION
drip joint : x,(건)(지붕을)단을 지어 이기
drip mat : x,컵 받침,코스터
Dripolator : n,드립식커피 끊이개
drip painting : x,(화)드립 페인팅(그림물감을 흘리거나 튀겨서 그리는 액션 페인팅)
drip pan : x,(떨어지는)액체받이,기름받이,=DRIPPING PAN
dripping : n,a,뚝뚝 떨어짐,적하 듣는 것,흠뻑 젖은
dripping pan : x,고기 굽는 냄비,(불고기의)기름받이
drippy : a,물이 똑똑 떨어지는(수도꼭지),눈물을 강요하는,감상적인,데데한
dripstone : n,(건)(문,창위 등의)빗물받이 돌,(화)(종유석,석순 모양의)점적석(탄산칼슘)
dript : v,DRIP의 과거,과거분사
drivability : n,(차의)운전 안이도,조정(안정)성
drive : vt,쫓다,몰다,몰이하다,혹사하다,운전하다,차로 나르다,영위하다,돌진하다,부딪치다,드라이브,추진력
drivein : n,a,드라이브인(탄채로 들어갈 수 있는 상점,식당,영화관 등),드라이브인의
drivel : n,vi,vt,군침,허튼소리,군침을흘리다,철없는소리를하다,시간을허비하다
driveler : n,침을 흘리는 사람,코흘리개,철없는 소리를 하는 사람,천치
driven : v,drive의 과거분사
driven well : x,깊이 판 우물
driveon : a,(배가)차를 타고 하는 선적 방식의,(배가)차에 탄 채 승선할 수 있는
driver : n,조종자,마부,운전수,기관사
driver's license : x,(미) 운전 면허(증),(영)driving licence
driver's seat : x,운전석,운영자의 지위
driver ant : x,군대개미(아프리카산)
driverless : a,운전사가 (필요)없는
drive shaft : x,=DRIVING SHAFT
drivethrough : a,차에 탄 채 지나가며 보는 식의(동물원등),차에 탄채 주문하고 식사를 받는 식의(식당)
driveup : a,(미)(은행 창구 등이)드라이브인 식의 고객용의
driveup window : x,드라이브인 식의 창구(상점,은행등의)
driveway : n,드라이브길,차도
driveway : n,(미)드라이브길,(도로에서 현관까지의),차도(영)drive,자동차길,(캐나다)경치 좋은 간선 도로,가축을 몰고 가는 길
drive wheel : x,=DRIVING WHEEL
driving : a,n,추진하는,동력전달의,혹사하는,정력적인,운전
driving axle : x,(기)(기관차 등의)구동축
driving band : x,동력 전달 벨트
driving box : x,마부석,(기)동륜축함
driving clock : x,조속기(시계 등의),운동 시계(적도의 장치)
driving gear : x,(기관의)구동 장치
driving iron : x,(골프)아이언 클럽 No.1
driving licence : x,(영)=DRIVER'S LICENSE
driving mirror : x,(영)백 미러
driving range : x,골프 연습장
driving school : x,자동차 운전 학원
driving shaft : x,(기)구동축,운전축
driving test : x,운전 면허 시험
driving wheel : x,(기)동륜,(기관차,자동차등의)구동륜
drizzle : n,이슬비
drizzly : a,이슬비(가랑비)내리는,가랑비가 내릴 듯한
drll sergeant : x,훈련 담당 하사관
drmb cluck : x,(속)바보,멍청이
drnnite : n,(군)고성능 D 폭약
drogher : n,드로거(서인도제도의 느린 돛배)
drogola : n,(미)(경찰이나 당국에 바치는)마약 판매 묵인 청탁 뇌물
drogue : (고래잡이)작살 줄에 달린 부표,(비행장의)풍향 기드림,(공)(비행기가 끌고 가는)사격 연습용 표적,(공)드로그(비행기의 공중 급유용의 원통형 기구),=SEA ANCHOR
drogue parachute : x,(착륙 때의)감속용 소형 보조 파라슈트,(전투기 등의 사출 좌석에서 사출후 공중에서 펴지는)안정 파라슈트
droit : n,법적인 권리
droit du seigneur : x,(F)(신하의 신부에 대한)영주의 초야권,(비유)무도한 권리
droll : a,익살스러운
drollery : n,익살맞은 짓
drome : n,비행장
dromedary : n,단봉낙타
dromond : n,(중세의 주로 지중해에서 사용되던)대형 쾌속범선
drone : n,vi,수펄,게으름뱅이,무인기,윙윙거리다,핀둥대다,단조로운 소리로 말하다
drone beetle : x,풍이
drongo : n,a,(조)오추,바람가마귀,(오스)얼간이,얼간이의,멍청한
droningly : ad,낮은 소리로 단조롭게,나른하게,게으름 피우며
droob : n,(오스)감상적인 사람
droog : n,갱의 일원
droogie : n,갱 소년,비행 소년
drool : n,=DRLVEL
drool : n,vi,(주로 미)=DRIVEL
drooly : a,침을 흘리는,(미)굉장히 매력적인,(미)옷,차 등이)군침이 날 정도의,(미)인기 있는 남자(10대들의 용어)
droop : vi,처지다,수그러지다,눈을 내리깔다,풀이죽다,쇠하다,수그러짐,고개숙임,늘어짐
drooping : a,늘어진,눈을 내리깐,풀이 죽은
droopingly : ad,맥이 빠져,힘없이
droop nose : x,(공)(초음속기 등의 착륙시 시야를 넓히기 위해)숙일 수 있는 기수
droop snoot : x,=DROOP NOSE (의 비행기)
droopy : a,축 늘어진,수그린,지친,의기 소침한
drop : n,vi,vt,물방울,한방울,소량,낙하,눈깔사탕,드롭스,듣게하다,낮아지다,그치다,그만두다
dropby : n,(미)(정치가,의원등을 초대하는)접대회
drop cake : x,반죽을 스푼으로 철판 위에 떨어뜨려 구운 쿠키
drop cloth : x,페인트받이 천(시트,종이(등))
drop curtain : x,말아서 오르내리는 말
drop folio : x,(인)아래쪽 페이지 숫자
drop forge : x,(기,건)낙하 단조 장치,낙하
dropforge : vt,드롭해머로 벼리다
drop forging : x,DROP HAMMER 단조
drop front : x,젖히면 그대로 책상이 되는 서가 뚜껑
drop goal : x,(럭비)골을 겨누어 찬 DROPKIC의 성공,드롭골
drop hammer : x,드롭해머,말뚝박는 해머
drophead : n,(영)(차의)접는 포장
dropin : n,훌쩍들르는사람
drop kick : x,드롭킥
dropkick : n,(럭비)공을 땅에 떨어뜨려 튀어 오를 때 차는 방법
drop leaf : x,책상에 경첩으로 달아 접게 되어 있는 보조판
droplet : n,작은물방울
droplet infection : x,(의)비말 감염
drop letter : x,같은 우체국 관할내에 보내는 우편물
droplight : n,(이동식)현스등
dropoff : n,벼랑,아주 가파른 내리받이,감소,쇠미,하락
dropoff point : x,배달품 전달 장소,(유괴 사건 등에서)몸값을 두고 가는 장소
dropout : n,드롭아웃,낙제생,중퇴생,탈락자
dropped seat : x,앉는 자리가 우묵한 의자
dropped shoulder : x,진동을 보통 위치보다 팔 쪽으로 처지게 붙이기
dropper : n,점적기
dropperin : n,불쑥 들르는 사람
dropping : n,적하,낙하,투하,방울져 떨어지는것,촛농,낙하물,탈모,(새,짐승의)똥
dropping ground : x,=DROP ZONE
drop press : x,=DROP HAMMER
drop scene : x,무대의 현수막,대단원,끝장
dropshot : n,(정구)드롭쇼트,녹은 금속의 방울을 물에 떨어뜨려서 알맹이로 만든 것
drop shutter : x,(사)초기의 카메라의 셔터
dropsical : a,(병리)수종의
dropsied : a,=DROPSICAL
dropsonde : n,(기상)투하(낙하)존데
dropsulfurp : n,(화)입자골 유황(녹여서 물에 떨어뜨려 작은 낟알처럼 된)
dropsy : n,수종
dropt : v,drop의 과거(분사)
drop table : x,(벽에 고정시킨)접탁자(쓰지 않을 때는 접어서 벽에 붙여 둠)
drop test : x,낙하 시험(테스트)
droptest : vt,낙하 테스트를 하다
drop tin : x,입자꼴 주석(녹여서 물에 떨어뜨려 알맹이가 된)
dropwort : n,(식)참터리풀,독미나리 무리
drop zone : x,(군)(낙하산)투하(강하)지역
droshky : n,무개4륜마차
drosophila : n,초파리
dross : n,부스러기,쇠똥,찌끼
drotone : n,(인)2색 그림,2색 망판,더블톤,더블톤 인쇄물
drought : n,가뭄,한발
droughty : a,가문,한발의,모자라는,(고,방)목마른
drouth : n,(영고,미)=DROUGHT
drouthy : a,(영고,미)=DROUGHTY
drove : v,drive의 과거
drove : n,몰려가는 가축 때(움직이는 인파)
drover : n,가축 떼를 시장까지 몰고 가는 사람,가축 상인
drove road : x,가축 모는 길
drown : vt,vi,물에	빠뜨리다,흠뻑 젖게하다,들리지 않게하다,물에 빠지다,달래다,잊어버리다
drowned : a,물에 빠져 죽은,...에 빠진,몰두하고 있는
drowning : a,물에 빠져 있는,(미)혼란한,이해할 수 없는
drownproofing : n,(수영)익사 방지 부유법
drowse : n,vi,vt,꾸벅꾸벅졺,졸다,졸게하다
drowsihead : n,졸림
drowsily : ad,졸린듯이,꾸벅꾸벅,잠결에,나른하게
drowsiness : n,졸음,나른함
drowsy : a,졸린,졸음오게하는
drowyhead : n,졸리는(꽤나른한)듯한 사람,잠꾸러기
drub : vt,매질하다,패배시키다,몽둥이로치다
drubbing : n,몽둥이로 때림,구타
drudge : vi,꾸준히하다,뼈빠지게하다
drudgery : n,단조롭고 고된 일(교정 따위)
drudgingly : ad,노예처럼,고되게
drug : n,약,약제,약품,마약,~에 약을넣다,마취시키다,물리게하다
drug addict : x,마약 중독자
drug buster : x,(미)마약 단속관
drug design : x,(약)약제 설계(유효성을 높이기 위한 종합적 개발 검토
drugget : n,(인도산의)거친 융단,옛날의 나사의 일종
druggist : n,약종
druggy : a,마약의,상용의
drug interaction : x,(약)약물 상호 작용
drug pump : x,(의)약 펌프(혈관 주사용)
drugpusher : n,마약 밀매자
drugster : n,마약 중독자
drugstore : n,약방(담배,화장품 등도 팔고 다방도 겸함)
drugstore cowboy : x,(미,캐나다)옷차림만의 카우보이,드러그스토어에서나 어정거리는 건달
Druid : n,켈트족의 두루이드료 단원
druidic : a,DRUID의
druidism : n,드루이드교
drum : 북,고동,드럼통,고실,고막,북으로 연주하다,불러모으다,억지로 주입시키다,북을치다,북을 치고 돌아다니다,북을 치고 돌아디니며 모집하다
drumbeat : n,북소리
drumbeater : n,광고(선전)담당자,(주의,정책 등의)열성적 창도자,(라디오,TV)광고 아나운서
drumbeating : n,요란한 창도,선전
drum corps : x,고수대,군악대
drumfire : n,맹렬한 연속포화,연발
drumfish : n,(어)민어과의 물고기(미국산,북소리 같은 소리를 냄)
drumhead : n,북가죽
drumhead courtmartial : x,전선의 임시 군법 회의
drumlin : n,(지질)빙퇴구(표적물로 된 타원형의 구릉)
drum major : x,악대의 고수장,악장
drum majorette : x,행진의 선두에서 지휘봉을 휘두르는 소녀,바몽걸
drummer : x,고수
drumroll : n,(악)드럼 트레몰로
drumstick : n,북채,요리한 닭다리
drum table : x,외다리의 회전식 둥근 탁자
drunk : a,술취한,주정뱅이
drunkard : n,술고래
drunken : a,술취한,술고래의
drunkenness : n,술취함,명정의
drunkometer : n,취도측정기
drunk tank : x,(미)주정뱅이 유치장
drupaceous : a,(식)핵과성의,다육과의,핵과를 맺는
drupe : n,핵과
drupelet : n,(식)소핵과
Drury Lane : x,런던의 유명한 극장(17세기 창립)
Druse : n,드루즈파(회교의 과격파)
druthers : n,(미방,구)선택,좋아함
druzhinnik : n,(소련의)민간 경비대원
drvetyn : n,듀베틴(보풀이 선 비로드 비슷한 천)
DRX : x,drachma
dry : a,vt,vi,마른,건조한,바싹마른,가무는,쌀쌀한,냉담한,무미건조한,말리다,마르다,널다
dryad : n,숲의요정
dry area : x,(건)드라이 에어리어(지하실의 환기,채광을 위하여 만들어 놓은 도랑)
dryasdust : a,무미건조한
dry avalanche : x,(지진,사태 등으로 인한)토석류,암설류
dry battery : x,dry cell을 모은 건전지
dry bob : x,(영)크리켓(럭비)부원
dryboned : a,뼈와 가죽만 남은,바짝 마른
drybones : n,바짝 마른 사람,말라깽이
dry bread : x,버터 안 바른 빵
drybulb : a,건구식의
drybulb thermometer : x,건구식 온도계
dry cell : x,건전지
dryclean : vt,드라이클리닝하다
dry cleaner : x,드라이클리닝 업자
dry cleaning : x,드리이클리닝
drycleanse : vt,=DRY CLEAN
drycure : vt,절여서 말리다
Dryden : n,John(1631~1700)영국의 시인 극작가
dry distillation : x,(화)건류
dry dock : x,건선거
drydock : vt,건선거에들어가다
dry dyeing : x,(섬유의)건식 염색
dryer : n,=DRIER
dryeyed : a,울지 않는,냉정한
dryeyes : x,건조성 각결막염,건각결막염
dry farm : x,(건조지의)건지농장
dryfarm : vt,(미,캐나다)(토지,작물을)건지 농법으로 경작(재배)하다
dryfarmer : n,(미,캐나다)건지 농법을 쓰는 사람(농가)
dry farming : x,건지 농법
dryfly fishing : x,물 위에 띄우고 하는 파리낚시질
dry fog : x,(기상)건무
dryfoot : ad,발을 적시지 않고
dry goods : x,  직물류,곡류,잡화
dryhouse : n,갱의실,건조실
dry humour : x,천영스레 말하는 익살
dry ice : x,드라이아이스
drying : n,건조(옷,가구등의)한여름에 볕 쬐기
dryish : a,덜 마른
dry kiln : x,(목재의)건조로)
dry land : x,(강수량이 적은)건조 지역,(바다등에 대하여)육지
dry law : x,금주법
dry lodging : x,잠만 자는 하숙
dryly : ad,건조하여,무미건조하게,냉담하게
dry martini : x,=MARTINI
dry masonry : x,(돌담을 시멘트,모르타르 없이)돌로만 쌓기
dry measure : x,건량(곡물,야채,과일 등의 계량 단위)
dry milk : x,분유
dry mop : x,(방바닥 등을 닦는)자루 달린 걸레
dryness : n,건조(한 상태),무미건조,냉담,정열이 없음,금주
dry nurse : vt,아이를 돌보다,보모,아이보는여자
drynurse : vt,아이를 보다
dry plate : x,건판
drypoint : n,동판 조각침,동판 조각법
dry rot : x,목재의 건식
dry run : x,예행 연습,공포사격 연습,시운전,견본
drysalt : vt,=DRYCURE
drysalter : n,(영)건물 장수(절임,통조림,약품,염료,기름 등을 파는)
drysaltery : n,(영)건물상,건물류
dryshod : a,신을 적시지 않고
dryski : a,옥내(인공설면)에서 스키연습을 하는
dryskid : x,(자동차등의) 건조한 도로면에서의 슬립,타이어의 미끄러지기
dryskid : vi,(자동차 등이)건조한 도로상에서 슬립하다
drysnap : vt,(권총으로)공포 사격하다,탄창이 비었을 때 방아쇠를 당기다
dry stove : x,(선인장 등의)건조 식물용 온실
dryup : n,(극)대사를 잊음,각본에 없는 말이나 우스운 짓으로 상대역을 웃기어 연극의 진행을 중단시킴
dry wall : x,(건)(시멘트,모르타르 없이 쌓은 자연석의)돌담
dry wash : x,빨아 말리기만하고 다림질을 않은 세탁물
dry weight : x,(자우)건조 중량(연료,승무원,소모품을 제외한 우주선,로켓의 중량)
DS : x,depositary shares(증권)예탁 주식
dsecration : n,
DSL : x,deep scattering layer(지질)심해 산란층
DSN : x,deep space network
DSS : x,(전산)deciksion support system
Du, : x,Duke,Dutch
duad : n,한 쌍,2개1조,(화)2가 원소
dual : a,둘의,이중의,이원적인,이중경제,이중 국적
dual carriageway : x,(영)=DIVIEDE HIGHWAY
dual control : x,이중 관할,양국 공동 통치,(공)이중 조종 장치
dualin : n,듀얼린(초석,니트로글리세린,톱밥을 섞어 만든 폭약)
dualism : n,이원론
dualistic : a,이원론적인,이원론상의
duality : n,이원성,이중성
dualize : vt,이중으로 하다,겹치다,이원적이라고 간주하다
Dual Monarchy : x,(사)이중 제국
dual number : x,(문법)양수(둘 또는 한쌍을 표시함)
dual personality : x,(심)이중 인격
dual pricing : x,(포장 상품에 제품 가격과 단위 중량당 가격을 표시하는)2중 가격 표시
dual pump : x,복식 펌프
dualpurpose : a,두가지 목적의
dual slalom : x,=PARALLEL SLALOM
dub : vt,나이트 작위 수여식에서 칼로 가볍게 어깨를 두드리다,...라고 부르다
dub : n,서투른 사람
dub : vi,n,새로이 녹음하다,그 녹음
dub : vt,vi,n,찌르다,북을 둥둥치다,찌르기,북치는 소리
dub, : x,dubious
Dub, : x,Dublin
dubadub : n,=RUBADUB
Dubai : n,두바이(아랍 에미레이트 연방의 주요 구성국의 하나
dubbin : n,보혁유(가죽의 방수,경화 방지용)
dubbing : n,KNIGHT작위 수여,=DUBBIN,=제물낚시용 털
dubbing : n,(영)더빙,재녹음
Dubcek : n,두브체크(체코슬로바키아의 정치가)
dubiety : n,(문어)의혹,의아스러움,의심스러운 것(일)
dubiosity : n,=DUBIETY
dubious : a,의심스러운,수상한,미정의,불명한,불안한
dubitable : a,의심스러운
dubitation : n,의심,주저
dubitative : a,의심스러운 듯한,의심을 표하는,주저하는
dublin : n,아일랜드의 수도
ducal : a,공작의
ducat : n,다컷 금화
duce : n,수령,지도자(il Duce 총통)
duchess : n,공작부인,여공작
duchesse petatoes : x,달걀과 뒤섞은 으깬 감자(굽거나 튀김)
duchy : n,공작령
duck : n,vi,vt,오리,오리의 고기,귀여운 사람,돈을 물쓰듯하다,물에 쑥 잠기게하다,홱 머리를 숙이다,피하다
duck : n,(제 2차 대전에 쓰던)수륙양용 트럭
duck's ass : x,=DUCK ASS
duck's disease : x,(익살)짧은 다리
duck's egg : x,영점
duck ass : x,=DICKTAIL
duckbill : n,오리너구리
duckbilled : a,오리너구리와 같은 주둥이를 가진
duckboards : n,(진창길 등에 건너지른)널빤지 길
duck course : x,(미학생속)학점을 쉽게 딸 수 있는 대학의 수업 과목
ducker : n,잠수하는 사람,잠수하는 새,(특히)농병아리,오리 치는 사람,오리 사냥꾼
duck hawk : x,(조)(미)매,(영)개구리매
duck hook : n,vi,vt,(골프)덕훅(코스에서 많이 벗어나는 훅),덕훅으로 치다
ducking : n,오리사냥(물에처넣기,더킹,몸 머리를 홱 숙일는 짓)
ducking pond : x,오리 사냥 못,물고문 못
ducking stool : x,물고문 의자(옛날에 말썽 많은 여자 등을 징계하는데 사용)
ducklegged : a,(짧은 다리로)아장아장 걷는,다리가 짧은
duckling : n,집오리 새끼,새끼 오리
duckling : n,오리 새끼(때로는 경멸적)
duckmole : n,=DUCKBILL
duckpins : n,테니스 비슷한 구기
duck shot : x,오리 사냥의 총알
duck soup : x,쉬운일,편한일
ducktail : n,(10대 소년들이 가운데는 짧고 양 앞을 길게 하는)머리모양
duckweed : n,좀 개구리밥
ducky : n,a,(영)=DARLING,귀여운,유쾌한,즐거운
duct : n,관,도관
ductile : a,연성이 있는,마음대로 되는,가르치기 쉬운,고분고분한
ductility : n,연성,전성,(아스팔트의)신도,유연성,양순한 성품
ductless : a,관이 없는(ductless gland 내분비선)
ductless gland : x,내분비선(갑상선,뇌하수체,생식선 등)
dud : n,옷,누더기옷,소지품,버린사람
dude : n,멋쟁이,도회지 사람
dudeen : n,(아일)짧은 사기 담배 파이프
dude ranch : n,관광 목장
dudgeon : n,성냄,분개
dudish : a,(미)멋쟁이의,멋부리는
due : a,ad,n,응당치러야할,응당,에 돌여야할,할 예정인,당연할,정식으로,때가 오면,마땅히,세금
due bill : x,차용 증서
due date : x,어음의 만기일
duel : n,vi,결투,결투하다( duel of with 재치 겨루기)
duende : n,불가사의 한 매력,마력
duenna : n,=chaperon
due process : x,(법)정당한 법의 절차(미국 헌법 제 5조,제 14조)
duet : n,2중창,2중주곡
duettist : n,이중주(이중창)하는 사람
duetto : n,=DUET
duff : n,푸딩의일종,엉덩이,속이다,새 것처럼 꾸미다
duffel : n,캠프용품,나사의 일종
duffel bag : x,즈크 자루
duffer : n,바보,병신,가짜
duffle coat : x,더플코트(후드가 달린 무릎까지 내려오는 코트)
dug : n,젖꼭지
dugg gen : x,믿을 수 없는 정보,데마
dugong : n,듀공(돌고래 비슷함)
dugout : n,마상이,통나무배,땅굴집,대피호,선수 대기소
duiker : n,(동)영양의 일종(남아프리카산)
duka : n,(케냐,아프리카 동부의)작은 매점,가게
dukaqallah : n,DUKA의 주인
duke : n,공작,군주
Duke : n,남자 이름
dukedom : n,공령,공국
dukeout : n,(미)서로치고받기
dukesup : a,(미)걸핏하면 싸우는,호전적인
Dukhobor : n,=DOUKHOBOR
DUKW : n,(미군)=DUCK
Dulce : n,여자 이름
dulcet : a,아름다운
Dulcie : n,여자 이름
dulcify : vt,(기분 등을)상쾌(평온)하게 하다,누그러뜨리다,(맛 등을)감미롭게 하다
dulcimer : n,거문고 비슷한 옛 현악기
Dulcin : n,둘신,감미료
dulcinea : n,(이상적인)애인,여인
dulcitol : n,(화)둘시톨(6가의 알코올,감미료)
dull : a,vt,둔한,무딘,둔감한,또렷하지 않은,지루한,무디게하다,흐리게하다,누그러뜨리다
dullard : n,둔한사람,멍청이
dullbrained : a,머리가 둔한
dulleyed : a,눈에 총기가 없는,눈이 흐릿한
dullwitted : a,=DULLBRAINED
dully : ad,둔하게,멍청하게,활발치 못하게,지루하게,느럭느럭
dulse : n,홍조류의 해초(아이슬란드 해안산,긱용)
duly : ad,정식으로,바로,당연히,적당히,제시간에
duma : n,제정러시아의 국회
Dumas : x,Alexander(1802~1870,1824~1895)프랑스의 소설가 부자
dumb : a,벙어리의,말못하는,말이없는,무언의,말문이 막힌,우둔한,깜작 놀라게 하다,아연케 하다
dumb barge : x,=DUMB CRAFT
dumbbell : n,아령,얼간이
dumb blonde : x,머리가 나쁜 금발 미인
dumb craft : x,(영)돛 없는 배,무동력선
dumber : n,(미)바보
dumbfound : vt,아연케하다,깜짝놀라게하다
dumbhead : n,(미,스코)=BLOCKHEAD
dumb iron : x,(자동차의)스프링 받침
dumbly : ad,말없이,묵묵히
dumbness : n,벙어리임,무언,침묵
dumbo : n,구명기,비행기,귀가 큰사람
Dumbo : n,(미해군속)구명(수색)기(특히 비행정)
dumb ox : x,(덩치가 큰)바보
dumb piano : x,(손가락 연습용)무음 피아노
dumb show : x,무연극(pantomime)
dumbstruck : a,놀라서 말도 못하는
dumbwaiter : n,식품전용 엘리베이터,식탁 위의 회전 식품대
dumb well : x,하수 처리용 우물
dumdum : n,덤덤탄
dumet : n,두멧선(진공관,백열 전구의 봉입부재용 동피막선)
dumfound : vt,=DUMBFOUND
Dumfries : n,덤프리스(스코틀랜드의 옛 주,그 주도)
dummy : n,a,모델인형,얼뜨기,견본,모형,모조품,바꿔친것,꼭둑각시,가제본,제사람 놀이를 셸이 할 때의 빈자리,가상 더미,가짜의
dummy head : x,더미 헤드(귀 부분에 마이크를 설치한 사람 머리 모양의 녹음 장치)
dummy run : x,(영)공격(상륙)연습,예행 연습,시행,실험
dump : vt,n,털썩부리다,덤핑하다,덤프하다,쓰레기 더미,쓰레기 버리는 곳,덤프(기억 장치의 내용을 출력 장치에 전사하기)
dump car : x,덤프차
dumpcart : n,쓰레기를 버리는 손수레
dumper : n,쓰레기 치우는 사람,청소부,=DUMPTRUCK,투매자,(파도타기나 수영을 하고 있는 사람을)밀어 던지는 큰 파도
dumpiness : n,짧고 굵음,뭉뚝함
dumping : n,쓰레기 따위를 내버림,염가 수출,덤핑
dumpish : a,우울함,침울한,슬픈,dumpishly()ad,dumpishness()n
dumpling : n,고기단자,땅딸보
dumpling : n,덤플링,고기 만두,과일 푸딩(디저트),땅딸보
dumps : n,침울(low spirits)(in the dumps 울적하여,기운 없이)
dump truck : x,덤프트럭
dumpy : a,땅딸막한,울적한,뚱한
dumpy level : x,망원경이 달린 수준기
dun : vt,성화같이 독촉하다,독촉장,암갈색으로 하다
Duncan : n,남자 이름
dunce : n,열등생,저능아,바보
dunce cap : x,원추형의 종이 모자(열등생이나 게으른 학생에게 벌로 씌우는)
dunderhead : n,멍청이
dunderpate : n,=DUNDERHEAD
dundreary whiskers : x,(고)(턱수염이 없는)긴 구레나룻
dune : n,모래언덕
dune buggy : x,모래 언덕,모래밭 주행용 소형차
dunemobile : n,=DUNE BUGGY
dun fly : x,(낚시)거무스름한 파리낚시의 털바늘
dung : n,똥거름
dungaree : n,인도산의 굵게짠 무명,작업복,노동복
dung beetle : x,쇠똥구리
dung cart : x,분뇨(운반)차
dungeon : n,토굴감옥
dung fly : x,똥파리
dung fork : x,거름주는 쇠스랑
dunghill : n,똥거름더미
dungy : a,똥 같은,지저분한,더러운
duniewassal : n,(스코)중류 신사,명문 집안의 차남 이하의 아들
dunk : vt,적시다(dund bread into coffee)
Dunkirk : n,됫케르크,프랑스의 항구
Dunkirk spirit : x,뒹케르크 정신(위기에 처했을 때의 불굴의 정신)
dunk shot : v,높이 점프해서 메어꽂듯이 하는 슛
dunlin : n,민물도요
Dunlop : n,던롭 John Boyd(스코틀랜드의 발명가,공기 주입 타이어를 발명),던롭 고무 타이어
Dunlop : n,던롭치즈(스코틀랜드의 Dunlop지방 원산)
dunnage : n,파손을 막기 위해 뱃짐사이에 끼우는 멍석(따위),소지품,의류
dunner : n,=DUN
dunno : x,do not know
dunnock : n,(영방)=HEDGE SPARROW
dunny : n,(오스속)(옥외)변소
dunny cart : x,(오스 속)분뇨 (운반)차
dunt : n,(공)수직 기류와의 급격한 충돌에 의한 충격
duo : n,(악)이중주(곡)(2개의 다른 악기를 위한 악곡,2개의 동일 악기를 위한 작품은 duetto),(연예인 등의)짝,콤비,2인조
duo- : x,(연결형)(둘)의 뜻
duodecimal : n,12의,12진법의,한벌의
duodecimo : n,12절판
duodenal : a,십이지장의
duodenary : a,(한 단위가)12의,12진법의
duodenitis : n,(병리)십이지장염
duodenum : n,십이지장
duograph : n,(인)=DUOTONE
duologue : n,(두 사람의) 대화,대화극
duomo : n,대교회당,대성당
duopoly : n,(경)복점(두 회사에 의한 판매 시장의 독점),(정)양대 강국에 의한 패권
duorail : n,이궤 철도
dup : x,duplicate
dupable : a,속기 쉬운
dupe : vt,n,속이다,속기 쉬운 사람
dupery : n,사기
duple : a,2배의,이중의(duple time 2박자)
duples apartment : x,복식 아파트(아래 위층의 방을 한 단위로 함)
duples system : x,(전산)복식 시스템(2대의 컴퓨터를 설치하되 하나는 예비용)
duplet : a,이중전자,이중입자
duple time : x,(악)2박자,(미)짝수 박자
duplex : a,2중의,2배의,복식으로 된
duplex house : x,연립 주택
duplicate : 이중의,복제의,한쌍의,부의,복사의,등본,부본,사본,물표 ,전당표,이중으로 하다,복사하다,정부 두통으로 하다
duplicating machine : x,복사기
duplication : n,이중,중복,복제,복사
duplicator : n,복사기,복제자
duplicity : n,이심,표리부동,불성실
durability : n,지속력,내구성,영속성
durable : a,오래견디는,튼튼한,지속하는(durable goods 내구재)
durable press : x,형태 고정 가공(의복의 주름 등을 영구 가공하는 방법)
dural : n,=DURALUMIN
duralumin : n,두랄루민(알루미늄 합금)
dura mater : x,(L)경뇌막
duramen : n,심재,적목질,나무의심
durance : n,감금(in durance vile 부당하게 감금되어)
duration : n,지속
durative : a,(문법)계속상의,계속상(의 동사)
durbar : n,알현실
Durer : n,albrecht(1471~1528)독일의 화가,조각가
duress : n,속박,감금,강박,강제
Durex : n,condom의 일종
durgah : n,=DRAGAH
Durgam Book : x,=LINDISPARNE GOSDURIAN
Durham : n,영국북동부의 주
durian : n,두리언의 열매(동남아산,독특한 향미가 있음)
during : prep,~의동안,~사이
durn : v,a,ad,n,(미)=DARN
DurocJersey : n,미국산 듀록 저지종의 돼지(성장이 빠르고 강건함)
durra : n,수수,고량
durst : v,dare의 과거
durum : n,밀의 일종(마카로니의 원료)
dusk : n,a,땅거미,황혼,그늘,어스레한
dusky : a,어스레한,거무스름한,음울한
Dusseldorf : n,뒤셀도르프(서독 라인 강가의 항구)
dust : n,먼지,티끌,가루,분말,쓰레기,유해,인체,흙,무덤,현금,굴욕을 받고,죽어서 가루를 뿌리다,먼지를 떨다
dust bag : x,(전기 청소기의)먼지 주머니
dustbath : n,사욕
dust bin : n,쓰레기통
dust bowl : x,모랫바람이 심한 건조 지대
dust box : x,쓰레기통
dustbrand : n,(식)(보리의)깜부기병,흑수병
dustcap : x,(망원경,카메라의)렌즈 커버
dust cart : n,쓰레기차
dust children : x,쓰레기 애들(동남 아시아의 현지 여성과 미군 사이의 혼혈아)
dust chute : x,더스트 슈트(건물의 위층에서 쓰레기를 떨어뜨려 밑에서 모으는 장치)
dustcloth : n,걸레,(가구 등의)먼지 막이 커버
dust coat : x,먼지 방지용 외투
dustcolor : n,뿌연 갈색
dust counter : x,계진기
dust cover : x,=DUST JACKET
DUST DEVIL : x,흙먼지의 작은 회오리바람
DUST DISEASE : x,=PNEUNOCONIOSIS
duster : n,먼지 터는 사람,총채,걸레,후춧가루,소금을 치는 기구
dustguard : n,방진 장치,(자전거 등의)흙받기
dust head : x,(미)합성 헤로인 상용자
dusthole : n,(영)쓰레기 버리는 곳(구멍)
dustily : ad,먼지투성이가 되어
dustiness : n,먼지투성이,무미건조
dusting : n,청소
dust jacket : x,책 커버(book jacket)
dustman : n,쓰레기청소부
dust mop : x,마루 훔치는 자루 걸레
dustoff : n,(미군속)사상자 후송 헬리콥터
dustoor : n,=DASTUR
dustpan : n,쓰레받기
dustproof : a,먼지가 안 묻는,방진의
dust sheet : x,=DUST COVER 1
dust shot : x,최소 산탄
dust storm : x,큰 모랫바람,황진
dust tail : x,(천)(혜성의)더스트의 꼬리
dusttrap : n,먼지 제거 장치,집진기
dustup : n,소동,싸움
dustvinman : n,(영)쓰레기 수거인,청소업자
dust wrapper : x,=DUST JACKET
dusty : a,먼지투성이의,가루의,먼지빛의,티끌투성이의
dusty miller : x,(식)앵초의 일종,제물낚시의 일종,(미)부나방의 일종
dutch : n,(속)체격이 당당한 여자(어머니,아내)
Dutch : a,n,네덜란드의,네덜란드 말,각자 부담으로 하다,네델란드 사람
Dutch act : x,(미)자살(행위)
Dutch auction : x,값을 조금씩 떨어뜨리며 하는 경매
Dutch bargain : x,한 잔 마시며 맺는 매매계약
Dutch barn : x,기둥과 지붕만 있고 벽이 없는 건초 헛간
Dutch butter : x,인조 버터
Dutch cap : x,더치캡(좌우의 테 부분에 삼각형의 날개 같은 것이 붙은 여성용 레이스 모자),(피임용)페서리의일종
Dutch cheese : x,네델란드 치즈(탈지유로 만드는 둥글고 연한 치즈)
Dutch clinker : x,네덜란드 벽돌,경질 벽돌
Dutch clover : x,(식)토끼풀
Dutch comfort : x,별로 고맙지 않은 위로
Dutch concert : x,(네덜란드식의)혼성 합창
dutch courage : x,용기,객기
Dutch doll : x,이음매가 있는 나무 인형
Dutch door : x,상하 2단으로 된 문,잡지의 접혀진 광고
Dutch East Indies : x,네델란드령 동인도 제도(지금의 인도네시아 공화국)
Dutch elm disease : x,(식)세균성의 느릅나무병
Dutch foil : x,=DUTCH METAL
Dutch liquid : x,염화 에틸렌
Dutch Lunch : x,비용 각자 부담의 점심
Dutchman : n,네덜란드 사람
Dutchmansbreeches : n,금낭화류의 물
Dutch metal : x,네덜란드 금박(구리11푼과 아연2푼을 섞어 만든 모조 금박)
Dutch oven : n,고기구이용 오븐
Dutch school : x,(미)네덜란드 화파
Dutch supper : x,각자 비용 부담의 저녁 회식
Dutch treat : x,회비를 각자가 부담하는 연회
Dutch uncle : x,가차없이 비판하는 사람,차근차근이 타이르다
Dutch white : x,(안과)네덜란드백(흰 물감,연백+증정석)
Dutch wife : x,죽부인
Dutchwoman : n,네덜란드 여자
duteous : a,충실한
dutiable : a,관세를 물어야 할,유세의
dutiful : a,충실한,본분을 지키는,효성스러운
duty : n,의무,본분,책임,직무,임무,일,경의,관세,조세,효율,종무,관세,...의 대용이 되다
dutyfree : a,면세의
dutypaid : a,납세필의
duumvir : n,(로마사)(연대 책임하의)양두정치가 중의 한 사람
duvay : n,(영)깃털 이불
duvet : n,(F)깃털 이불
Duvhemme dystrophy : x,(의)뒤센형 근위축증(근 디스트로피의 일종)
duxtcloak : n,(영)=DUSTCOAT
dvms : x,doctor of veterinary medicine
Dvorak : n,드보르작,체코슬로바키아의 작곡가
dwale : X,(식)=BELLADONNA
dwarf : n,a,vi,vt,난쟁이,작은,작게하다,작아지다,지지러지게 하다
dwarfish : a,난쟁이같은,유난히 작은,오그라져서 작은,(지능이)위축된
dwarfism : n,위성,(동식물의)왜소성,왜소 발육증,주유증,소인증
dwarf star : x,(천)왜성
dwell : vi,살다,거주하다,곰곰이 생각하다,길게 논하다,천천히 발음하다
dweller : n,거주자,주민,머뭇거리는 말(목책 같은 것을 뛰어넘을 때)
dwelling : n,주거,주소
dwelling house : n,주택
dwelling place : n,주소
dwelt : v,dwell 의 과거분사
dwe works : x,염색 공장
DWI : x,driving while intoxicated음주 운전
Dwight : n,남자 이름
dwindle : vi,점점작아지다,줄다,야위다,타락하다
dwindler : n,(영양 실조로)성장이 나쁜 사람(동물)
Dwon's syndrome : x,다운 증후군(Mongolism)
dwt : x,deadweight ton
dwt, : x,denarius weight,=penntweight)
DX : n,a,vi,(통신)장거리(의),(해외 방송 등의)원거리수신(의),(속)상업 방송을 듣다
DXer : n,해외 방송 수신자(애호가)
DY : x,(화)dysprosium
dyad : n,(한 단위로서의)둘,2개군,(수)다이애드,(화)2가 원소
dyadic : a,2수의,(화)2가 원소의
Dyak : n,=DAYAK
dyarchy : n,=DIARCHY
dyck : n,즈크,즈크바지
dye : n,vi,vt,물감,염색,색조,물들이다
dyebath : n,염욕(염색용 용액)
dyed : a,물들인,염색된
dyedinthewool : a,철저한,실을 물들인
dyehouse : n,염색소,염색 공장
dyeing : n,염색,염색업
dyer : n,염색하는 사람
dyer's broom : n,녹황색
dyer'sbroom : n,(식)금작화의 일종
dyer's bugloss : x,(식)우설초
dyer'sweed : n,염료의 원료가 되는 식물의 총칭
dyestuff : n,염료,물감
dyewood : n,염료가 되는 각종 목재
dying : a,n,죽어가는,임종의,꺼져가는,죽음,임종
dyke : n,=DIKE
dyke : n,(속)동성애의 여자(특히 남성적인 여자)
dyllish : a,좀 둔한,좀 멍청한,흥이 없어진 듯한
dyn, : x,dynamics
dynagraph : n,궤도 시험기
dynam : x,(연결형)(힘,동력)의 뜻
dynameter : x,(광)(망원경의)배율계
dynamic : a,n,역학의,동력의,동적인,힘찬,힘센,동태 경제학,원동력
dynamical : a,=DYNAMIC
dynamically : ad,동력학적으로,역학상,정력적으로,다이내믹하게
dynamic electricity : x,(전)동전기,전류
dynamic immobility : x,(주로 정치계에서)동적인 무활동 상태,적극적 정관 태도
dynamic meteorology : x,기상 역학
dynamic obsolescence : x,(자동차 디자인의)계획적 폐용
dynamic pickup : x,다이내믹 픽업(마그넷을 고정하여,바늘이 코일을 움직이는 픽업)
dynamic positioning : x,(해)(컴퓨터에 의한)자동 위치 제어,자동 정검 유지
dynamic pressure : x,(물)동압(로켓이 대기 속을 날때 받는 압력
dynamic RAM : x,(전자)다이내믹 램(컴퓨터의 기억소자의 일종)
dynamics : n,(물)(역학),원동력,힘,활력 에너지,(약)강약법,변천(발달)의 형
dynamid psychology : x,(심)역학적(역동적)심리학
dynamism : n,역본설
dynamitard : n,(특히 폭력적,혁명적인)다이너마이트 사용자
dynamite : n,vt,다이너마이트로 폭발하다
dynamiter : n,다이너마이트 사용자,적극적인 야심가
dynamitic : a,다이너마이트적인(성의)
dynamitism : n,급진적혁명주의
dynamo : n,발전기,정력가
DYNAMO : n,다이너모(시물레이터의 일종)
dynamoelectric : a,기계에너지를 전기에너지로 바꾸는
dynamograph : n,역량 기록기,자기 역량계
dynamometer : n,역량계,망원경,배율계
dynamometry : n,동력 측정법
dynamotor : n,(전)직류 발전동기
dynapolis : 기능도시(간선 도로를 따라 잘 계획된 도시)n,
dynast : n,군주,주권자
dynastic : a,ad,왕조의,왕가의,왕조에 관하여,왕통에 의하여
dynasty : n,왕조
dynatron : n,4극 진공관의 일종
dyne : n,다인,힘의단위,(질량 1g의 물체에 매초 cm의 가속도를 일으키는 힘)
Dynel : n,합성섬유의 일종
dypso : n,a,=DIPSO
dys- : pref,(악화,불량,곤란)등의 뜻
dysbarism : n,(병리)감압증(기압의 변화로 인한 증상)
dysentery : n,이질
dysfunction : n,기능장애,역기능
dysgenic : a,비우생학적인,자손에게 나쁜 영향을 끼치는
dysgenics : n,(생)열생학
dyslexia : n,실독증
dyslexic : a,n,독서 장애의,실독증의,독서 장애자,실독증 환자
dyslogistic : a,비난의,욕설의
dysmenorrhea : n,월경 곤란(불순)
dysmetria : n,(의)운동 측정 장애,(소뇌성)운동 조절 실조
dysmorphology : n,(의)기형학(기형의 연구 치료)
dyspepsia : n,소화불량
dyspeptic : a,소화 불량(성)의,우울하고 화를 잘내는,소화불량인 사람
dysphasia : n,부전실어,실어증
dysphemism : n,(수)위악 어법,위악 어구
dysphonia : n,발성장애,음성장애
dyspnea : n,호흡곤란
dyspneic : a,호흡 곤란성의
dysprosium : n,디스프로슘(금속 원소,기호 Dy)
dystopia : n,결함사회,살기어려운 곳
dystrophication : n,(생태)(호수,하천 등의)영양 오염
dystrophy : n,영양실조
dysuria : n,배뇨곤란
dz : a,=dozen,1다스
Dzerzhinsky Square : n,제르진스키 광장(모스크바의 KGB소재지)
