F : n,바음,바조
F : n,심이 가는(연필의),fluorine
f : n,farthing,fathom,feet,female,feminine,filly,folio,following,foot,foul(s),franc(s),frequency,from,function
f,F : n,에프(영어 알파벳의 제 6자),F자 모양(의 것),F(바)음,(16진수의)F
F- : x,fighter전투기
F. : n,fahrenheit,farad,fathom,february,fellow,fighter,france,french,friday
F.A. : x,field artillery,fine arts,football association
F.A.A.,f.a.a. : x,free of all average전손 담보
F.A.A.A.S. : x,fellow of the american academy of arts and science미국 과학 협회 회원,fellow of the american association for the Advancement of Science미국 과학 진흥회 회원
F.A.C.P. : x,Fellow of the American College of Physicians
F.A.C.S. : x,Fellow of the American College of Surgeons
F.A.F.,f.a.f. : x,free at field항공기 인도 조건
F.A.G.S. : x,Fellow of the American Geographical Society
F.A.I. : x,Federation Aeronautique Internatinale국제 항공 연맹
F.A.I.A. : x,Fellow of the American Institute of Architects
F.A.M. : x,foreign airmail,Free and Accepted Masons
F.A.N.Y. : x,First Aid Nursing Yeomanry응급 간호사 부대
F.A.Q. : x,fair average quality
F.A.S. : x,free alongside ship 화물의 선측 인도
F.B.A. : x,Fellow of the British Academy
F.B.O.A. : x,fellow of the British Optical Association
f.c. : x,fielder's choice,follow copy
F.C. : x,Football Club,Free Church
F.C.A. : x,Farm Credit Administratio,Fellow of the (Institute of)Chartered Accountants
F.C.I.I. : x,Fellow of the Chartered insurance Institute
F.C.I.S. : x,Fellow of the Chartered Institute of Secretarties
F.C.O. : x,Foreign and Commonwealth Office
F.C.S. : x,Fellow of the Chemical Society
F.C.W.A. : x,Fellow of the Institute of Cost and Works Accountants
F.D. : x,Fidei Defensor,Defender of the Faith영국왕의 칭호의 하나
F.D.R. : x,Franklin Delano Roosevelt
F.E.I.S : x,Fellow of the Educatinal Institute of Scotland
F.E.N. : x,Far East Network극동 방송망
F.E.R.A. : x,Federal Emergency Relief Administration
F.E.T. : x,federal excise tax연방 소비세
f.f.a.,F.F.A. : x,free from alongside선측도
F.F.A.S : x,Fellow of the Faculty Architects and Surveyors
F.F.R. : x,Fellow of the Faculty of Radiologists
F.F.V. : x,First Families of Virginia버지니아 개척 시대부터의 구가문,엘리트층
f.g. : x,fully good
F.G. : x,Foot Guards
F.G.A. : x,free of general average
F.G.C.M. : x,Field General Cout Martial
F.G.S. : x,Fellow of the Geographical Society,Fellow of the Geological society
F.H. : x,fire hydrant
f.h.p. : x,friction horsepower
F.I. : x,Falkland Islands
F.I.A. : x,Fellow of hte Institute of Actuaries국제 자동차 연맹
F.I.B. : x,Fellow of the Institute of Bankers
F.I.C. : x,Fellow of the Institute of Chemistry
F.I.J. : x,fellow of the Institute of Journalists
F.I.M.T.A. : x,Fellow of the Institute of Municipal Treasurers and Accountans
F.Inst.P. : x,Fellow of the Institute of Physics
F.J.P. : x,Federation of Jewish Philanthropies(of New York)
f.l. : x,falsa lectio
F.L.N. : x,Front de liberation nationale (알제리) 민족 해방전선
F.O.E. : x,Fraternal Order of Eagles
F.R.I.B.A. : x,Fellow of the Foyal Institute Of British Architects
f/ : x,f-number
F2 layer : x,F2층
fa : n,파
Fa. : x,florida
FAA : x,federal aviation administration(agency)
fab : a,=FABULOUS
fabaceous : a,콩과의,콩의,콩같은
Fabian : n,a,(지구전을 쓴 고대 로마의 장군 Fabius의 이름에서)Fabius식의,지연전법으로 적을 지치게 하는,지구책의,점진적인,신중한,페이비언 협회의,페이비언 협회 회원
Fabianism : n,페이비언주의,점진주의
Fabianist : n,페이비언주의자
Fabian policy : x,지구책
Fabian Society : x,페이비언 협회
fable : n,vt,vi,우화,전설,신화,꾸며낸 이야기,지어낸 이야기,줄거리,우화를 이야기하다,거짓말하다,꾸며낸 이야기를 하다,꾸며내다
fabled : a,이야기(전설)로 유명한,전설적인,꾸며낸 이야기의,허구의
fabler : n,우화 작가,거짓말쟁이
fabliau : n,우스꽝스럽고 점찮치 못한 우화시
Fabre : n,파브르
fabric : n,구조,조직,구성,구조물,건물,구성법,피륙,직물,천,편물,짜임새,바탕
fabricable : a,만들수 있는
fabricant : n,제조(업)자
fabricate : vt,만들다,제작하다,조립하다,규격대로 만들다,제품으로 가공하다,꾸며내다,위조하다
fabricated food : x,합성 가공 식품
fabrication : n,제작,구성,구조물,꾸며낸 것,거짓말,위조(물),위조문서
fabricator : n,제작자,거짓말쟁이
Fabricoid : n,방수 모조 피혁(상표명)
Fabrikoid : n,방수 모조 피혁(상표명)
Fabry's disease : x,파브리병(선천성 지질 대사 이상증)
fabulist : n,우화작가,거짓말쟁이
fabulosity : n,전설적 성질,가공성
fabulous : a,전설상의,전설적인,비사실적인,믿어지지 않는,거짓말 같은,터무니 없는,굉장한
fabulously : ad,우화(전설)적으로,거짓말 같이,엄청나게,놀랄만큼,굉장히
fabulousness : n,
FAC : x,forward air controller 전방 공중 정찰자(기)
fac. : x,facsimile,factor,factory
facade : n,정면,전면,겉보기,외관,허울
face : n,얼굴,얼굴 생김새,안색,표정,화장,찌푸린 얼굴,표면,겉,쓰는 쪽,치는 쪽,정면,겉모양,외관,겉보기,지세,지형,형세,국면,태연한 얼굴,면목,체면
face : vt,..을 향하다,..에 면하다,정면으로 대하다,직면하다,..을 직시하다,마주 보게 하다,..을 향하게 하다,방향 전환시키다,까놓다,겉칠을 하다,겉치장을 하다,닦다,마무르다,단을 대다,착색하다,물들이다,마주 선 두 경기자 사이에 쳐서 넣다
face : vt,향하다,면하다,방향 전환하다
faceache : n,안면 신경통
face brick : x,외장 벽돌
face card : x,그림카드
facecloth : n,세수 수건,시체의 얼굴을 덮는 천
facecream : n,얼굴 화장 크림
faced : a,..한 얼굴을 한,표면이 ..한
facedown : ad,n,울굴을 숙이고,거죽을 아래로 하고,대결
face flannel : x,=facecloth
face fly : x,가축의 안면에 꾀는 집파리속의 일종
facefungus : n,턱수염
face guard : x,얼굴 가리개,마스크
faceharden : vt,표면 경화 처리를 하다
faceless : a,얼굴이 없는,개성(주체성)이 없는,익명의,정체불명의,면이 닳아 없어진
facelift : n,vt,=facelifting
facelifting : n,얼굴 성형술,외부 개장,모델 변경
faceman : n,막장 작업원
face massage : x,안면 마사지
faceness : n,
faceoff : n,시합개시,대결
facepack : n,미용 팩
faceplate : n,면판,화면
face powder : x,분
facer : n,화장 마무리하는 사람,안면 펀치,난처하게 하는 일,뜻하지 않는 곤란(장애)
facesaver : n,체면 유지 수단
facesaving : n,체면 세움,체며늘 세워주는 것
facet : n,vt,한 면,간(깎은,자른)면,홀눈,낱눈,깎아서 작은 면을 내다
faceted : a,작은(깎은)면이 있는
facetiae : n,재담,해학,농담,우스운 책,음서
facetious : a,우스운,익살맞은,허튼소리의
facetiously : ad,
facetiousness : n,
facetoface : ad,a,정면으로 맞서서,직면하여,정면으로 마주보는,직접의
face towel : x,세수 수건
face value : x,액면 가격,권면액,액면(표면)상의 가치(의미)
face wall : x,=BREAST WALL
faceworker : n,막장 작업원
facia : n,간판,계기판
facial : a,n,얼굴의,얼굴에[ 사용하는,얼굴 마사지,미안술
facial angle : x,면각,안면각
facial index : x,안면 계수
facially : ad,
facial nerve : x,안면 신경
facial neuralgia : x,안면 신경통
facial tissue : x,고급 화장지
facient : x,(..화하는,..작용을 하는,..성의)의 뜻
facies : n,안색,외관,외견
facile : a,손쉬운,힘들지 않는,쉽사리 얻을 수 있는,가뿐한,간편한,경묘한,유창한,경솔한,겉핥기의,(혀가)잘 돌아가는,잘 지껄이는,재빠른,고분고분한,양순한
facileness : n,
facilitate : vt,(일을)용이하게 하다,쉽게 하다,촉진(조장)하다
facilitation : n,용이(간편)하게 함,편리(간이)화,촉진,조장
facilitative : a,
facilitator : n,
facility : n,쉬움,재주,재간,솜씨,유창함,편익,편의,설비,시설,기지,변소,세면 설비
facility trip : x,관비(사비)여행,접대 여행
facilly : ad,
facing : n,면함,..향,겉단장,외장,마무리,치장된 면,외장재,깃(끝동,섭,단)달기
facing brick : x,=FACE BRICK
fack : vi,사실(진실)을 말하다
facsimile : n,vt,복사,모사,복제,사진 전송,팩시밀리
fact : n,사실,(실제의)일,사실,범행,사건
fact finder : x,진상 조사원
fact finding : a,n,진상(현지)조사(의)
faction : n,당내의 당,도당,당파,파벌
faction : n,실록 소설,실화 소설
faction : x,(작용)의 뜻
factional : a,도당의,당파적
factionalism : n,파벌주의,당파심
factionalist : n,파당을 짓는 사람,당파에 속하는 사람
factious : a,당파적인,당파심이 강한,당파 본위의,당쟁을 일삼는
factiously : ad,
factiousness : n,
factitious : a,인공(인위)적인,겉꾸민,부자연스러운
factitiously : ad,
factitiousness : n,
factitive : a,작위의
factitively : ad,
factoid : n,사실로서 받아들여지고 있는 일(이야기),의사 사실
factor : n,요소,요인,원인,인수,인자,계수,율,대리상,도매상,중매인
factorage : n,대리업,도매업,중매 수수료,도매상이 받는 구전
factor analysis : x,인자 분석
factor cost : x,요인(요서)비용
factorial : n,a,계승의,대리상의,도매상의,계승
factoring : n,인부 분해,대리업,채권 매입업
factorization : n,인수 분해,채권 차압 통고
factorize : vt,인수 분해하다
factory : n,공장,제조소
Factory Acts : x,공장법
factory farm : x,공장 방식으로 운영되는 축산 농장
factory ship : x,공선,모선,공작선(함)
factory system : x,공장 제도
factotum : n,잡역부,막일꾼
factualism : n,사실 존중(주의)
factualismist : n,
factualistic : a,
factum : n,사실,행위,범행,작성,진술서
facture : n,제작(법),수법,제작물,작품,(작품의)질
facula : n,흰 반점
faculalous : a,
facular : a,
facultative : a,허용적인,수의의,임의의,우발적인,기능의,다른 환경에서도 살수 있는
faculty : n,능력,재능,기능,수완,자력,기능,학부,학부의 교수단,대학고교의 전교직원,직원회의,동업자 단체,특허
fad : n,변덕,일시적 유행,도락,유별난 취미
fadayee : n,
faddish : a,벽덕스러운,별난 것을 좋아하는
faddism : n,일시적인 유행을 따름,별난 것을 좋아함
faddist : n,변덕쟁이,일시적인 유행을 따르는 사람,음식에 까다로운 사람
faddy : a,=FADDISH
fade : vi,vt,바래다,사라지다,나빠지다,시들다,쭈그러들다,쇠퇴하다,희미해지다,자취를 감추다,차츰 안보이게 되다,코스에서 벗어나다
fade : n,파두
fadeaway : n,사라져 버림,소실
faded : a,시든,빛깔이 바랜,쇠토한
fadedly : ad,
fadedness : n,
fadein : n,페이드인,용명
fadeless : a,시들지 않는,빛깔이 바래지 않는,쇠퇴하지 않는,불변의
fadelessly : ad,
fadeout : n,페이드아웃,ㅛ암,차차 흐려짐,점점 보이지 않게 됨
fader : n,음량 조절기,광량 조절기
fading : n,페이딩
FAdm,F.Adm.,FADM : x,Fleet Admiral해군 원수
FAE : x,fuel air explosive
faecal : a,=FECAL
faeces : n,=FECES
faed : a,운명의,운이 다한
faena : n,파에나(투우사의 기술을 과시하기 위하여 죽기 직전의 소를 연속해서 찌르는 일)
faerie,faery : n,a,요정의 나라,몽환경,선경,선녀들,요정의,요정같은,몽환적인
Faeroe Islands : n,페로 제도
faff : n,vt,공연한 법석을 떨다,빈둥빈둥 지내다,공연한 법석
Fafnir : n,파브니르
faful : a,숙명적인,치명적인,중대한
fag : n,vt,열심히 일하다,상급생의 심부름꾼 노릇을 하다,피곤하게 한다,고역,노역,피로,상급생 시중드는 하급생,궐련
fag : n,a,동성연애자
fagaceous : a,너도밤나무과의
fag end : n,도려낸 끝 조각,말단,남은 허섭쓰레기,담배,토끌,새끼의 꼬지 않은 끄트러미
faggotry : n,동성애,호모행위
faggot vote : x,긁어 모으기 투표(재산의 일시적 양도로 선거 자격을 얻은 사람의)
fag hag : n,동성애 남자만 사귀는 여자
Fagin : n,(어린이를 소매치기,도둑질의 잡이로 만드는)나쁜 노인
fagot,faggot : n,vt,장작뭇(단),삭정이단,쇠막대 다발,지금 뭉치,한 묶음,간 요리의 하나,동성애자,호모,싫은 여자,미운녀석,단으로 묶다,다발로 만들다
fagoting : n,패고팅
fagotto : n,
Fah. : x,Fahreheit
Fahrenheit : a,화씨의
Fahrenheit thermometer : x,화씨 온도계
faience : n,파양스 도자기
fail : vi,vt,n,실패하다,실수하다,낙제하다,게을리하다,부족하다,끊어지다,흉작이 되다,모자라다,없다,약해지다,파산하다
failed : a,실패한
failing : n,prep,실패,낙제,쇠약,파산,결점,약점,부족,..이 없어서,..이 없을 경우에는
faille : n,파유
failsafe : n,a,vi,vt,(핵폭격기가 별도 지시 없이는 넘을 수 없는)한계선,2중 안전 장치,우발 방지 기구,전자통제의,우발 방지의,비상(이중)안전장치로 하다,비상(이중)안전장치가 가동하다
failure : n,실수,실패,실패자,잘못된 것,실패한 계획,태만,불이행,부족,불충분,없음,감퇴,쇠퇴,지불정지,파산,고장,정지,파괴,파손,낙제
fain : ad,기꺼이,쾌히,기꺼이..하는,어쩔 수 없이..하는,..하기를 바라는,하고 싶어하는
fain,fains : vt,..은 싫다
faineant : n,a,게으름뱅이,게이른,나태한
faint : a,vt,n,희미한,가냘픈,몽롱한,어렴풋한,약한,엷은,희박한,힘없는,연약한,열없는,활기없는,뱃심없는,쇠약해진,미약한,어질어질한,인사 불성이 된,졸도하다,기절하다,약해지다,활기를 잃다
faintheart : n,겁쟁이
fainthearted : a,소한,겁많은,뱃심 없는
faintheartedly : ad,
faintheartedness : n,
fainting : n,a,기절,졸도,실신,의기소침,졸도하는,기철의
faintingly : ad,
faintish : a,기절할 것 같은,아찔한,좀 희미한,어렴풋한
faintly : ad,희미하게,어렴풋이,힘없이,가냘프게,소심하게,머무적거리며
faintness : n,약함,연약함,희미한,미약,심약함,실신
faintruled : a,엷은 괘선이 쳐진
faints : n,불순한 알코올
fair : a,ad,vt,vi,n,공명정대한,올바른,온당한,적정한,규칙에 어긋나지 않는,꽤 좋은,어지간한,나쁘지 않은,보통의,순조로운,알맞은,살결이 흰,금발의,갠,아름다운,정중한,깨끗한,흠없는,장애물이 없는,꽤 많은,상당한,유망한,가망이 있는,철저한,깔축 없는
fair : n,정기시,축제일겸 장날,자선시,박람회,견본시,전시회,품평회,공진회
fair ball : x,페어볼
fair catch : x,페어캐치
fair copy : x,정서,정확한 사본
Fair Deal : x,공정 정책
fair employment : x,공평 고용
fairfaced : a,피부가 흰,미모의,회를 바르지 않은,그럴싸한
fair game : x,수렵 해금된 사냥감,좋은 목표(공격,조소의)
fair green : x,=FAIRWAY
fairground : n,정기 장터,공진회,박람회,등이 열리는 장소
fairhaired : a,금발의,마음에 드는,총애받는
fairharied boy : x,총애 받는 청년,후임자로 지목받는 청년
fairing : n,장에서 산 선물
fairish : 유선형으로 하,정형,우선형의 구조(부분)n,
fairish : a,어지간한,상당한
Fair Isle : x,스웨터의 일종
fairlead : n,페어리드,페어리더,도삭기
fairlight : x,=TRANSOM window
fairly : a,요정같이
fairly : a,공정(공평)히,꽤,어지간히,그런대로,아주,완전히,정말로,명료하게,뚜렷이
fairminded : a,공정(공평)한,편견을 갖지 않은,기탄없는
fairness : n,살결이 흼,예쁨,금빛,공명 정대,공평
fairness doctrine : x,기회 공평의 원칙
fair play : x,정정당당한 경기 태도,공명 정대한 행동,페어플레이
fair price : x,적정 가격
fair sex : x,여성,여자들
fair shake : n,공평한 기회,공정한 조치
fairsized : a,꽤 많은(큰)
fairspoken : a,정중한,상냥한,구변이 좋은
fairtomiddling : a,보통보다 좀 나은
fairtrade : vt,vi,호혜무역협정에 따라 거래하다
fairtrade agreement : x,호혜무역협정,최혜국 약관
fairtrade agreement : a,vt,공정 거래의,공정거래(호혜무역)협정의 규정에 따라 팔다
fair trader : n,공정 거래(호혜 무역)업자
fairway : n,항로,안전한 뱃길,페어웨이
fairweather : a,순조로운,날씨가 좋은 때만의 
fairy : n,a,요정,선녀,동성 연애를 하는 남자,요정의,요정에 관한,요정 같은,우미한
fairycircle : n,어린이용 자전거
fairy dogmother : n,주인공을 돕는 요정,친절한 사람(아주머니)
fairydom : n,=FAIRYLAND
fairy green : n,노란 색을 띤 녹색,황록색
fairyhood : n,요정임,마성,요정
fairy lamp : x,꼬마램프
fairyland : n,요정(동화)의 나라,선경,더할 나위 없이 아름다운 곳,신기한 세계,도원경
fairylike : a,요정과 같은
fairy money : n,요정에게서 받은 돈,주운 돈
fairy ring : x,요정의 동그라미,춤터(균 때문에 잔디가 둥그렇게 검푸르게 된 부분)
fairy tale : x,동화,지어낸 이야기,거짓말
faisande : a,젠체하는,부자연스러운,꾸민듯한
fait accompli : n,기정 사실
faites vos jeux : int,돈을 거십시오
faith : n,신뢰,믿음,신용,신앙,신념,확신,신조,신의,성실,충성,서약,약속
faith cure : x,신앙요법
faith curer : x,신앙요법을 베푸는 사람
faithful : a,n,성실한,신뢰할 수 있는,정확한,신자들
faithfully : ad,여불비례
faith healer : x,=faith curer
faith healing : x,=faith cure
faithless : a,불성실한,믿을수 없는,신심없는
fake : vt,vi,n,a,날조하다,~인체하다,위조,위조의,가짜,가짜의,사기꾼
fake : vt,n,(밧줄을)첩첩이 사리다,한사리
fake book : n,대중 가요 악보집
faker : n,위조자,사기꾼,노점(대로),상인,행상인
fakery : n,속임수,사기,가짜,모조품
fakir : n,회교,브라만교의 행자
falafel : n,팔라펠
falange : n,팔랑헤당(스페인 내란 후 정권을 잡은 우익 정당)
Falangist : n,팔랑해당원
Falasha : n,팔라샤인
falbala : n,옷자락 장식,옷자락 주름
falcate : a,낫모양의,갈고리 모양의
falchion : n,언월도,칼
falciform : a,=FALCATE
falcon : n,송골매
falconer : n,매부리
falconet : n,작은매,경포
falconry : n,매훈련법,매사냥
falderal : n,하찮은것,허튼수작,잠꼬대,무의미한 후렴
faldstool : n,팔걸이 없는 의자,예배용 접의자,호칭 기도용 작은 책상
Falernian : n,팔레르노 포도주
Falkland Islands : n,포클랜드 제도
fall : vi,n,떨어지다,강하하다,온도가 내리다,우연히 오다,뽑히다,분류되다,쇠미,함락,강하,내리막,폭포,가을
fallacious : a,그릇된,허위의,속이는
fallaciously : ad,오류에 빠져,허위적으로
fallaciousness : n,
fallacy : n,오류,틀린생각,사기성
fallal : n,싸고 야한 장신구
fallal(l)ery : n,야한 장식품
fallback : n,후퇴,의지(가 되는 것),여축,예비물(금),대체 시스템
fallen : n,fall의 과거 분사,떨어진,쓰러진,죽은,파멸한,타락한(fallen angel 천국에서 쫓겨난 타락한 천사)
fallfish : n,잉어과의 담수어
fall guy : n,잘 속는 사람,남에게 이용당하여 손해만 보는 사람
fallibility : n,오류를 범하기 쉬움
fallible : a,속아 넘어가기 쉬운,틀리기 쉬운,오류가 있는
fallin : n,방사성 폐기물
falling : n,a,낙하,추락,강하,전도,함락,붕괴,타락,떨어지는,내리는,하락하는,감퇴하는
falling door : x,=flap dooor
falling leaf : x,낙엽식 강하 비행술
fallingout : n,싸움,불화,충돌
falling sickness : x,간질
falling star : x,별똥별,유성
falling stone : x,운석,별똥
fall line : x,폭포선,평원과 해안 평야와의 한계선,최대 경사선
falloff : n,저하,쇠퇴,감소
Fallopian tube : x,나팔관,수란관
fallout : n,방사성 낙진,원자 재
fallout shelter : x,방사성 강하물 대피소
fallow : a,n,vt,놀리다,묵히고 있는,유휴,유휴하다,담황색의
fallow : a,연한 황갈색의,연한 회갈색의
fallow deer : x,유럽산의 노랑사슴
fallsown : a,가을 파종의
falltrap : n,함정
FALN,F.A.L.N. : x,민족 해방군
false : a,틀린,거짓의,가짜의,부정의,가의,가락이 맞지 않는
false acacia : x,아카시아
false alarm : x,화재 신고,헛 위기(경고),허보
false arrest : x,불법체포
false bottom : x,이중바닥
false color : x,위색채(법)
false colors : x,가짜 국기,정체를 숨기는 것
false concord : x,불일치
false eye : x,의안,해박은 눈
false face : x,가면
falsehearted : a,성실하지 않은,신의가 없는
falseheartedly : ad,
falsehood : n,허위,거짓말
false imprisonment : x,불법감금
false keel : x,가용골
false key : x,도둑용의 곁쇠
falsely : ad,거짓으로,속여서,잘못하여,부정하게,불성실하게
falseness : n,불성실
false position : x,궁지
false pretenses : x,사기죄
false quantity : x,모음 장단의 잘못
false relation : x,대사
false return : x,부정 신고
false rib : x,가늑골,보조 소골
false start : x,부정한 스타트,그릇된 출발(첫 발)
false step : x,곱드러짐,실책
false teeth : x,의치,틀니
falsettist : n,가성 가수
falsetto : n,a,ad,가성,가성의,가성으로
false window : x,봉창,붙박이창
falsework : n,비계,가설물
falsies : n,여성용 가슴받이(유방을 풍만하게 보이기 위한)
falsification : n,허위,위조,곡해,반증
falsifier : n,위조자,거짓말쟁이,곡해자
falsify : vt,속이다,위조하다,거짓임을 증명하다,저버리다
falsity : n,허위,거짓말,틀림
Falstaff : n,사극에 나오는 명랑하고 겁많은 허풍쟁이 뚱뚱보 기사
Falstaffian : n,
faltboat : n,접이보트
falter : vi,vt,n,비틀거리다,말을 더듬다,머뭇거리다,우물우물 말하다,비틀거림,머뭇거림,더듬음
falteringly : ad,비틀거리며,머뭇거리며,말을 더듬으며
falvescent : a,누르스름해지는,누르스름한
falwy : :a,
fam. : x,familiar,family,famous
fame : n,vt,명성,평판,유명하게 만들다
famed : a,유명한
fameless : a,
familial : a,가족의,가족성의,가족 특유의
familiar : a,잘 알려져있는,흔한,잘 알고있는,친한,부담없는,스스럼없는,탁터놓은,뻔뻔스러운,길들여진
familiar angel : x,수호신
familiarity : n,친함,친밀,친교,허울없음,무간함,스스럼 없음,임의로움,치근치근함,무엄한
familiarization : n,친하게 함,익숙하게 함,정통케 함
familiarize : vt,친해지게하다,통속화하다
familiarly : ad,친하게,허물없이,무엄(치근치근)하게
familiar spirit : x,부리는 마귀,영혼
familism : n,가족주의
famille jaune : x,노란색을 바탕으로 한 중국의 연채 자기
family : n,a,가구,세대,가족,집안,식구들,아이들,자녀,종족,민족,일족,가문,친척,일가,집안
family : n,가족,식구,일가,한집안의 아이들,일족,문벌,명문
family allowance : x,가족수당
family Bible : x,가정용 성경
family circle : x,일가 사람들,가족석
family court : x,가정재판소
family Division : x,가정(가사)부
family doctor : x,단골의사
family ganging : x,호나자의 가족까지 친절하여 부당 보험료를 청구하는 행위
familygram : n,가족 전보
family hotel : x,가족 할인 호텔
family hour : x,가족 신청 시간
family jewels : x,고환
family life cycle : x,가족 주기
family likeness : x,가족끼리의 닮은 점
family man : x,가정을 가진남자
family medicine : x,가족 의료
family name : x,성
family planning : x,가족계획
family practice : x,=family medicine
family practitioner : x,=family doctor
family room : x,가정 오락실,거실
family skeleton : x,집안내의 비밀
family style : x,각자가 떠먹게 큰그릇에 담음
family therapist : n,
family therapy : x,가족 요법
family tree : x,가계도,족보
famine : n,기근,대부족(house famine 주택난)
famine prices : x,품귀(품절)시세
famish : vi,vt,굶주리게하다
famous : a,유명한,근사한
famulus : n,제자,조수
fan : n,vt,vi,부채,선풍기,부채모양의 것,키,부채질하다,키질하다,부채따위로 쫓다,부추기다,부채꼴로 펼치다,팬,열광자
fanatic : n,=fanatica,열광자,광신자
fanatical : a,열광(광신)적인
fanatically : ad,열광하여,광신적으로
fanaticalness : n,
fan belt : x,팬벨트
fancied : n,상상의,공상의,가공의,사육자
fancier : n,애호가,사육자,공상가
fanciful : a,변덕스런,기발한,공상의
fanciless : a,상상(공상)(력)이 없는,무미 건조한
fanciness : n,장식성
fan club : x,후원회,팬클럽
Fanconi's anemia : x,판코니빈혈
fancy : n,a,vt,공상력,공상,변덕,취미,도락,애호가들,공상의,터무니 없는,공상하다,좋아하다
fancy ball : x,가장무도회
fancy cake : x,데커레이션 케이크
fancy dan : x,허세부리는 사람
fancy diving : x,곡예다이빙
fancy dress : x,가장복
fancy fair : x,방물자 선시
fancyfree : a,연애를 모르는
fancy goods : x,방물,장신구,특선품
fancy man : x,매춘부의 정부
fancy pants : x,멋쟁이
fancy piece : x,애인
fancysick : a,사랑에 고민하는
fancy woman : x,매춘부,정부
fancywork : n,수예품
fan dance : x,큰 부채를 사용하는 선정적인 누드댄스
fan dance : x,나체로 추는 부채춤,부채춤
fandangle : n,기이(기발)한 장식,어리석은 짓,기계기구
fandango : n,스페인의 3박자의 활발한 춤
fandom : n,펜 전체
fane : n,신전,교회당
fanfare : n,과시,광고
fanfaronade : n,호언장담,허세
fanfold : n,복사장(사이사이에 먹지를 끼워 철한)
fang : n,엄니,뱀의독아,끌이나 찬칼 따위의 슴베
fangle : n,유행
fan heater : x,송풍식 전기 스토브
fan jet : x,괜 제트기,제트엔진의 일종
fan letter : x,괜레터
fanlight : n,부채꼴 창
fan magazine : x,대중 오락 잡지
fan mail : x,팬레터
fan marker : x,부채꼴 위치표지
fan marker : x,부채꼴 위치 표지(공항 부근에 배치되어 전파로 비행기를 유도함)
fannaticism : n,
fanner : n,부채질하는 사람,선풍기
Fannie Mae(May) : x,연방 국민 저당 협회
fanny : n,궁둥이,여성의 성기
Fanny Adams : x,통조림 고기,스튜,전혀없음,전무
fanout : n,부채꼴 전개
fanout : n,부채꼴의 전개
fan palm : x,잎이 부채꼴인 야자수
fantabulous : a,믿을 수 없을 만큼 굉장한
fantad : n,=FANTOD
fantail : n,부채꼴의 꼬리,공작비둘기,농어과의 담수어,고물의 돌출부
fantan : n,판탄(종발을 사용하는 중국도박),카드놀이의 하나
fantan : n,팬탠,카드놀이의 일종
fantasia : n,환상곡,혼성곡
fantasist : n,환상곡(환상적 작품)을 쓰는 작곡가(작가),몽상가
fantasize : n,vi,꿈에 그리다,몽상하다,공상에 잠기다
fantasm : n,=phantasm
fantasmo : a,매우 이상한,기발한,기막히게 훌륭한(빠른,높은)
fantast : n,환상가,몽상가
fantastic : a,공상적인,변덕스러운,기묘한,상상의
fantasticality : n,공상적임,기이,괴기(한 것),광상
fantastically : ad,
fantasticate : vt,환상적으로 하다
fantastication : n,
fantasticism : n,괴기(기이)함을 좋아하는 마음,색다름
fantasy : n,공상,기상,변덕,백일몽
fantod : n,안절부절 못함,심한 근심(고뇌),육체적 장애,감정의 폭발
fantom : n,=PHANTOM
fan tracery : x,부채꼴 둥근 천장의 창장식
fan window : x,부채꼴 창
fanwise : ad,부채꼴로(의)
fanzine : n,공상 과학 소설 잡지
FAO,F.A.O. : x,Food and Agriculture Organization (of the United Nations)
fapi : n,법폐(중국의 옛 통화)
faquir : n,=FAKIR
far : a,ad,먼,저쪽의,극동의,멀리,크게
farad : n,패럿(전기 용량의 단위)
faraday : n,전기분해에 쓰이는 전기량의 단위
faradism : n,유도전류
faradize : vt,감응전류로 자극,치료하다
faraway : a,먼,꿈꾸는듯 한
farce : n,vt,익살극,소극,익살미를 가하다
farcical : a,우스운,익살맞은
farcicality : n,익살스러움
far corner : n,3루
farcy : n,마비저,치명적 만성 선규증
fardel : n,다발,무거운 짐
fare : n,vi,요금,승객,음식물,지내다,일어나다,먹다,대접받다,가다,여행하다
Far East : x,극동
Far Eastern : x,극동의
farer : n,여행자,길손
faretheewell : n,완전,극단
farewell : int,a,n,안녕!,작별의 인사,고별
fareyouwell : ad,끝까지,완벽하게
farfamed : a,이름이 널리 알려진
farfamed : a,이름이 널리 알려진
farfectched : a,억지로 갖다대는,견강부회의
farflung : a,광범위에 걸친,널리 퍼진
farforth : ad,아득히 먼,극도로
fargone : a,먼,훨씬 악화된,피로에 지친
farina : n,곡식 가루,꽃가루,전분,녹말,분말
farinaceous : a,곡식 가루의,가루를 내는,녹말질의,가루같은
farinaceous : a,전분질의
farinose : a,가루 모양의,가루를 내는,흰 가루로 덮인
farkleberry : n,울귤 나무의 일종
farkleberry : n,월귤나무의 일종
farl(e) : n,연맥,밀가루로 살짝 구워 만든 둥근 케이크
farm : n,vt,vi,농장,농가,사육장,선수양성팀,토지를 대차하다,경작하다,도급맡다,경작하다,농장을 경영하다
farmable : a,
farm belt : x,곡창 지대,대농업 지대
farm bloc : x,농민 이익 대표단
farmer : n,농장 경영자,농장주,농부,유아등을 맡는 사람,수세 도급인,시골사람
farmer cheese : x,파머치즈
farmerette : n,농장에서 일하는 여자
farmers cooperative : x,농업 협동 조합
farmfresh : a,농장 직송의,산지 직송의
farm hand : x,농장 노동자
farmhouse : n,농가
farming : a,n,농어브이,농장의,농업용의,농업,농작,농장 경영,사육,야식,징수도급
farm laborer : x,=farmhand
farmland : n,농지
farm management : x,농업(농장)경영
farmost : a,가장 먼
farm produce : x,농산물
farmstead : n,건물을 포함한 농장
farm stock : x,농장 자산
farm system : x,제2군 리그 합동 운영제
farm team : x,팜팀,2군
farmyard : n,농가의 안뜰
faro : n,은행놀이(카드놀이의 일종)
faroe Islands : x,=Faeroe Islands
faroff : a,아득히 먼
faroff : a,아득히 먼
farouche : a,뚱한,무뚝뚝한,수줍은,격렬한,난폭한
farout : a,훨씬 앞선,참신한
farout : a,먼,참신한,전위적인,파격적인,멋진,극단적인
farouter : n,파격적인 사람,인습에 구애되지 않는 사람
far point : x,원점
farraginous : a,긁어 모은,뒤섞인
farrago : n,뒤범벅
farranging : a,광범위한,장거리에 걸친
farreaching : a,멀리까지 미치는,광범위한
farrier : n,편자공,말의사,수의
farriery : n,제철술,제철 공장
Far Right : x,극우
farrow : n,vt,vi,한배의 돼지새끼,(돼지가)새끼를 낳다
farruca : n,파루카(플라밍고의 일종)
farseeing : a,선견지명이 있는,먼눈이 밝은
farside : x,먼 쪽,저편,저쪽,건너편
farsighted : a,원시의
farsightedly : ad,
farsightedness : n,
fart : n,vi,방귀(뀌다)
farther : a,ad,더먼,더멀리,그위에,더욱더,좀더
farthermost : ad,가장 먼
farthest : a,ad,가장먼,가장멀리(at farthest 멀어도,늦어도,고착)
farthing : n,영국의 동전
farthingale : n,둥근뼈속 버팀 스커트
fartlek : n,파틀렉
Far West : x,극서부 지방(미국로킬 산맥 지방에서 태평양안 일대)
fasces : n,속간표(집정관 권위의 표지)
Fasching : n,사육제,카니발
fascia : n,끈,띠,붕대,근막
fasciate : a,띠로묶은,띠모양의,무늬있는
fasciation : n,붕대 감기,대화 현상
fascicle : n,작은다발,밀산화서,분책
fascicular : a,총생의
fascicule : n,섬유속,분책본
fasciculus : n,=fascicle
fascinate : vt,매혹하다,움츠러지게 하다,눈독들이다
fascinating : a,매혹적인
fascination : n,매혹,눈독들임,매력있는 것,황홀한 상태
fascinator : n,매혹하는 사람,마법사,매혹적인 여자,레이스 두건
fascine : n,장작단
fascism : n,파시즘,독재적 국가 사회 주의
fascismo : n,=fascism
fascist : n,파시스트 당원,파시즘 신봉자,국수주의자,파쇼
Fascista : n,파시스트당원,파시스트당
fascistization : n,파쇼화
fascistize : vt,파쇼(파시즘)화하다
FASE : x,fundamentally analyzable simplified English
fashion : n,vt,유행,방법,형,종류,유행아(after a fashion 이럭 저럭,come into fashion 유행되다),형성하다
fashionable : a,유행의,상류 사회의
fashion book : x,패션 견본집
fashion conscious : a,유행에 민감한
fashion display : x,=fashion show
fashioned : a,...식(류,풍)의
fashionese : n,패션계 용어
fashion house : x,고급 양장점
fashion model : x,패션 모델
fashionmonger : n,유행 연구가,유행을 쫓는 사람
fashion plate : x,유행복장도
fashion plate : x,유행복의 본
fashion show : n,패션 쇼
fash plte : x,원색 인쇄한 유행 복장도
fast : a,ad,vi,n,빠른,재빠른,단단한,고정된,피할 수 없는,고감도의,저항력이 있는,굳게,푹,빨리,착착,방탕하여,단식하
fastback : n,파스트백(유선형지붕의자동차)
fast ball : x,속구,파스트볼
fast baller : x,속구투수
fast breeder : x,고속 증식로
fast breeder : x,고속 증식로
fastbuck : n,쉽게번 돈
fastday : n,단식일
fasten : vt,vi,단단히 고정시키다,붙들어 매다,멈추다,잠그다,고착하다,잠기다,꽉 달라붙다
fastener : n,잠그는 사람,죄는(잠그는)금속구,지퍼,클립,스냅,탈색 방지제
fastening : n,죔,잠금,닫음,붙임,채우는(걸어매는)기구
fast food : x,간이(즉석)음식
fastfood : x,즉석 또는 가져가서 먹게 만든 요리(힘버거나 닭튀김 등)
fastgrowing : a,빨리 성장하는
fastidious : a,꽤 까다로운
fastidiously : ad,
fastidiousness : n,
fastigiate : a,끝이 원추 모양으로 뾰족한
fastigium : n,극기,뇌실정
fasting : n,a,단식,금식,절식,단식의,금식의
fastish : a,꽤 빠른
fast lane : x,추월 차선
fast motion : x,지속촬영에 의한 움직임(동작)
fastness : n,고착,정착,신속,빠름,난봉,방탕,요새,성채
fast neutron : x,고속 중성자
fast one : x,협잡,사기,속임수
fasttalk : vt,유창하게 말하다
fasttalker : n,사기꾼,말재주가 좋은 사람
fast time : x,=daylight-saving time
fastuous : a,오만한,허세부리는
fat : a,n,vi,vt,살찐,지방이 많은,비옥한,풍부한,유복한,둔감한,지방,기름기,제일좋은 부분,살찌(게하)다
fatal : a,치명적인,숙명적인,결정적인
fatalism : n,숙명론
fatalistic : n,숙명
fatalistically : ad,
fatality : n,불운,불행,재난,참사,죽음,사망자(수),숙명,운명,인연,숙명론,필연설,치사성,불치
fatality rate : x,사망률
fatally : ad,치명적으로,숙명적으로
Fata Morgana : n,모르가나 선녀
fatback : n,돼지의 구리 위족의 비계살
fat cat : x,정치 자금을 많이 바치는 부자,세력가,유명인,돈 많은 특권인
fat city : x,더할 수 없이 좋은 상태(상황,전망)
fate : n,운명,숙명,운,죽음,파멸(meet one's fate 비명에 죽다,the Fates 운명의 세 여인)
fat farm : x,살빼는 도장
fat farm : x,=health spa
fath. : n,=fathom
fathead : n,바보,얼간이
fatheaded : a,우둔한,얼뜬
father : n,vt,아버지,조상,창시자,시조,신부,원로원의원,하느님,~의 아버지이다,아버지처럼 행동하다,창시하다
Father's Day : x, 아버지 날(6월 세째 일요일)
Father Christmas : x,=santa claus
Father Christmas : x,=SANTACLAUS
father confessor : x,고해신부
fatherhood : n,아버지임
father image(figure) : x,이상적인 아버지상을 지닌 사람
father in law : n,장인,시아버지
fatherland : n,조국
fatherless : a,아버지가 없는,작자 미상의
fatherlike : a,ad,=fatherly
fatherliness : n,아버지 다움,아버지의 자애,부성애
fatherly : a,아버지의,자비깊은
Fathership : n,아버지의 신분(자격)
Father Thames : x,템스 강
Father Time : x,시간 할아버지
fathom : n,vt,길(약1,8m),수심을 재다,헤아리다,추측하다
fathomable : a,잴(추측할)수 있는
Fathometer : n,음향측심기
fathomless : a,잴 수 없는,깊이를 알 수 없는,불가해한
fathomlessly : ad,
fathom line : x,측연선
fatidic : a,예언의,예언적인
fatigable : a,곧 피로해지는
fatigue : n,vt,피로,노역,금속의약화,사역,작업복,지치게 하다,(금속 등을)약화시키다
fatigue clothes(dress) : 작업복
fatigue duty : x,사역
fatigueless : a,지치지 않는,피로를 모르는
fatigue party : x,사역반
fatigue test : x,피로 시험
fatimas : n,여성의 귀감으로 일컬어진 마호메트의 딸,Bluebeard의 비밀을 간파한 그의 일곱째 아내
fat lamb : x,비육 새끼양
fat lime : x,부석회
fatling : n,살찌운 가축
fatly : ad,살쪄서,서투르게,크게
fatmouth : vi,말만 하다
fatness : n,뚱뚱함,비만,기름기가 많음,비옥
fatso : n,뚱뚱보
fatsoluble : a,유지에 용해하는,지용성의
fatted : a,살찌운
fatten : vt,vi,살찌우다,기름지게 하다,살찌다
fattiness : n,지방질,기름기가 많음,지방 과다(성)
fattish : a,좀 살찐
fatty : a,n,기름기가 많은,지방 과다(증)의,뚱보
fatty acid : x,지방산
fatty degeneration : x,지방 변질
fatuity : n,어리석음,우둔,어리석은 짓(말)
fatuous : a,얼빠진,분별없는,철없는,실체가 없는(fatuous fire 오깨비물)
fatuously : ad,
fatuousness : n,
fatwitted : a,우둔한,어리석은,멍청한
faubourg : n,교외,근교
faucal : a,n,구협의,인두의,인두음의,인두음
fauces : n,인두
faucet : n,수도꼭지,고동
faugh : int,피이!,쳇!,흥!
Faulkner : n,William(1897~1962)미국의 소설가
fault : n,과실,결점,책임,테니스 폴트(서브실패),단층(at fault 잘못하여,당황하여)
faultfinder : n,트집쟁이,잔소리꾼
faultfinding : n,흠잡기
faultily : ad,불완전하게,잘못하여
faulting : n,단층 형성
faultless : a,더할나위 없는
fault line : x,단층선
fault plane : x,단층면
fault tree : x,=event tree
faulty : a,결점 있는,불완전한
faun : n,목축,농업을 맡은반인,반염소의 신
fauna : n,동물상,동물군,동물지
faunal : a,동물지적인
faunist : n,동물상 연구자
faunistic : a,동물 지리학상의,동물상의
faunistical : a,동물상(지)의
Faunus : n,파우누스
Faust : n,지상에서의 쾌락과 맞바꾸어 혼을악마에게 팔아넘긴 남자,Goethe작의 극이름
Faustian : a,파우스트적인,정신적 가치를 파는
faute de mieux : ad,a,달리 더 좋은 것이 없어서(채택된)
fauteuil : n,팔걸이(안락)의자
Fauve : n,야수파 화가
Fauvism : n,야수파주의
faux bonhomme : n,선량해 보이는 교활한 사람
fauxnaif : a.n,순진(소박)한 체하는(사람)
faux pas : x,실례되는말,품행이 좋지 못함,(여성의)문란한 행위
fava bean : x,=broad bean
fave : n,=favorite
fave rave : n,마음에 드는 것,인기 탤런트(가수)
favism : n,급성 용혈성 빈혈
favo(u)r : n,호의,친절,은혜,편벽된 사랑,선물,(여자가 몸을 허락하는)동의
favo(u)rable : a,호의를보이는,형편 좋은,유리한,유망한
favo(u)rably : ad,호의를 가지고,유리하게,순조롭게,알맞게,유망하게
favo(u)red : a,호의를(호감을)사고 있는,혜택을 받고 있는,특성.재능 등이 있는
favo(u)rer : n,호의를 베푸는 사람,보호자,보조자,찬성자
favo(u)ring : a,형편에 맞는,순조로운
favo(u)ringly : ad,
favo(u)rite : n,a,마음에 드는것,인기 있는 사람,우승후보,맘에 드는,좋아하는
favo(u)rite sentence : x,애용하는 문형
favo(u)rite son : x,지방 유지,인기 후보자
favolate : a,벌집 모양의,기포가 있는
favonian : a,서풍의(같은),온화(온후)한
favouritism : n,펀애,정실,편과
favus : n,황선
fawn : n,a,vi,새끼사슴,엷은 황갈색의,아첨하다,해롱거리다,재롱떨다
fawncolored : a,엷은 황갈색의
fawning : a,아양부리는,알랑거리는,아첨하는
fawningly : ad,
fax : n,팩시밀리
fay : vi,vt,접합(밀착)시키다
fay : n,=FAIRY
faze : vt,방해하다,마음을 혼란케 하다
FB : x,freight bill 운임 청구서
fb : x,freight bill,fullback
FBI,F.B.I. : x,Federal Bureau of Investigation연방 수사국
FBM : x,foot board measure
FBR : x,fast breeder reactor고속 증식로
FBS : x,fasting blood sugar 고복시 혈당,forwardbased system전진 기지 조직
fcap.,fcp. : x,foolscap Commission연방 통신 위원회
F clef : x,저음 자리표
FCS : x,fire control system
fcy. : x,fancy
FDA : x,Food and Drug Administration
FDC : x,Fire Direction Center사격 지휘소
FDF : x,flight data file 
FDIC : x,Federal Deposit Insurance Corporation연방 예금 보험 공사
FDX : x,full duplex
Fe : x,ferrum
FEAF : x,Far Eastern Air Force극동 공군
feal : a,충실한,성실한
fealty : n,(영주에대한)충성,성실
fear : n,vt,vi,두려움,공포,걱정,경외,무서워하다,걱정하다,경외하다
fearful : a,무서운,두려워하여,걱정하여,지독한
fearfully : ad,무서워하며,거정스럽게,굉장히,지독하게,몹시
fearless : a,무서워하지 않는,대담 무쌍한,겁 없는
fearlessly : ad,무서워하지 않고,대담하게,겁 없이
fearlessness : n,대담,용기
fearnought,fearnaught : n,두껍고 질긴 모질물,그것으로 만든 웃옷
fearsome : a,무서운,겁많은
fearsomely : ad,
feasance : n,이행
feasibility : n,실행할 수 있음,성부,가능성
feasibility study : x,타당성 조사,예비 조사
feasible : a,실행할 수 있는,가능한,있을법한,적당한
feast : n,vt,ti,축제,축연,대접,즐거움,잔치를 베풀다,대접을 받다,즐기(게 하)다
feast day : x,축제일,연회일,잔칫날
feaster : n,a,
feat : n,위엄,공적,묘기
feather : n,vt,vi,깃털,깃으로 장식하다,깃털이 나다,날개처럼 움직이다
feather bed : x,깃털 침대(요),안락한 처지
featherbed : a,vt,vi,과잉 고용을 요구하는,과잉 고용으로 하다,정부 보조금으로 원조하다,응석을 받아주다
featherbedding : n,페더베딩(노동조합의 실업대책의 하나)
featherbed industry : x,정부의 보호 육성을 받는 산업
feather boa : x,여자용 깃털 목도리
featherbone : n,깃뼈
featherbrain : n,얼간이,바보
featherbrained : a,어리석은 경망스러운
feather duster : x,깃털 총채
feathered : a,깃털이 난(있는),깃이 달린,깃털 장식이 있는,깃 모양의,날개가 있는,날듯이 빠른
featheredge : n,vt,얇게 깎은 쪽의 가장자리,페더에지,아주 얇은 날
featheredged : a,얇게 깎은
featherfooted : a,소리 없이 잽싸게 움직이는
feather grass : x,나래새
featherhead : n,=featherbrain
featherheaded : a,
featheriness : n,깃털 모양,깃털처럼 가벼움,경박
feathering : n,깃털,깃,화살깃,깃털 모양의 것,깃털 같이 수북한 털,페터링
featherless : a,깃 털 없는
feather merchant : x,병역기피자,책임회피자,게으름뱅이
feather merchant : x,책임 회피자,병역 기피자,게이름뱅이
feather palm : x,깃 모양의 잎을 가진 야자수
featherpate : n,=featherbrain
featherpated : a,
feather star : x,바다 양치류
featherstitch : n,vt,페더스티치,페더스티치로 꾸미다
featherweight : n,페더급선수
feathery : a,깃이 난,깃털이 있는,깃털 같은(눈 등),가벼운,경박한
featly : ad,a,적절히,알맞게,솜씨있게,말끔하게,말쑥하게,우아한,품위있는,꼭맞는
feature : n,vt,얼굴의 일부,용모,특징,특집기사,특종,특징을 이루다,인기 거리로 내세우다
featured : a,특색으로 한,주요프로로 하는,..한 용모를 가진
feature film(picture) : x,장편 특작 영화
featurelength : a,장편의
featureless : a,특색이 없는,아무 재미 없는,평범한
feature size : x,최소 배선폭
feature story : x,특집 기사
featurette : n,단편 특작영화
feaze : n,vt,=feeze
Feb : n,February
FEBA : x,forward edge of the battle area(최)전선
febricity : n,열이 있는 상태
febrific : a,열이 나는,열이 있는
febrifugal : a,
febrifuge : n,해열제
febrile : a,열병의,발열의
febrility : n,발열
February : n,2월
February fill-dike : ,fill-dlike
FEC : x,Far Eastern Commission,Federal Election Commissin,Federal Exchange Commission,Freestanding Emergency Clini독립 단기 치료소
fec. : x,fecit
fecal : a,찌끼의,똥의
fecerunt : v,..등의 작(필,조각)
feces : n,배설물,찌꺼기
fecit : v,..작,..필,..서
feckless : a,쓸모없는,약하디약한
feculence : n,불결,오물
feculent : a,더러운,불결한
fecund : a,다산의,비옥한
fecundate : vt,많이 낳게(맺게)하다,비옥하게 하다,수태(수정)하다
fecundation : n,수태작용,수태,수정
fecundity : n,다산,생산력
fed : v,feed의 과거,과거분사
fed : n,연방 정부,연방 준비 은행,연방 수사관
fed : x,federal,federated,federation
fedayeen : n,아랍게릴라
Fedelism : a,
federacy : n,연합,동맹
federal : a,동맹의,연방의
Federal Butrsu of Investigation : x,연방 수사국
federal court : x,연방 법원
federal district : x,연방구
federales : n,연방 정부군
federal funds : x,연방 준비은행 준비금
federalism : n,연방주의(제도)
federalist : n,a,연방주의자(의)
federalistic : a,
Federal Republic of Germany : x,독일연방공화국
Federal Reserve Bank : x,연방 준비 은행
Federal Reserve Board : x,연방준비국
Federal Reserve System : x,연방준비제도
federate : vt,vi,a,연합시키다,연합한
federation : n,연합,동맹,연맹,연방 정부(제도)
federative : a,연합의
fedl : x,federal
fedn. : x,federation
fedora : n,중절모의 일종
fee : n,vt,보수,요금,행하,영지,상속재산(hold in fee 토지를 무조건으로 영유하다),요금을 치르다
fee,TV : n,유료 TV
fee-TV : n,유료 텔레비젼
feeb : n,겁많은 사람,바보,등신
feeble : a,약한
feebleminded : a,의지가 약한,저능한
feebleness : a,약한 듯한,힘 없어 보이는
feed : vt,vi,n,음식물을 주다,공급하다,만족시키다,기르다,먹이를 먹다,먹을 것을 줌,사료,식사공급,공급재료
feedback : n,a,피드백(출력에너지의 일부를 입력으로 되돌리는 조작),종합작용,반향,피드백의,재생의
feedback inhibition : x,피드백 저해
feed bag : x,꼴망태
feeder : ,먹는 사람(짐승),사육자,가축,사육자,여물통,모이통,젖병,턱받이,지류,배양수로,철도 지선,항공지선,지선 도로,급전선,궤전선,공급기(장치),급송장치,급광기,급수(급유)기
feederforward : n,피드포워드
feeder line : x,지선
feederliner : n,지선 운항 여객기
feedforservice : n,진료 때마다 하는 지불
feed grain : x,사료 곡물
feedin : ,무료 급식회
feeding bottle : x,젖병
feedlot : n,사육장
feed pipe : x,급수관
feed pipe : x,급수관
feed pump : x,급수 펌프
feedstock : n,(기계에의)공급원료
feedstore : n,사료 가게
feedstuff : n,사료
feefawfum : int,n,잡아 먹자,위협의 말,식인귀,도깨비
feel : vt,vi,n,느끼다,만지다,만져보다,생각하다,알아채다,~라는 느낌이 들다,동정하다,느낌,촉감
feeler : n,더듬이,촉각,촉모,촉수,떠보기,타진,만져보는 사람
feelgood : n,시름없는 행복한 상태,완전한 만족
feelie : n,감각 미술품
feeling : n,a,촉감,지각,느낌,감각,동정,흥분,감수성,느끼는,감각이 있는,다감한
feelingly : ad,감정을 넣어
feelthy : a,외설한
fee simple : x,무조건 토지 상속권,단순 봉토권
fee simple : x,무조건 토지 산속권,단순 봉토권
fee splitting : n,(의사,변호사가 환자,의뢰인을 소개해 준 동업자에게 주는)구전
feet : n,FOOT의 복수
feet of clay : n,감춰진 약점,숨겨진 결점
feeze : vt,vi,n,징계하다,쫓아내다,겁주다,동요하게 하다,안달하다,마음 졸이다,격돌,놀람,동요,흥분
feign : vt,vi,겉으로꾸미다,(구실 따위를)만들어내다,짐짓~인 체하다
feigned : a,거짓의,허위의,꾸민,가공의
feignedly : ad,꾸며서,가장하여
feint : n,vt,가장,가장하다,(권투,배구 등에서)치는 시늉하다
feint : a,가늘고 색이 엷은
feist : n,잡종 강아지
feisty : a,잡종 강아지 같은,성마른,공격적인,허세부리는,교만한
felafel : n,=FALAFEL
feldspar : n,장석
feldspathic : a,장석의,장석을 함유한
Felicia : n,여자이름
felicific : a,행복을 가져오는,행복하게 하는,행복을 가치 기준으로 하는
felicitate : vt,n,축하하다,축하,축사
felicitous : a,적절한,표현이 교묘한
felicitously : ad,
felicitousness : ,n
felicity : n,경사,행복,지복,교묘함,적절한 표현
felid : a,n,고양이과의(동물)
feline : a,n,고양이과의,고양이과의 동물,고양이 같은
felinely : ad,
felinity : n,고양이 성질,교활,잔인,음흉
Felix : n,남자 이름
fell : v,n,vt,a,fall의과거,벌채(하다),(사람을)쳐서 넘어 뜨리다,공그르기(하다)
fella : n,남자,놈
fellah : n,농부
fellate : vi,vt,..에 펠라티오하다
fellatio : n,음경에의 구강성교
feller : n,벌채자,벌목기,공그르는 사람,공그르는 기구
feller : n,=FEELOW
fellmonger : n,모피의 털 뽑는 직공,수피(모피)상,양피상
felloe : n,(수레바퀴의)테
fellow : n,동무,동지,동료,일원,한 쪽,놈,자식,애인,평의원
fellow creature : x,동포,같은인간
fellow feeling : x,동정,공감
fellowman : n,동포
fellow servant : x,동료 고용인
fellowship : n,친구,우정,친교,교우,단체,조합,특별연구원의 지위
fellow traveller : x,길동무,(정당의)후원자,(특히 공산당의)동조자
felly : n,겉 테(차 바퀴의)
felly : ad,맹렬히,잔인하게
Felm. : x,Flemish
felodese : n,자살자,자살
felon : n,a,중죄인,흉악한,잔인한,표저
felonious : a,중죄(범)의,극악한,흉악한
felonry : n,중죄 범인,죄수단
felony : n,중죄
felsite : n,규장석
felsitic : a,
felspar : n,=FELD SPAR
felstone : n,=FELSITE
felt : v,n,a,feel의과거(분사),펠트(의)
felting : n,펠트 제법,펠트 감,모전류,펠트 제품
feltip(ped) pen : x,펠트펜
felucca : n,펠러커 배
FeLV : n,feline leukemia virus고양이 백혈병 바이러스
fem : a,여자같은,여성적인,여자의,여성의
fem : x,female,feminine
female : n,a,여성(의),암(의)
female impersonator : x,여장 남우
female suffrage : x,=WOMAN SUFFRAGE
femcee : n,여성 사회자
feme : n,여성,처
feme covert : x,기혼부인
feme covert : x,기혼 부인,유부녀
feme sole : x,독신여성,독립부인(법률상 남편과 독립된 재산이 있는 부인)
feme sole : x,미혼 부인,독립부인
femiminity : n,여자다움,계집애 같음,여성
feminacy : n,여자다운 성질,여자다움
feminal : a,여자다운
feminality : n,여성다움,여자의 특성
femineity : n,여성다움
feminiism : n,연약한 경향,여자 특유의 말씨
feminine : a,여성의,여자다운
feminine ending : x,여성 행말,여성 어미
feminine rhyme : x,여성 휴지,여성운
feminism : n,여성 신장론,남녀 동권주의
feminist : n,a,여권 주장자,여권 확장론자,페미니스트
feministic : a,
feminity : n,=FEMININITY
feminization : n,여성화
feminize : vt,(남자를)여성화하다,여성적으로 하다,유약하게 하다,암컷화하다
Fem Lib : x,=WOMAN'S LIB
femme : n,여자,아내,동성애의 여자역
femme de chambre : n,시녀,룸메이드
femme fatale : n,요부
femoral : a,대퇴부의
femto- : x,(10조분의 1)의 뜻
femtometer : n,펨토 미터
femur : n,대퇴골
fen : n,소택지,지대
fen : n,=fain
fen : n,펜(중공의 화폐단위)
fenagle : vi,vt,=FINAGLE
fenberry : n,=CRANBERRY
fence : n,vt,vi,펜싱,검술,울타리,담,변론의 교묘함,장물 취득인,울타리를 하다,방어하다,검술을 하다,담을 뛰어넘다
fence buster : x,장타자,강타자
fenceless : a,울이 없는,무방비의
fencemending : n,관계회복,기반 굳히기
fence month : x,금렵기
fencer : n,검색
fencesitter : n,형세를 관망하는 사람,중립적 태도를 취하는 사람,기회주의자
fencesitting : a,형세 관망(의),중립(의)
fencible : a,n,막을 수 있는,국방병
fencing : n,펜싱,겁술,담의 재료
fend : vt,vi,막다 ,저항하다(fend off 피하다,받아넘기다,fend for oneself 자할하다,혼자꾸려 나가다)
fender : n,완충물,자동차의 흙받기,전차의 완충기
fender beam : x,방현재
fender bender : x,자도차 사고
fender stool : x,발 얹는 판
fenestella : n,작은 창문,작은 창문 모양의 벽장
fenestra : n,천공,명반,들여다 보는 창 같은 구멍
fenestral : a,
fenestrate : a,창문이 있는,창문 모양의 작은 구멍이 있는
fenestration : n,창문 내기,창문 모양의 구명이 있음,천공(술)
fen fire : x,도깨비불
fenfluramin : n,펜플루라민
fenian : n,a,페니아 회원
fenianism : n,
fenitrothion : n,페니트로티온(사과 등 과수용 살충제
fenks : n,고래 기름의 찌꺼지
fenland : n,습지,소택지
fenman : n,소택 지방 사람
fennec : n,(아프리카산의)귀가 긴 여우의 일종
fennel : n,회향풀
fennelflower : n,니겔
fennel oil : x,회향유
fenny : a,소택성의,이많은
fenreeve : n,소택 지방 감독관
fenrunners : n,소택 지방에서 쓰는 스케이트
fens : v,=fain
fentanyl : n,펜타닐
fenthion : n,펜티온(살충제)
fenugreek : n,호로파(콩과식물)
feoff : n,vt,봉토,영지,..에게 영지를 주다
feoffee : n,=FEOFFPR
FEPC : x,Fair Employment Practices Committee적성 고용 실시 위원회
feracious : a,다산의
feracity : n,비옥,다산
ferae naturae : a,야생의,야생 상태의
feral : a,야성의,흉포한
ferberite : n,철중석
ferdelance : n,큰 삼각머리독사
Ferdinand : n,남자이름
feretory : n,사리용기
Fergus : n,남자 이름
feria : n,축제일
ferial : a,평일의,휴일의
ferine : a,=FERAL
feringhee,Feringi : n,유럽 사람,인도인과 혼혈의 포르투갈 사람
ferity : n,야생(상태),흉포
Fermanagh : n,퍼매너
fermata : n,연음,늘임표
ferment : n,vt,vi,효소,발효,흥분,동란,발효시키다,대소동을 벌이(게 하)다
fermentation : n,발효,흥분,동란
fermi : n,페르미(10조분의1인치)
fermiology : n,페르미올로지
fermion : n,페르미 입자,페르미온
fermium : n,페르뮴(방사성 원소)
fern : n,양치류
Fernanda : n,여자 이름
fernbracken : n,양치 식물의 덤불
fernery : n,양치식물의 재배지
fern owl : n,쏙독새
fern seed : x,양치의 포자
ferny : a,양치가 무성한,양치 모양의
ferocious : a,사나운 ,잔인한,흉악한
ferocity : n,잔인성,광포한 행동
ferox : n,스코틀랜드 호수에서 나는 큰 송어
ferrate : n,철산염
ferredoxin : n,페레독신
ferreous : a,철의,철색의,철분을 함유한
ferret : n,vt,vi,흰족제비,흰족제비로 사냥을 하다,찾아내다
ferrety : a,흰족제비 같은,교활한
ferriage : n,도선(업),도선료,나룻배 삯
ferric : a,철의,제2철의
ferric chloride : x,염화 제2철
ferricferous : a,철이 나는,철을 함유한
ferric oxide : x,산화 제2철
ferric sulfate : x,황산 제2철
ferrimagnetism : n,페리 자성
Ferriswheel : n,페리스식 회전관람차
ferrite : n,페라이트
ferroalloy : n,합금철
ferrocalcite : n,함철 방해석
ferrochrome : n,=FERROCHROMIUM
ferrochromium : n,크롬철,페로크롬
ferroconcrete : n,철근콘크리트
ferromaganese : n,망간철,페로망간
ferromagnesian : n,철고토질의,철고토질광물
ferromagnet : n,강자성체의 자석
ferromagnetic : a,n,강자성의,강자성체
ferromagnetism : n,강자성
ferromagnetism : n,강자성
ferropseudobrookite : n,철위판 티탄석
ferrosilicon : n,규소철,페로실리콘
ferrosilicon : n,규소철,페로실리콘
ferrotungsten : n,텅스텐철,페로실리콘
ferrotungsten : n,텅스텐철
ferrotype : n,vt,페로타이프,광택사진,페로타이프에 걸다
ferrotype plate : x,페로타이프판
ferrous : a,철의,제1철의
ferrous chloride : x,염화 제1철
ferrous oxide : x,산화 제1철
ferrous sulfate : x,황산 제1철
ferruginous : a,철의,철같은,철을 포함한,쇠녹빛의
ferrule : n,(지팡이따위의)물미
ferry : n,vt,나루터,나룻배,도선업,항공수송,자력현지수송,도선하다,공수하다
ferryage : n,=FERRIAGE
ferryboat : n,나룻배,연락선
ferry bridge : x,열차운반용 연락선,나룻배 승강용 배다리
ferryman : n,나룻배 사공,도선업자
ferry pilot : x,현지 수송 조종사
ferry steamer : x,연락 기선
fertile : a,비옥한,다산하는,풍부한,번식력이 있는
Fertile Crescent : x,비옥한,초승달지대
fertility : n,비옥,다산,풍요
fertilizable : a,비옥하게 할 수 있는,수정(수태)가능한
fertilization : vt,비옥화,수정(현상)
fertilize : vt,비옥하게 하다,풍부하게 하다,수정시키다
fertilizer : n,비료
fertillity drug : x,임신 촉진제
fertillity pill : x,배란 유발형 피임정
ferula : n,아위속,=FERULE
ferule : n,vt,(벌로 어린이의 손바닥을 때리기위한)매,손 때리는 매로 때리다
fervency : n,열렬,열성,열정
fervent : a,뜨거운,강렬한,열렬한
fervid : a,=fervent
fervidity : n,열렬,열심
fervor : n,열렬,열정,백열
fescue : n,김의털(목초),중대(가로띠무늬)
fess : n,중대(가로띠무늬)
festa : n,축일,휴일,잔치
festal : a,축제의,명랑한
fester : vi,vt,n,곪다,곪게하다,진무르(게 하)다,괴로워하다,괴롭히다,화농상태
festina lente : x,천천히 서둘러라,급하면 돌아가라
festinate : a,vi,vt,급속한,성급한,몹시 빨라지다,병적으로 빨라지다
festination : n,빨라짐,가속,가속 보행
festival : n,a,축제(일),축제소동,(정기적인)행사,축제의
festive : a,축제의,즐거운,명랑한
festivity : n,축제,제전,경축,행사,잔치,축제,소동,잔치 기분,축제 분위기
festoon : n,vt,꽃줄,꽃줄로 장식하다,꽃줄로 만들다
festoonery : n,꽃줄(장식)
Festschrift : n,기념 논문집
FET : x,field effect transistor
fetal : a,태아의
fetal hemoglobin : x,태아성 혈색소,태아성 헤모글로빈
fetalization : n,태형 보유
fetal position : x,태아형 자세
fetationo : n,태아 형성,임신
fetch : vt,vi,가져오다,불러오다,오게하다,(탄식,신음소리를)내다,팔리다,(타격을)가하다,물건을가져오다,도달하다
fetcher : n,가져오는 사람
fetching : a,매혹하는,사람의 눈을 끄는
fete : n,vt,축제,축연,잔치를 베풀어 축하하다,환대하다
fete champetre : n,야외의 축제,원유회
fete day : x,축일,축제일
fetial : a,국제 문제를 다루는,선전 포고(화평)에 관한,외교의
fetich : n,=FETISH
feticide : n,태아살해,낙태
fetid : a,악취를 풍기는
fetiparous : a,미숙한 새끼를 낳는(동물)
fetish : n,물신(미개인이 숭배하는 나뭇 조각,돌따위)
fetism : n,물신 숭배,페티시즘(이성의 몸의 일부나 의복등에서 성적 만족을 얻는 변태 심리)
fetistic : a,물신 숭배의,미신적인
fetlock : n,거모(말굽 뒤쪽위의 텁수룩한 털),구절(말굽 뒤의 털이 난 곳)
fetology : n,태아학
fetoprotein : n,태아단백질
fetoscope : n,태아경
fetoscopy : n,태아검사경
fetter : n,vt,차꼬,차꼬를 채우사,속박하다
fetterless : a,족쇄(속박)가 없는
fetterlock : n,D자 꼴의 족쇄
fettle : n,심신의 상태(fine fettle 원기 왕성하여)
fettuccini : n,가는 끈 모양의 파스타,이것을 주재료로 하는 요리
fettuccini (all) Alfredo : x,페투치니를 버터,치즈,크림에 버무려서 맛을 낸 요리
fetus : n,태아
feu : n,영대 조차(지),영지,봉토,영대 조차자
feud : n,불화,반목,싸움,영지(be at feud with ...,와 반목하고 있다)
feudal : a,영지(봉토)의,봉건(제도)의
feudalism : n,봉건 제도
feudalismist : n,봉건제 주장자
feudalistic : a,봉건 제도(주의)의
feudality : n,봉건제도,봉건주의,영지,봉토
feudalization : n,봉건화
feudalize : vt,..에 봉건 제도를 실시하다,봉건화하다
feudal lord : x,영주
feudally : ad,봉건적으로
feudal system : x,봉건 제도
feudatory : a,n,봉건의,가신의,가신,영지
feudist : n,앙숙으로 다투는 사람
feudist : n,봉건법 학자
feuilleton : n,문예란
Feulgen reaction : x,포일겐(핵염색)반응
fever : n,vt,열,열병,열광,발열시키다
fever : a,열이 있는,열병의,열광적인
fever blister : x,단순 헤르페스
fevered : a,열이 있는,열병에 걸린,몹시 흥분한
feverfew : n,화란국화
fever heat : x,(섭씨37도를넘는)신열,열광적 흥분
feverish : a,열이 있는,열띤,열병의,열병이 많은,열광적인
feverous : a,=FEVERISH
fever pitch : x,병적 흥분,열광
fever therapy : x,발열요법
fever therapy : x,발열 요법
few : n,a,(a를 붙이지 않는 경우)적은,별로없는
fewer : n,보다 소수의
fewness : n,소수,근소,약간
Feynman diagam : x,파인만 도표
fez : n,페즈모,터키모
ff : x,fortissimo
FF : n,(군대 신체 검사의) 불합격자,허약자
ff. : x,folios,(and the) following (pages),and what follows
FFA,F.F.A. : x,Fellow of the Faculty of Actuaries (Scotland),Future Farmers of America
F factor : x,F인자,염성인자
FH'er : n,4H 클럽회원
FHA : x,Federal Housing Administration연방 주택 관리국
FI : x,for instance
FI : n,fluorine
fi.fa. : x,=FIERI FACIAS
fiacre : n,소형 4륜 합승 마차
fiance : n,약혼자
fiancee : n,약혼녀
fiasco : n,큰 실수
fiat : n,명령,엄명,인가,허가
Fiat,F.I.A.T. : n,피아트 회사제 자동차
fiat money : x,법정 불환 지폐
fib : n,vi,vt,거짓말,거짓말을 하다,(복싱 따위에)타격을 주다
fib : vt,n,치다,일격
FIBA : x,Federation Internationale Basketball Amateur국제 아마추어 농구 연맹
fibber : n,하찮은 거짓말을 하는 사람
fiber : n,섬유질,단섬유,성격,수염뿌리
fiber art : x,파이버아트
fiberboard : n,섬유판
fibered : a,섬유질의,..의 섬유로 된,..한 기질의
fiberfill : n,인조 섬유 솜
Fiberglas : n,=FIBERGLASS
fiberglass : n,섬유유리(절연체,직물용)
fiber optics : x,섬유 광학(유리나 플라스틱 섬유관을 통하여 광상을 굴절시켜 전달하는 기술)
fiberscope : n,파이버스코프(유리섬유에 의한 내시경)
fibertip : n,펠트펜
fibriform : a,섬유 모양의
fibril : n,소(원)섬유,근모,수염뿌리
fibrillar : a,
fibrillary : a,(소)섬유의,근모의,원섬유(성)의
fibrillate : a,가는 섬유가 있는
fibrillation : n,섬유성 연축
fibrin : n,섬유소
fibrinogen : n,브리노겐,섬유소원
fibrinous : a,섬유소(성)의
fibroblast : n,섬유아세포
fibrocement : n,석면 시멘트
fibrogenesis : n,섬유 성장
fibroid : a,n,섬유질의,섬유모양의,섬유종
fibroin : n,피브로인(경단백질의일종)
fibroma : n,섬유종
fibrosis : n,섬유증,섬유형성
fibrositis : n,결합 조직염
fibrous : a,섬유질의
fibrous root : x,실뿌리
fibrovascular : a,유관속의
fibster : n,하찮은 거짓말을 하는 사람
fibula : n,비골
fibular : a,비골(부)의
FICA : x,Federal Insurance Contribution Act
fical stamp : x,수입 인지
fice : n,=FEIST
fiche : n,마이크로피시(정보정리용의 마이크로카드나 필름)
Fichte : n,피히테
fichu : n,(삼각형의)숄
fickle : a,(기후,기분따위가)변덕스러운
fiction : n,소설,꾸민 이야기,꾸며낸 것,허구,상상,의제,가설
fictional : ad,꾸며낸,허구의,소설의,소설적인
fictionalize : vt,소설화하다,각색(윤색)하다
fictionally : ad,
fictioneer : n,다작(양산)하는 (2류)작가
fiction executive : x,편집장
fictionist : n,창작자,소설가
fictitious : a,가공의,거짓의,의제의(fictitious capitaldmlwp wkqhs,fictitious person 법인)
fictitious bill(paper) : x,공어음
fictitious person : x,법인
fictitious transaction : x,공거래
fictive : a,상상의,가공적인,꾸며낸
fid : n,버팀대,고정재,쐐기 모양의 꼭지,돛대 버팀목,원추꼴의 나무못,두꺼운 조각
fid. : x,fiduciary
fid. : n,fluid,field
Fid.Def. : x,Fidei Defensor
fiddle : n,=VIOLIN(hang up one's fiddle when one comes home 밖에서는 명랑하고 집에서는 침울하다)
fiddle : n,vt,vi,바이올린,바이올린을 켜다,농락하다,시간을 헛되이 보내다,빈들빈들 보내다,속이다
fiddleback : n,a,등이 바이올린 모양의 의자,바이올린 꼴의,가는 줄이 있는
fiddle bow : x,바이올린의 활
fiddle case : x,바이올린 케이스
fiddlede(e)dee : int,당찮은!,엉터리!,시시해!
fiddlefaddle : n,vi,int,부질없는 일,하찮은 일을 하다,시시하다,어이없다,부질없다
fiddlehead : n,이물 양족의 소용돌이 꼴 장식
fiddle pattern : x,소용돌이 꼴 장식
fiddler : n,바이올린켜는 사람
Fiddler's Green : x,여자와 술과 노래가 있는 뱃사람의 낙원(뱃사람 기병이 죽은 후에 간다고 생각된)
fiddlestick : n,바이올린의 활,하찮은 일
fiddlesticks : int,어처구니 없다,시시하다
fiddling : a,하찮은,헛된,사소한,다루기 곤란한,귀찮은
fiddly : a,다루기 힘든,품(시간)이 드는,귀찮은,지겨운(일)
Fidei Defensor : n,신앙의 옹호자
fideism : n,신앙주의
fideismist : n,
fideistic : a,
Fidelia : n,여자이름
Fidelismo : n,카스트로주의(운동)
Fidelista : n,a,카스트로주의자
fidelity : n,충실,(약속의)엄수,(묘사의)정확함,충실도(high fidelity 고충실도)
fidelity insurance : x,신용 보험
fidget : vi,vt,n,싱숭생숭 하다,마음졸이(게 하)다,싱숭생숭함(have the fidgets 싱숭생숭하다)
fidgetiness : n,
fidgety : a,안절부절 못하는,조바심하는,불안한,안달하는,까다로운
fidibus : n,불붙이는 종이심지
FIDO : n,파이도
FIDO,Fido : n,우주선 조종관(조종기사)
fiducial : a,기점의,기준의,신앙에 바탕을 둔,믿어 의심치 않는,신탁의
fiducially : ad,
fiduciarily : ad,
fiduciary : a,n,신용의,신탁의,수탁자의,신용발행의,수탁자
fiduciary bond : x,수탁자 보증
fiduciary issue : x,보증 발행
fidus Achates : n,충실한 아카테스
fie : int,체!,에잇!
fiedl night : x,중요 사건 토의(의 날)
fief : n,영지,봉토
fiefie : a,그릇된,언어도단의
FIEJ : x,Federation internationale des editeurs de journaux et publications국제 신문 발행인 협회
field : n,들,벌판,밭,광장,표면,산지,싸움터,경기장,내(외)야,분야,바탕,영상면(coal field 탄전)
field allowance : x,출정 수당
field amvulance : x,이동야전병원
field army : x,야전군
field artillery : x,야포,야전포병
field bag : x,=MUSETTE (BAG)
field battery : x,야포대,야전포병 중대
field book : x,측량자의 야외 수첩,채집 메모장
field boot : x,무릎까지 오는 군화
field capacity : x,농포 용수량
field captain : x,주장 선수
field club : x,야외 자연 연구회
field coil : x,계자코일
field colors : x,야영기
field corn : x,옥수수
fieldcornet : n,하급 지방 행정관
field court : x,약식 군법 회의
field day : x,야외 연구일,채집일,특별한 생사가 있는 날
field dog : x,사냥개
field dressing : x,응급 치료
field driver : x,주인 불명의 가축류를 몰수하는 관리
fieldeffect : a,전계 효과의,전계 효과를 이용한
fieldeffect transistor : x,전계 효과 트랜지스터
field emission : x,전계 방출(방사)
fielder : n,야수,외야수
fielder's choice : x,야수선택,야선
field event : x,필드 경기
field exercise : x,기동 연습
fieldfare : n,개똥지빠귀의 일종
field glass : x,쌍안경
field goal : x,필드에서 킥하여 얻는 3점,필드로부터의 골
field grads : x,영관급
field gray : x,암회색,군복,독일병
field gun : x,야포
field hand : x,농장 노동자
field hockey : x,육상 하키
field hospital : x,야전 병원
field house : x,경기장의 부속 건물,실내경기장
field ice : x,빙원,야빙
fielding : n,수비
fielding average : x,수비율
field intensity : x,장의 세기,전계의 강도
field ion microscope : x,이온 방사 현미경,전계 이온 현미경
field jacket : x,야전용 재킷
field judge : x,필드 심판
field kitchen : x,야외(야전)취사장
field lacrosse : x,라크로스
field lark : x,=MEADOWLARK
field length : x,이착륙 활주 거리
field lens : x,대물 렌즈,시역 렌즈
field line : x,힘의 선
field magnet : x,계자,장자석
Field Marshal : x,육군 원수
field method : x,야외 연구법
field mouse : x,들쥐
field music : x,군악대(군악 대용)행진곡
field officer : x,육군의 영관급 장교
fieldpiece : x,야포
field preacher : x,야외 전도사(설교사)
Field prize : x,필드상
field punishment : x,전지 형벌
field ration : x,야전양식
field recording : x,현지 녹음
field secretary : x,외근 직원,지방 연락원
field service : x,야전근무
fieldsman : n,야수
field sports : x,야외 운동,유렵,필드 경기 종목
field stone : n,자연석
field strength : x,장의 세기,전계 강도
field strip : vt,보통 분해하다,까고 비벼서 버리다
field study : x,=FIELDWORK
fieldtest : vt,실지 시험하다
field theory : x,장론,장의 이론
field trip : x,실지 연구 여행
field umpire : x,누심
fieldward(s) : ad,들 쪽에,들 쪽으로
field winding : x,계자 권선
fieldwork : n,부루,현지(실지)조사,현장 견학(답사)연구,야외 채집,현장방문
fieldworker : n,FIELDWORK를 하는 과학자,기술자,학생(등)
fiend : n,악마,악령,잔인한사람,~중독자,~광
fiendish : a,악마(귀신)같은,마성의,극악한,공력이 드는,교묘한,몹시 불쾌한,매우 어려운,대단한
fiendishly : ad,
fiendishness : n,
fiendlike : a,
fierce : a,흉포한,사나운,맹렬한,열렬한,싫은,지독한
fiercely : ad,사납게,맹렬하게,지독하게
fierceness : n,사나움,맹렬
fierifacias : n,강제 집행 영장
fierily : ad,불같이,열렬히,격렬히
fiery : a,불의,불같은,불빛의,불타고있는,작열하는,열렬한,격하기 쉬운,염증을 일으킨
fiery cross : x,혈화의 십자가,불의 십자
fiesta : n,축제,휴일
fife : n,vi,vt,저(를불다)
fifer : n,저 부는사람
fife rail : x,큰 돛대의 밧줄 매는 난간
fifo : n,선입선출법
fifteen : n,a,15(의)
fifth : n,a,제5(의),5분의1(의)
Fifth Amendment : x,헌법 수정 제5조
Fifth Avenue : x,5번가
fifth column : x,제5열
fifth columnist : x,제5열분자,제5부대원,배반자
Fifth Estate : x,제5계급
fifth generation computer : x,제5세대 컴퓨터
fifthly : ad,
Fifth Monarchy : x,제5왕국
Fifth Republic : x,제5공화국
fifth wheel : x,전향륜,예비바퀴,좀처럼 쓰지 않는 것,무용지물
fiftieth : a,n,pron,제50의,50번재의,50분의1의
fifty : n,a,50(의)
fiftyfifty : ad,a,절반씩(의),반반으로
fiftyfold : ,50배의(로)
fig : n,무화과,조금,하찮은 것
figaro : n,피가로
figeater : n,아메리카 꽃풍뎅이
fight : n,vt,vi,전투,다툼,전투력,투지(gve a fight 일전을 벌이다)싸우다,싸워얻다,싸우게하다,지휘하다,움직이다
fightback : n,반격,반공
fighter : n,싸우는 사람,투사,권투선수,전투기
fighterbomber : n,전투 폭격기
fighterinterceptor : n,전투 요격기
fighting chair : x,갑판에 고정시킨 회전 의자
fighting chance : x,크게 노력해야만 얻어질 성공의 가능성(기회),희박한 가는성
fighting cock : x,투계,쌈닭,싸움을 좋아하는 사람
fightingdrunck : a,술김에 싸우려 드는
fightingfit : a,전투 능력 있는
Fighting French : x,싸우는 프랑스인
fighting mad : x,격노한,격앙된
fighting top : x,전함 돛대 위의 둥근 포상
fighting words : x,도전적인(트집잡는)말
fightorfight reaction : x,방위 반응의 일종
fighttest : vt,(항공기,비행 장치의) 비행 시험을 하다
fightworthy : a,안전 비행 가능 상태의,내공성의
fig leaf : x,무화과 잎사귀,악취나는 것을 덮는 뚜껑
figment : n,꾸며낸 일
fignting : n,싸움,전투
fig tree : x,무화과나무
figural : a,수식적인,인간이나 동물의 형상을 주로 한
figurant : n,발레댄서
figurante : n,FIGURANT의 여성형
figuration : n,성형,모양,장식
figurative : a,비유적인,수식적인,상징적인,조형의(figurafive arts 조형 미술)
figuratively : a,비유적으로,전의적으로,상징적으로
figure : n,vt,vi,모양,모습,초상,외관,풍채,인물,상징,도면,도안,도해,숫자,자릿수,피겨스케이트,도형
figured : a,모양으로 나타낸,무늬 있는
figured bass : x,통주 저음,숫자 붙은 저음
figure eight : x,8자 모양의 도형,8자형 비행,8자형 매듭
figurehead : n,이물장식,표면상의 명목,명목상의 우두머리,사람의 얼굴
figurer : n,본으로 도기에 무늬를 박는 사람
figure skate : x,피겨 스케이트화
figure skating : x,피겨스케이트
figure skating : x,피겨 스케이트
figurine : n,작은조상,주상
figwort : n,현삼과의 식물
Fijian : a,n,피지 제도의
Fiji Islands : x,피지 군도(태평양  남부의 322개의 작은 섬으로 된 군도)
Fiji islands : n,피지 제도
filagree : n,a,vt,=FILIGREE
filament : n,섬유,꽃실,필라멘트
filamentary : a,섬사의,섬유 모양의,꽃실(모양)의
filamentous : a,실 모양의,섬질의
filamentous virus : x,섬사상 바이러스
filar : a,실(선)의,실(선)이 있는,실모양의
filaria : n,필라리아,사상충
filarial : a,사상충의,사상충 감염에 의한,사상충을 지닌
filarially : ad,
filarialness : n,
filariasis : n,필라리아병
filate : a,실의,실로 된,실 모양의
filature : n,(누에고치에서)실뽑기,물레,제사공장
filbert : n,개암나무
filch : vt,vi,좀도둑질하다
filcher : n,도둑
file : n,vt,서류철,철하기,파일,정리카드,목록,명부,철하다,퇴고하다
file clerk : x,무서 정리원
filefish : n,쥐치의 일종
filemot : a,n,마른 잎 빛깔(의),황갈색(의)
file name : x,파일명
file photo : x,보관(자료)사진
filepunch : n,철하기 위해 구멍 뚫는 기구,파일용 펀치
filer : n,문서 정리원
filet : n,등심살,망사레이스
filet mignon : n,소의 두터운 허리 고기,필레 살
filial : a,자식으로서의
filiale : n,자회사
filial generation : x,후대
filiate : vt,=AFFILIATE
filiation : n,자식임,친자관계,계통,유래,분파,분기,파생,사생아 인지
filibeg : ,=KILT
filibuster : n,vi,vt,해적,약탈병,약탈하다,해적 행위를 하다,의사를 방해하다
filibusterism : n,의사 진행 방해(연설)
filicide : n,자식살해,자식살해범
filiciform : a,양치꼴의
filicite : n,양치류의 화석
filicoid : a,n,고사리 모양의
filiform : a,실(섬유)모양의
filigree : n,가는줄세공,섬세한 물건
filigreed : a,=FILIGREE
filing : n,철하기,서류정리
filing cabinet : x,서류 정리용 캐비닛
filing clerk : x,문서 정리원
filings : n,줄밥
Filipine : a,=PHILIPPINE
Filipino : n,필리핀 사람
fill : vt,vi,n,채우다,(지위를)차지하다,보충하다,가득차다,충분,가득참
filldike : n,(2월의)눈석임
fillebeg : n,=KILT
filled gold : x,피복용 금
filled milk : x,치환유
filler : n,채우는 사람(물건),메우는 사람(물건),주입기,충전기,깔때기,여백을 메우는기사,단편영화,채우는 것,메우는 나무,충전재
filler cap : x,연료 주입구 뚜껑(캡)
fillet : n,vt,리본,가는 띠,등심살,저민고기,윤곽선,리본으로 매다,장식하다,(생선을)저미다
fillin : n,대리,보결,빈 자리를 메우는 사람,대용품,여백을 메우는 기사,개요 설명,기입
filling : n,충전
filling station : x,주유소
fillip : vt,n,손가락으로 튀기다,튀기기,자극(을 주다),원기를 북돋우다
fillister : n,개탕 대패,개탕으로 파낸 홈
Fillmore : n,필모어
filly : n,암망아지,말괄량이
film : n,vt,vi,필름,얇은 껍질,영화,가는실,엷은 안개,흐림,얇은 껍질로 덮이다,촬영하다,영화화하다
filmable : a,영화에 적합한,필름에 담을 수 있는
filmcard : n,=FICHE
film clip : x,방송용 영화 필름
filmdom : n,영화계
filmgoer : n,자주 영화 구경 가는 사람,영화팬
filmic : a,영화의,영화 같은
filmically : ad,
filmize : vt,영화화하다
filmland : n,영화계
filmlet : x,단편 영화,소영화
film library : x,영화 도서관,필름 대출소
filmmaker : n,영화 제작자,영화 회사
filmmaking : n,영화 제작
filmmy : a,엷은 껍질(모양)의,엷은 막(모양)의,아주 엷은,가는 실 같은,엷은 안개 같은,흐린
filmography : n,특정 배우,감독의 작품 리스트,영화 관계 문헌
film pack : x,필름팩,갑에 든 필름
film premiere : x,특별 개봉
film projector : x,영사기
film rating : x,관객 연령 제한(표시)
filmscript : n,영화 각본,시나리오
filmset : a,vt,n,사진 식자의,사진 식자하다,영화 촬영용 세트
filmsetting : n,사진 식자,사식
filmslide : n,슬라이드
film star : x,영화 스타
film stock : x,미 사용의 영화 필름
filmstrip : n,영사 슬라이드
film studio : x,영화 촬영소
film test : x,영화 배우 지망자의 카메라 테스트
filose : a,실 모양의,끝이 실 같은
filoselle : n,플솜,풀솜으로 만든 자수실
fils : n,아들 뒤마
filter : n,vi,vt,여과기,여과재,필터,거르다,여과하다,스미다,배다,새다
filterable : a,여과할 수 있는
filterable virus : x,여과성 바이러스(병원체)
filter bed : x,여과성,여과지,물 거르는 탱크
filter center : x,대공 정보 존부,정보 심사소
filter cigarette : x,필터 담배
filter paper : x,여과지
filter press : x,압착식 여과기,생선 기름 짜는 기계
filter sign : x,직진 차량이 정지하는 사이에
filter tip : x,필터(담배)
filtertipped : a,필터 달린
filth : n,오물,외설,추잡(한 말)
filthin : n,항의 집회의 한 형태
filthy : a,더러운,추잡한
filthy lucre : x,부정한 돈,힘들이지 않고 번 돈,금전
filtrable : a,=FILTERABLE
filtrate : vt,vi,n,여과하다,여과
filtration : n,여과(작용)
filtration plant : x,정수장
filum : n,섬사조직,섬조,필라멘트
FIM : x,field interceptor missile야전용 방공 미사일
fimbria : n,술(털)달린 가장자리,주름모양의 돌기
fimbriate : a,술 모양으로 깊이 갈라진,술이 달린,가는 띠 모양의 선으로 두른
fin : n,지느러미,팔,손,발갈퀴
fin. : x,finem,finance,financial,finished
Fin. : x,Finland,Finish
Fin.Sec. : x,Financial Secretary
FINA : x,Federation Interatoinale de Natation Amateur국제 아마추어 수영 연맹
finable : a,과료(벌금)에 처할 수 있는
finagle : vt,잘 변통하다,속이다,속임수 쓰다,속여서 뺨앗다
final : a,n,최종의,결정적인,목적의,최후의 것,결승전,최종시험
final cause : x,목적인,궁극인
final drive : x,최종 구동 장치
finale : n,종악장,최후의 막,끝장,종국,대단원
finalist : n,결승전 출장선수
finality : n,최후적인,최종적인,결정적인,종국,결국,결말,최종적인 사물,최후의 언행
finalize : vt,완성하다,끝내다,..에 결말을 짓다,최종적으로 승인하다
finally : ad,최후로,마침내
final solution : x,최종적 해결
finance : n,vt,vi,재정,재원,자금을 공급하다,융자하다,재정을 처리하다
finance bill : x,재정 법안,금융어음
finance company : x,금융 회사
financial : a,재정상의
financial futures contract : x,금융 선물 거래
financial innovation : x,금융 혁신
financially : ad,재정적으로,재정상
financial market : x,금융 시장
financial service : x,투자 정보 서비스 기관
financial statement : x,재무 제표
financial year : x,회계(사업)연도
financier : n,재정가,금융업자,자본가
finback : n,큰고래
finch : n,피리새류
find : vt,vi,찾아내다,발견하다,우연히 만나다,알아차리다,깨닫다,확인하다,쓰이게하다,이르다,판정을 내리다,공급하
finder : n,발견자,(카메라의)파인더,조정 망원경
finder's fee : x,중개(인)수수료
finders keepers : x,먼저 발견한 사람의 승리,빠른 놈이 장땡
fin de siecle : x,19세기 말의,데카당파의
findspot : n,발견지(점),출토지(점)
fine : a,n,ad,vt,훌륭한,아름다운,맑게 갠,품위있는 고상한,가는,섬세한,예리한,고운,미세한,(금,은이)순도가 높은
fineable : a,=FINABLE
fine art : x,미술품,미술,예술
fine ceramics : x,파인 세라믹스
fine champagne : x,핀샹파뉴
fine chemical : x,정제 화학 제품,정약품
fine chemistry : x,부가가치 화학 제품에 관한 화학
fine cut : x,가늘게 썬 담배
finecut : a,가늘게 썬
finedraw : vt,솔기가 보이지 않게 꿰매다,감쪽같이 꿰매다,가늘게 늘이다
finedrawn : a,곱게 꿰맨,가늘게 늘인,정밀한
fine food : x,정밀 식품,고부가가치 식품
finegrained : a,결이고운
finely : ad,훌륭하게,아름답게,멋지게,미세하게,정교하게,세밀하게,잘게,가늘게
fineness : n,훌륭함,절묘,아름다움,우량,결의가늚,섬세함,분말도,순수도,순수,공차,섬세,세밀,예민함,정확함
fine print : x,작은 활자,작은 글자 부분
finery : n,아름다운 옷,미장,미복,훌륭함,화려
finery : n,정련로
fines : n,미세한 입자들,고운 가루
finespun : a,가늘게 자아낸,섬세한,지나치게 세밀한,지나치게 정밀하여 비실용적인
finesse : n,vt,vi,교묘한 처리,기교,솜씨,술책,책략,피네스
fine structure : x,미세구조
finetoothed comb : x,가늘고 촘촘한 빗
finetune : vt,미조정하다
finger : n,vt,vi,손가락,손가락 모양의 물건,손가락을 대다,만지다,탄주하다,켜다
finger alphabet : x,(농아용의)지문자
fingerboard : n,지판
finger bowl : x,(식탁의)손가락씻는 물그릇
fingerbreadth : n,지폭,손가락넓이
fingered : a,..손가락의,손가락이..인,손가락 자국이 난,손때가 묻은,손가락 모양의,운지 기호가 표시된
fingerfish : n,불가사리
finger food : x,손으로 집어 먹는 음식
fingerfuck : vt,vi,여성의 성기를 손으로 자극하다
finger glass : x,손가락 씻는 유리 그릇
finger hole : x,바람구멍,전화기의 다이얼구멍,볼링 공의 손가락 구멍
fingering : n,손가락으로 만지작거림,운지법,운지기호
fingering : n,가는 털실
finger language : x,지화
fingerling : n,작은 물고기
finger man : x,밀고자
finger mark : x,손가락 자국
fingermarked : a,손가락 자국이 있는,손가락 때가 묻은
fingermath : n,지산
fingernail : n,손톱
finger nut : x,=THUMB NUT
finger paint : x,젤리 모양의 지두화용 물감
finger painting : x,지두화법,손가락으로 그린 그림
fingerpeck : vt,손가락으로 토닥토닥 타자치다
finger plate : x,지판(손가락 자국이 나지 않게 문의 손잡이 주위에 댄 금속판
finger post : x,(손가락꼴의)길표
fingerprint : n,vt,지문,..의 지문을 채취하다
finger reading : x,점자독법
finger ring : x,반지
fingershaped : a,손가락 모양의
fingerstall : n,손가락 싸개,손가락 색
fingertight : a,손으로 단단히 죈
fingertip control : x,버튼 조종(장치)
fingertips : n,손끝
finger wave : x,손가라가 웨이브(기름 바른 머리르 손가락으로 눌러 만듦)
finial : n,정식
finialaled : a,
finical : a,꾀까다로운,지나치게 공들인,정교한
finically : ad,
finicky,finnicky : a,=FINICAL
finis : n,끝
finish : vt,vi,n,끝내다,완성하다,마무리하다,마무리칠을하다,해치우다,죽이다,먹어치우다,끝나다,끝,끝손질
finish : a,우수한,질이 좋은,가느다란,매우 섬세한
finisher : n,완성자,마무리하는 직공,마무리 기계,치명적 타격,결정적인 사건
finishing : a,n,최후의,끝손질의,마무리의
finishing school : x,여성의 교양완성 학교(일종의 신부학교)
finish line : x,결승선
finite : a,유한의,정형의
finite verb : x,정동사
finitude : n,유한성
fink : n,파업파괴꾼,밀고자
fin keel : x,철기 용골
finkout : n,탈퇴,발빼기,배신
Finland : n,피란드
Finlandization : n,핀란드화
Finlandize : vt,핀란드화하다,대소 유화정책을 취하게 하다
finn : n,핀란드 사람
finnan haddie : x,훈제한 대구의 일종
finnan haddock : x,=FINNAN HADDIE
finned : a,지느러미를 가진,..지느러미의
finner : n,=FINBACK
finnesko : n,피네스코
Finnic : a,핀족의,핀 말의
Finnish : n,a,핀란드(사람.말)의,핀족의,핀란드 말
Finno Ugrian : a,n,핀 사람과 우그리아 사람의
Finno Ugric : a,n,피노우그리아어족의
finny : a,지느러미있는
Finsen light : x,핀센광(램프)
FIO : x,free in and out
fiord : n,(노르웨이등의)협만,피오르드
fipple : n,관악기의 음향 조절 마개
fipple flute : x,음향 조절 마개가 달린 종적
fir : n,전나무,그 재목
fir cone : x,전나무 열매
fire : n,vt,vi,불,화롯불,모닥불,화재,광채,정열,열병,염증,시련,발사,점화,포화,불지르다,자극하다,흥분시키다
fire alarm : x,화재 경보,화재 경보기
fire ant : x,쏘는 개미
firearm : n,화기,소화기
fireback : n,난로의 뒷벽,꿩의 일종
fire ball : n,불덩어리,번개,,소이탄,화구,속구,지칠줄 모르는 정력가
fire baller : x,속구 투수
fire balloon : x,열기구,꽃불 기구
firebase : x,중포 기지
fire basket : x,쇠바구니
fire bell : x,화재 경종
fire belt : x,방화대
firebird : n,꾀꼬리의 일종
fire blast : x,고사병
fire blight : x,부란병
fire blocks : x,불에 의한 방색,화재 방색판
fireboat : n,소방선
fire bomb : x,소이탄
fire bomber : x,소화용 비행기
fire bowl : x,화로
firebrand : n,횃불,불붙은 관솔,불타는 나뭇 조각,선동자
firebreak : n,방화대,방화선
firebrick : n,내화벽돌
fire brigade : x,소방대,소방서,긴급출동부대
fire bucket : x,비상용 소화 양동이
fire bug : x,개똥벌레,방화광(범)
fire chief : x,소방서장,소방 부장
fire clay : x,내화점토
fire company : x,소방대,화재 보험 회사
fire control : x,사격지휘
fire control radar : x,화기 관제 레이더
firecracker : n,폭죽,딱총,폭탄,어뢰
fire cross : x,=FIERY CROSS
firecure : vt,담배를 모닥불 연기에 쐬어 건조 처리하다
firedamp : n,폭발성 메탄가스
fire department : x,소방국,소방서,소방대원
fire dog : x,=ANDIRON
fire door : x,연료 주입구,점화구,방화문
firedragon : n,불을 뿜는 용
firedrake : n,불을 뿜는 용
fire drill : x,소방연습
fireeater : n,불을 먹는 요술쟁이,싸우기 좋아하는 사람,객기 부리는 사람,열렬한 노예 제도 지지자
fireeating : a,n,혈기에 날뛰는,전투적인,불을 먹는 요술
fire engine : x,소방펌프,소방차
fire escape : x,비상구계단,피난 사다리
fire exit : x,비상구,화재 대피구
fire extinguisher : x,소화기
fireeyed : a,눈이 빛나는
fire fight : x,포격전
fire fighter : x,소방수
fire fighting : x,소방(활동)
firefly : n,개똥벌레
fire grate : x,난로의 쇠살대
fireguard : n,난로 울,방화 지대,화재 감시인
fire hook : x,(소방용)갈고랑장대
firehorse : n,소방용 호스
fire hose : x,소방용 호스
firehouse : n,소방 기구고,소방서
fire hunt : x,야간에 불을 켜고 하는 사람
fire hydrant : x,소화전
fire insurance : x,화재 보험
fire irons : x,난로용 철물
fire ladder : x,비상(소방)사닥다리
fireless : a,불이 없는,활기가 없는
fireless cooker : x,축열요리기
firelight : n,불빛,난로불의 빛
firelighter : n,불쏘시개
fire line : x,방화선,소방 시상선
firelock : n,화승총
fireman : n,소방수,소방대원,화부,구원투수
fire marshal : x,소방국장,방화관리자
firenew : a,신품의
Firenze : a,피렌체의
fire office : x,화재 보험 회사
fire opal : x,화단백석
firepan : n,부삽,화로
fire place : n,난로,벽난로,노상,난로 ,노변,야외(옥외)취사장
fire plug : x,소화전
fire policy : x,화재 보험 증서
firepot : n,화실,아궁이
firepower : n,화력,득점력,득점 행위
fire practice : x,소방 연습,방화 훈련
fireproof : a,vt,방화의,내화성의,불연성의,내화성으로 하다
fireproofing : n,내화성화,방화 시공,내화재료
firer : n,점화물,점화장치,발화기,총포,발화(발포)자,방화자
fireraising : n,방화죄
fire reel : x,소방(자동)차
fire resistant : a,내화성의
fire resitstance : x,내화성(도)
fire retaradant : n,a,방화 재료,방화 효력이 있는,연소 방지의
fireretarded : a,방화 재료로 보호된
fire rist : x,화재 위험(이 있는것)
fireroom : n,가관실,보일러실
fire sale : x,타다남은 물품특매
firesale price : x,특가,싼 값
fire screen : x,(난로용)화열방지 칸막이
Fire Service : x,소방대
fire ship : x,화선,화공선
fire shovel : x,석탄삽,부삽
fireside : n,a,난로가,노변,가정,일가,단란,난로가의,노변의,가정적인
fire station : x,소방서
fire step : x,발판,디딤판
fire stick : x,불을 일으키는 막대기,불쏘시개,부젓가락
firestone : n,내화 석재,부싯돌
firestorm : n,불기둥,화재 폭풍,폭발
fire teazer : x,화부,기관사
fire tower : x,작은 등대,화재 감시 망루
firetrap : n,화재때 피할길이 없는 위험한 건물
fire truck : x,소방(자동)차
fire walk(ing) : x,불 속 걷기
fire walker : x,불 속 또는 달군 돌 위를 맨발로 걷는 사람
fire wall : x,방화벽,기관부 격벽
fire wall : x,방화벽,기관부 격벽
fire ward : x,=fire warden
fire warden : x,방화관,소방 감독관,불 지키는 사람
firewatcher : n,화재 감시인
firewater : n,화주
fireweed : n,불탄자리에 나는 잡초
fire window : x,내화창
firewood : n,장작
fireworks : n,불꽃,분노의 폭발,기지 등의 번뜩임
fire worship : x,배화,배화교
fire worship : x,배화교
fire worshiper : x,배화교도
firing : n,발포,발사,발화,점화,불에 쬠,구워 만들기,불을 땜,연료,땔감,해고
firing battery : x,사격 중대,야포대
firing charge : x,장약,발사약
firing iron : x,낙철,소락침
firing line : x,사선,포열선,사선부대,제일선,최선봉
firing order : x,점화 순서
firing pin : x,공이,격침
firing point : x,발화점,연소점
firing squad : x,조총대,총살대
firing step : x,=FIRE STEP
firkin : n,1/4배럴 상당의 영국의 용량단위,버터를 넣는 작은 나무 통
firm : a,ad,vt,vi,n,견고한,굳은,고정된,강경한,(가격이)변동없는,단단히,굳게,굳게 하다,굳어지다,합자회사,상사
firmament : n,하늘,창공
firmamental : a,
firman : n,칙령,면허장,여행 허가증
firmly : ad,굳게,견고하게,단단하게,확고하게
firmness : n,견고,단단함,견실,확고 부동,결의가 굳은
firmware : n,(컴퓨터)펌웨어
firn : n,만녈설,싸라기눈
fir needle : x,전나무 잎
firry : a,전나무의,전나무 재목의,전나무가 많은
first : a,n,ad,제1의,주요한,수위의,제일,일등,일위,최초,초하루,첫째로,최초로,처음으로,차라리,오히려
first aid : x,응급치료
First Amendment : x,헌법 수정 제1항
first base : x,일루수
first base : x,1루,1루의 위치(수비)
first baseman : x,1루수
first blood : x,최초로 출혈시키기,초반의 우세
firstborn : a,n,최초로 태어난 자식
first call : x,제1나팔,제2회 불입,전장
first cause : x,제1원인,원동력,조물주
First Children : x,대통령의 자녀들
firstchop : a,=FIRST CLASS
firstclass : a,ad,일류의,(기차 따위)일등의
first coat : x,초벌칠,밑칠,초벽
firstcomefirstserve(d) basis : x,선착순
firstcomer : n,맨 먼저 오는 손님,선착자
First Commonder : x,제1평민
first cost : x,원가
First Couple : x,대통령 부처
first cousin : x,사촌,종형제,종자매,매우 가까운(관계가 깊은,흡사한)사람(물건),근친
first cover : x,표지
First day : x,(Quaker교도 사이에서)일요일
firstday cover : x,초일 커버
firstde gree : a,선악 양면에서 정도가 제 1급인
first down : x,퍼스트 다운
first edition : x,초판,초판본
First Empire : x,프랑스의 제1제정 치하
first estate : x,제1신분
first family : x,(어떤지역에서)명문,대통령 일가
first finger : x,집게손가락
first floor : x,2층
firstfoot : n,vi,vt,정월 초하루의 맨 처음 손님,맨 처음 만남 사람
firstfooter : n,
first fruits : x,맏물,햇것,첫수확,첫성과
first gear : x,최저속 기어
firstgenerarion : a,외국 이민 자식으로서 미국 태생의,외국 태생으로 미국에 귀화한,1세의 귀화 미국인의
first generation computer : x,제1세대 컴퓨터
first half : x,상반기,전반기,전반,전기
firsthand : a,ad,직접으로
firstin,firstout : x,선입 선출법
First Interantional : x,제1인터내셔날
first lady : x,미국대통령부인
first lieutenant : x,중위
first light : x,새벽녘,동트는 시각
firstline : a,제일선의,전선의,최우량의,가장 중요한
firstling : n,맏물,첫수확,(가축의)맏배
First Lord : x,장관,총재,대신
firstly : ad,첫쨩로
first mate : x,1등 항해사
First Mom : x,대통령 부인
first name : x,=CHTISTLAN NAME
firstname : x,세례명
first night : x,첫날
firstnighter : n,극,오페라 따위의 첫날에 꼭 보러 가는 사람
firstnighter : n,(극,오페라따위의)첫날에 꼭 보러가는 사람
first offender : x,초범자
first officer : x,(상선의)1등 항해사
first papers : x,제 1차 서류(외국인이 미국에 귀화할 때 최초로 제출하는 서류)
first person : x,제 1인칭
first principle : x,제1원리,근본 가설
first quarter : x,상현,상현의 기간
firstrate : a,ad,일류의,훌륭한,굉장히
first reading : x,제1독회
first refusal : x,제1선매권
First Republic : x,프랑스의 제 1공화국
firstrun : a,개봉 흥행의
firstrunner : n,개봉관
First Sea Lord : x,제1군사위원
First Secretary : x,제1서기
first sergent : x,육군상사
first speed : x,전진 제1단
firststrike : a,(핵공격에서)선제의,제1격의
firststrike capability : x,선제(기습)공격 능력
firststring : a,일군의,1급(1류)의,우수한,뛰어난
firsttime : a,처음의,첫번째의
firsttimer : n,처음 하는(가는)사람
first use : x,선재 사용
first water : x,최우량질,최우수,1류(급)의
First World : x,제1세계,선진 공업국들
First World War : ,=World War I
firth : n,후미,강어귀
FIS : x,Federation Internationale de Ski국제 스키 연맹
FIS : x,family income supplement저소득 세대에 대한 보조(금)
FIS : x,Foreign Industrial Standard해외 공업 규격
fisc. : x,fiscal
fiscal : a,국고의,재정상의,회계의
fiscal agent : x,재무 대리 기관,재무 대리인
fiscal drag : x,제정적 장애
fiscal year : x,회계연도
fish : n,vt,vi,물고기,생선,어육,(별난)사람,놈,물고기를 잡다,낚다,찾다,끄집어내다,낚시질하다
fishable : a,고기잡이에 알맞은,낚을(잡을)가능성이 많은,어획(낚시질)이 안정된
fish ball : x,어육 완자
fishbolt : x,접합 볼트
fishbone : n,물고기 뼈(가시)
fishbowl : n,어항,사방에서 빤히 보이는 것,프라이버시가 전혀 없는 장소(상태),유치장
fish cake : x,납작한
fishcarver : n,생선 베는 칼,생선용 나이프와 포크
fish culture : x,양어(법)
fish davit : x,닻 기둥
fish day : x,금육재일
fish eagle : x,물수리
fisheater : n,생선을 먹는 사람,생선 요리용 나이프와 포크
fisher : n,어부,포어성 동물
fisherboat : n,어선,고기잡이배
fisherboy : n,고기잡이 소년
fisherman : n,어부,어선
fisherwoman : n,여자 고기잡이(낚시꾼)
fishery : n,어업권,어장
fishery zone : x,어업 전관 수역
fisheye : n,어안,월장석
fish factory : x,수산물 가공 공장
fish farm : x,양어장
fishfarming : n,양어(법)
fishfinder : n,어군 탐지기
fish finger : x,=FISH STICK
fish flake : x,생선 말리는 덕(시렁)
fish flour : x,어분
fish fork : x,생선용 포크,생선 갈고리
fishgig : n,작살
fish globe : x,양어기
fish glue : x,생선 아겨,어교,부레풀
fish hawk : x,물수리
fishhook : n,낚시
fishhouse : n,어업 조합 집어장,어시장,생선 포장 작업장,생선 가공 출하소
fishify : vt,물고기를 놓아 주다,..에 생선을 공급하다
fishily : ad,
fishin : n,금어 구역 설정 항의 데모
fishiness : n,
fishing : n,a,낚싱리,어업,고기잡이,낚시터,어장,어획,어업권,낚시질(용)의,어업(용)의
fishing banks : x,어초,어장
fishing boat : x,낚싯배,어선
fishing boundary : x,어업 전관 수역
fishing expedition : x,법적 신문,공식조사
fishing ground : x,어장
fishing line : x,낚싯줄
fishing net : x,고기잡이 그물,어망
fishing pole : x,낚싯대
fishing rights : x,어업권
fishing rod : x,낚싯대
fishing smack : x,소형 어선
fishing story : x,터무니 없는 이야기,허풍
fishing tackle : x,낚시 도구
fishing worm : x,지렁이
fish joint : x,이음매 판
fish kettle : x,큰 생선 냄비
fishkill : n,어류의 떼죽음
fish knife : x,생선 나이프
fish ladder : x,어제
fishlike : a,물고기 같은,냉담한
fishline : n,낚싯줄
fish market : x,어시장
fish meal : x,어분
fishmonger : n,생선 장수
fishnet : n,어망
fish oil : x,어유
fish paste : x,어육 페이스트
fishplate : n,이음매 판
fish pole : x,=FISHING POLE
fish pot : x,통발
fishpound : n,어살
fish protein concentrate : x,어육 농축 단백
fish sauce : x,생선 요리용 (흰)소스,생선으로 만든 소스
fishskin : n,물고기 껍질
fishskin disease : x,어린선
fish slice : x,생선 칼,물고기 뒤치개
fish sound : x,물고기의 부레
fish spear : x,작살
fish stick : x,피시 스틱
fishtail : a,vi,n,물고기 꼬리 모양의,어미형의,미익을 좌우로 흔들다,꼬리치기 활공
fishtail burner : x,어미형 버너,확염기
fishtail wind : x,어미풍,부정풍
fish torpedo : x,어형 수뢰,어뢰
fish warden : x,어업(어장)감독관
fishway : x,=FISH LADDER
fishwich : n,생선 튀김 샌드위치
fishwife : n,여자 생선장수,입이 건 여자
fishworm : n,지렁이(낚시용)
fishy : a,물고기의,물고기같은,비린,의심스런,(눈이)흐리멍텅한
fishyback : n,핏기백식 수송
fisk : n,=FISC
fissile : a,갈라지기 쉬운,분열성의
fissility : n,분열하기 쉬운 성질,열개성
fission : n,열개,분열,(원자의)핵분열
fissionability : n,
fissionable : a,핵분열하는,핵분열성의
fission bomb : x,원자폭탄
fission capture : x,핵분열(을 수반하는)포획
fission chain reaction : x,핵분열 연쇄 반응
fission fragment : x,핵분열의 파편
fission product : x,핵분열 생성물
fissiontrack dating : x,핵분열 비적에 의한 연대 측정법
fissiparous : a,분열생식의
fissiparously : ad,
fissiparousness : n,
fissure : n,vt,vi,금,틈,분할,틈이 생기게 하다,갈라지다
fist : n,vt,주먹,주먹으로 치다,손,필적,손가락표
fistfight : n,주먹다짐,주먹 싸움
fistful : n,=HANDFUL
fistic : a,권투의,주먹다짐의
fistical : a,권투의,주먹다짐의
fisticuff : n,주먹다짐,난투
fistie : a,권투의
fist law : x,강자의 압제,약육강식,철권 제재
fistling : n,맏물,첫수획,가축의 맏배
fistnote : n,손가락표 주
fistula : n,(곤충등의)관상기관
fistulous : a,(빈)관 모양의,속이 빈,누관의,누성의
FISU : x,Federation Internationale du Sport Universitaire국제 대학 스포츠 연맹
fit : a,vt,vi,n,적당한,당장 ~할 듯한,건강한,~에 적합하다,꼭 맞다,준비시키다,조달하다,적합,(의복 따위의)만듦새
fitaholic : n,체력 조절 운동의 중독자
fitch : n,(유럽산의)족제비의 일종,그 모피
fitchet : n,=FITCH
fitful : a,발작적인,단속적인,변하기 쉬운
fitfully : ad,
fitfulness : n,
fitly : ad,적당히,적절히,꼭 맞게,시기에 맞게
fitment : n,비품,가구,내부 시설(장치),부속품,액세서리
fitness : n,적당함,적합,적격,적합성,적절,양호함,건강함
fitout : n,채비,준비
fitted : a,꼭 맞게 만들어진,..을 갖추어,장비하여
fitter : n,맞추는(설비하는)사람,정비공,조립공
fitting : a,n,적당한,어울리는,적합,(가봉한 것의)입혀보기,설치,가구,비품,부속품
fittingly : ad,
fittingness : n,
fitting room : x,가봉실,시착실,탈의실
fitting shop : x,조립 공장
fitup : n,임시 극장,임시(휴대용,가설)무대(장치),지방 순회 극단
five : n,a,5(의)
fiveanddime : n,싸구려 잡화점
fiveandten : n,싸구려 잡화점
fiveandtencent store : x,=FIVEANDDIME(TEN)
fivebyfive : n,a,땅딸막하고 뚱뚱한(사람)
fiveday week : x,1주 5일 노동제
fivefinger : a,n,다섯 손가락의,불가사리,도둑
fivefold : n,ad,5배의,5겹의,5부분(요소)이 있는
five hundred : x,카드 게임의 하나
Five Nations : x,5족 연합
fiveo'clock shadow : x,오후 5시 경에 거무스름해 보이는 수염
fiveo'clock tea : x,5시(오후)의 차
fivepence : n,5펜스
fivepenny : a,5펜스의
fivepercenter : n,5푼의 수수료를 받고 관청과의 계약을 알선하는 사람
five pointer : x,우수한 학생,우수한 성적
fiver : n,5파운드 지폐,5달러 지폐
fives : n,두사람 또는 네사람이 하는 핸드볼 비슷한 구기
fivestar general : x,육군(해군)원수
fivestones : n,다섯 개의 작은 돌을 사용하는 공기놀이
Five Uear Plan : x,5개년 계획
FiveYear Plan : x,5개년 개획
fivril : n,가는섬유
fivrous : a,섬유질의
fix : vt,vi,n,고정시키다,(의견따위를)결정하다,집중시키다,(책임을)지우다,정착시키다,수리하다,조리하다,준비하다
fixate : vt,vi,정작(고정)시키다,응시하다,고착시키다
fixation : n,고정,응고,정착,색고착,병적집착
fixative : a,n,정착력있는,정착제,염착제
fixature : n,모발 정조제
fixed : v,a,fix의 과거,고정된,부정하게 결정된,짬짜미의,응고된
fixed ammunition : x,약협식(총)포탄
fixed assets : x,고정 자산
fixed capital : x,고정 자본
fixed charge : x,고정 요금,확정 부채
fixed cost : x,고정비
fixed exchange rate(system) : x,고정환시세(제)
fixed focus : x,고정 촛점
fixedfoucs : a,고정 초점의
fixed idea : x,고정 관념,고착 관념
fixed income : x,고정 수입,정액 소득
fixedincome : a,고정 수입의
fixedly : ad,
fixedness : n,정착,고착,고정,정착성,응고성,불휘발성
fixed oil : x,고정유,불휘발유
fixed point : x,고정점,정점,경찰관 파출소,지서
fixed price : x,고정(정찰)가격,정가,공정(협정)가격
fixed property : x,고정 자산,부동산
fixed satellite : x,고정(정지)위성
fixedsequece robot : x,고정 연속 동작 로봇
fixed star : x,항성
fixed station : x,고정 교신국
fixed trust : x,특정 투자 신탁
fixedwing airplane : x,고정익 항공기
fixer : n,설치(설비)하는 사람(물건),정착제,염료 고정제,중개인,매수자,조정자,마약 밀매인
fixing : n,고정,정착,설비,비품
fixing solution : x,정착액
fixit : a,간단한 수리의(를 하는)
fixity : n,고정물,영구성,불변성
fixt : v,FIX의 과거,과거분사
fixture : n,정착물,비품,(어떤 직책,자리 따위에)오래 앉아 있는 사람,공작물
fixup : n,마약 1회분의 양
fizgig : n,a,바람둥이 여자,채찍으로 돌리는 팽이,작살,경박한,바람기 있는
fizz : vi,n,부글부글하다,거품이 이는 음료
fizzer : n,쉿하고 소리를 내는 것(사람),제1급의 것,일급품
fizzle : vi,n,희미하게(쉬잇)하는 소리(를내다)
fizzwater : n,소다수,비등성음료
fizzy : a,부글부글하는,거품 이는
fizzy lemonade : x,탄산이 든 레모네이드
fjord : n,=fiord
fL : x,footlambert(s)
FL : x,Florida
fl. : x,floor,florin,flourished,fluid,floruit
fl.dr. : n,fluid dram
FLA,F.L.A. : x,Federal Loan Agency연방금융 기관
Fla.,Flor. : x,Florida
flab : n,뚱뚱함,군살
flabbergast : vt,깜짝 놀라게하다
flabbergast : vt,깜짝 놀라게 하다
flabbily : ad,
flabbiness : n,
flabby : a,흐늘흐늘하는,기력없는
flabellate : a,부채꼴의
flabelliform : a,부채꼴의
flabellum : n,성선,부채꼴 부분,부채꼴 기관
flaccid : a,흐늘흐늘한,맥없는
flaccidity : n,연약,맥없음,무기력
flack : n,vt,vi,선전(신문)담당원
flackery : n,선전,광고
flacon : n,(향수따위의)작은병
flacon : n,작은 병
fladge : n,채찍질
flag : n,vt,vi,기,(새 날개의)둘쨋줄 칼깃,기를 올리다,기로 꾸미다(신호하다),판석,포석을 깔다,판석포장도로,시들다
flag bearer : x,기수
flagboat : n,기정
flag captain : x,기함의 함장
flag carrier : x,한 나라를 대표하는 항공(선박)회사
flag day : x,기의 날,국기 제정
flagellant : n,a,채찍질의(을 좋아하는),호되게 비난하는
flagellate : vt,a,채찍질하다,힐난(질책)하다,편모가 있는,포복지(기는 줄기)가 있는
flagellation : n,채찍질,태형,편모
flagellator : n,=FLAGELANT
flagelliform : a,편모사의,휘청(낭창)거리는
flagellum : n,편모,기는 가지,채찍
flageolet : n,플라지올레토
flageolet : n,제비콩의 일종
flag football : x,플레그 풋볼
flagging : a,축 늘어지는,맥이 빠지는,줄어드는,쇠약해 가는
flaggingly : ad,
flaggy : a,붓꽃(창포)이 맣은,창포모양의
flaggy : a,판석 모양의,쪼개낼 수 있는
flaggy : a,출 늘어지는,처지는,무기력한,흐느적거리는
flagitious : a,극악 무도한,흉악한,파렴치한,무법한,악명높은
flagitiously : ad,
flagitiousness : n,
flag lieutenant : x,부관,참모
flag list : x,현역 장성 명부
flagman : n,신호기수,신호수,건널목지기
flag officer : x,해군장성,(함대,선대의)사령관
flagon : n,목이 좁은 병,큰 포도주 병,그 한잔분의 용량
flagpole : n,깃대
flagrance : n,악명(이 높음)
flagrancy : n,악명(이 높음)
flag rank : x,장성의 계급
flagrant : a,악명 높은,이름난,극악한
flagrante delicto : ad,현행범으로
flagrantly : ad,
flagship : n,기함,가장 큰(호화스런,최신의)배(비행기),최고인것,본점,본사,본교
flagstaff : n,깃대
flagstick : n,홀에 세우는 깃대,핀
flagstone : n,판석,까는 돌
flag stop : x,신호 정차 지점
flagwagging : n,애국적 과시(열의),수기 신호
flagwaver : n,선동자
flagwaving : n,애국심을 끊게 하는 활동,애국적(당파적)선동
flail : n,vt,vi,도리깨,도리깨질하다
flail tank : x,대지뢰전차
flair : n,예리한 안식 육감,천부의 재능
flak : n,고사포화
flake : n,vi,vt,얇은조각,박편이 되(게 하)다,~이 되어 펄펄 날리다,~으로 덮이다
flake : n,물고기 말리는 덕,저장 시렁(선반)
flakedout : a,잠든,의식을 잃은
flakeout : n,대실패,바보짓
flaker : n,
flakers : a,지친,기진맥진한
flake white : x,연백안료
flakily : ad,
flakiness : n,
flak jacket : x,방탄조끼
flak jacket(vest) : x,방탄 잠바,방탄복
flako : a,술취한
flaky : a,벗겨지기 쉬운,엷은 조각 모양의,조각조각의,색다른,별난,괴짜의
flam : n,vt,vi,꾸며낸 이야기,거짓,기만,야바위
flambe : a,n,불을 붙여 눋게 한
flambeau : n,횃불
flamboyance : n,현란함,화려함
flamboyant : a,타는듯한,화려한,불길 모양의(고딕 건축의 창,가스 난로의 격자 따위)
flame : n,vi,불길,화염,광휘,정열,애인,훨훨타다,빛나다,정열을 드러내다,발끈하다
flame gun : x,화염 제초기
flamen : n,사제
flamenco : n,플라멩코(남부 스페인  Andalusia지방의 민속 무용)그 기악곡
flameout : n,비행중 또는 이륙시의 제트엔진의 돌연한 정지
flame projector : x,화염방사기
flameproof : a,내염성의,불타지 않는
flameretardant : a,불이 잘 붙지 않는,내염성의
flame session : x,공리 공론의 회의(의론)
flame stitch : x,불꽃무의 자수 기법
flamethrower : n,방사기
flame trap : x,화염 역행 방지 장치
flaming : a,불타는,불을 뿜는,타는 듯한,타는 듯이 붉은,열정에 불타는,열렬한,눈이 이글이글 빛난는,과장된,현란한
flamingo : n,홍학
Flaminnian Way : n,고대 로마의 도로
flammability : n,타기쉬움,가연성,인화성
flammable : a,=INFLAMMABLE
flamy : a,불꽃의(과 같은),불타는 듯한
flan : n,주화를 만드는 지금
Flanders : x,플랑드르(유럽의 옛나라,벨기에 서부,북프랑스,네델란드 남서부 등 포함)
Flanders poppy : x,양귀비
flanerie : n,게으름뱅이,빈둥거리는 사람
flange : n,vt,(수레바퀴 따위의)테,(수레바퀴 따위의)테를 씌우다
flange : n,vt,수레바퀴따위의 테를 씌우다
flank : n,vt,구리,측면,부대의 측면,~의 측면에서다,측면을지키다
flanken : n,유대식 쇠갈비 요리의 일종
flanker : n,측면 보루,측보,측면에 붙인 부분,측면 방위병,좌(우)측면에 있는 선수(하프백),속임수
flank speed : x,최대 규정 속도,전속력,맹렬한 속도
flannel : n,플란넬,융의 일종,플란넬제 의류,모직 속옷
flannel cake : x,플란넬 케이크
flannelet(te) : n,면플란넬
flannelled : a,플란넬 옷을 입은,운동에 열중한
flannelly : a,플란넬제의,플란넬과 유사한,또렷하지 않은
flannelmouth : n,아첨꾼,자기 자랑 잘 하는 사람
flannelmouthed : a,우물거리는,분명하지 않은,입에 발린 말을 잘하는,알랑거리는
flap : vi,vt,n,펄럭거리다,날개를 퍼덕이다,찰싹때리다,축 늘어지(게 하)다,펄럭임,날개침,찰싹,늘어진 것,보조익,흥분
flapdoodle : n,허튼소리,엉터리 같은 소리
flap door : x,아래로 여는 문
flapdragon : n,=SNAPDRAGON
flapeared : a,늘어진 귀의
flapjack : n,핫케이크,(화장용)콤펙트
flappable : a,흥분(동요)하기 쉬운,안절 부절 못하는,갈팡질팡하는
flapper : n,가볍게(툭)치는 사람(물건),파리채,말광량이,플래퍼,기억,주의 등을 환기시키는 사람
flapping : n,상하 방향의 회전 운동
flare : vi,vt,n,너울너울타오르다,번쩍번쩍 빛나다,발끈하다,(스커프가)플레어가 되다
flare bomb : x,조명탄
flared : a,플레어의
flareout : n,수평(자세)
flare path : x,(비행장의)조명활주로
flare stack : x,배가스연소탑
flare star : x,섬광성
flareup : n,번쩍 빛남,확 타오름,섬광,격발,불끈 화를 냄,급격한 재발(표면화),일시적인 인기,떠들썩한 잔치놀이
flaring : a,타오르는,현란한,벌어진,나팔꽃 모양의
flaringly : ad,
flash : n,vi,vt,섬광,(재치 등의)번득임,(번쩍이는)순가,플래시,허식,방류수,빛나다,번득이다,획 지나가다,홱 나오다
flashback : n,플래시백(과거를회상하는장면전환),(소설 등의)회고법적 묘사
flashboard : n,저수량 조절용 판자
flash boiler : x,플래시 보일러
flash bulb : x,섬광전구
flash burn : x,(원자탄 따위에 의한)섬광화상
flash card : x,플래시카드(시청각교육에서 잠시보여 단어,산수등을 외게하는 카드)
flashcook : vt,최단시간 내에 조리하다
flashcube : n,플래시큐브
flasher : n,자동점멸장치,점멸광
flash flood : x,돌발 홍수
flash forward : x,미래장면의 사전삽입
flash gun : x,섬광발화장치
flashily : ad,지나치도록 화려하게,저속하고 번지르르하게
flashiness : n,
flashing : a,n,섬광,섬발,막아둔 물,번쩍이는,번쩍번쩍 빛나는
flash lamp : x,섬광등
flashlight : n,회중전등,플래시,명멸광,회전등,섬광등
flash number : x,속보 숫자
flashover : n,vi,섬락,플래시오버
flash pack : x,할인가격 표시 제품
flash photography : x,섬광 전구(플래시)사용의 촬영 사진(술)
flash photolysis : x,섬광 광분해
flash point : x,인화점,발화점,일촉즉발의 위기,폴발점
flashtube : n,섬광 전구
flashy : a,섬광적인,야한
flask : n,플라스크,(호주머니용의)작은 병
flasket : n,작은 플라스크,세탁물 넣는 광주리
flat : a,ad,n,vt,vi,편평한,납작한,납죽엎드린,공기가빠진,김빠진,맛없는,불경기의,광택없는,단조로운,노골적인
flat adverb : x,단순형 부사
flat back : x,등이 네모진 제본(책)
flatbacker : n,매춘부
flat bag : x,서류 봉투
flatbed : n,a,평상형 트레일러(트럭)
flatboat : n,큰너벅선
flatbottomed : a,바닥이 편평한
flat cap : x,필기용 종이
flatcap : n,테 없는 모자
flatcar : n,무개화차,목판차
flatchested : a,가슴이 납작한
flat display : x,평면 표시 장치,평면 전시
flatfish : n,가자미,넙치류
flatfoot : n,편평족,순경
flatfooted : a,편평족의,단호한,타협을 않는
flatfour : a,수평 4기통의
flathat : vt,무모하게 저공 비행을 하다
flathead : n,머리가 납작한,납작머리뱀,얼간이,바보
flating : n,납작하게 하기,평연,무광 칠
flatiron : n,다리미,인두
flat knot : x,=REEF KNOT
flatland : n,평지,평탄한 토지
flatlet : n,작은 플랫
flatly : a,펀펀하게,평평하게,단조롭게,활기 없이,맥이 빠져서,거침없이,단호하게,사정없이
flat money : x,법정불환지폐
flatness : n,평탄,평면도,평범,무미,단호한 태도,음의 저하,불경기
flatnosed : a,코가 납작한
flatplate collector : x,평판식 태양열 집열기
flat race : x,평지 경주(경마)
flat racing : x,평지경주,평지 경마
flat rate : x,고정(정액)요금
flatrate tax : x,일률 과세
flat roof : x,평평한 지붕,평지붕
flatroofed : a,평지붕의
flatscreen : a,n,평판 스크린(의)
flat silver : x,은기
flat spin : x,수평 나선 운동
flat tax : x,일률 과세
flatten : vt,vi,평평하게하다,단조롭게 하다,김이 빠지다,맛없게 하다,반음 내리다
flatter : vt,아첨하다,알랑거리다,우쭐케하다,실물보다 좋게 그리다,기쁘게 하다
flatterer : n,아첨꾼,알랑거리는 사람
flattering : a,아첨하는,알랑거리는,비위 맞추는,유망한,실물보다 좋게 보이는
flatteringly : ad,
flattery : n,아첨,감언
flat time sentence : x,정기 금고형
flat tire : x,바람빠진 타이어
flattish : a,약간 평평한,좀 단조로운
flattop : n,항공모함
flat trie : x,바람 빠진 타이어
flatulence : n,뱃속에 가스가 참,고창,공허,자부심
flatulency : n,
flatulent : a,가스가 찬,헛배부른,가스를 발생시키는,과장된,공허한,젠체하는,자만하는,허세부리는
flatware : n,가스,고창,방귀,한줄기 바람
flat water : x,정수역
flatways : ad,평평하게,평면으로
flatwise : ad,평평하게,평면으로
flatwork : n,다림질이 쉬운 판판한 빨래감
flatworm : n,편충
Flaubert : n, Gystave(1821~1880)프랑스의 소설가
flaunt : vt,vi,n,과시하다,자랑해 보이다,허세부리다,옷치장하다,휘날리다,과시
flaunter : n,
flaunting : a,펄펄 휘날리는,이것 보라는 듯한
flaunty : a,자랑삼아 보이는,과시하는
flautist : n,=FLUTIST
flavo(u)r : n,vt,맛,풍미,풍취,향기,~에 맛을 내다,풍미를 곁들이다
flavomycin : n,플라보마이신
flavored : a,맛(향기)이 있는,맛좋은
flavoredly : ad,
flavorful : a,풍미 있는,맛좋은
flavorfully : ad,
flavorgen : n,풍미소
flavoring : n,맛내기,조미,조미료,양념
flavorless : a,풍미(향기)없는,운치 없는
flavorous : a,풍미 있는,향기 높은,풍치 있는
flavorsome : a,풍미 있는,맛좋은
flavory : a,향기로운
flaw : n,vt,vi,금,흠,결점,금가(게 하)다,흠집을 내다,돌풍,한차례의 폭풍
flaw : n,돌풍,질풍,잠시 동안의 폭풍우
flax : n,아마,아마실,린네르
flax brake : x,아마 벗기는 연장,삼실 푸는 기구
flax comb : x,삼바디
flaxen : a,아마의,아마로 만든,아마 같은,아마빛의
flaxenhaired : a,아마빛 머리털을 가진(금발의 일종)
flax lily(bush) : x,뉴질랜드 원산의 삼
flax plant : x,아마
flaxseed : n,아마씨,아마인
flaxy : a,아마 같은,아마의(로 만든)
flay : vt,가죽을 벗기다,홀랑 빼앗다,강탈하다,혹평하다
F layer : n,F층(최상층의 전리층)
F layer : n,1층(지상 200,300km 상층의 전리층,단파를 반사)
flayflint : n,지독한 구두쇠,수전노,착취자
flea : n,벼룩(flea in one's ear)빗댐,(듣기)싫은 소리
fleabag : n,침대,침낭,싸구려 하숙
fleabane : n,개망초속의 식물,봄망초
fleabeetle : n,뜀벼룩갑충
fleabite : n,벼룩에 물린 자국,물림
fleabitten : a,벼룩에 물린,흰 바탕에 갈색 얼룩이 있는(말),지저분한,구지레한
flea collar : x,벼룩 없애는 목걸이
flea house : x,싸구려 여인숙
fleam : n,방혈침
flea market : x,특히 유럽의 고물 시장
fleapit : n,지저분한 방(건물,영화관)
flea trap : x,=FLEA HOUSE
fleawort : n,질경이 무리,금불초 무리
fleche : n,작은 첨탑,돌출보,플레시
flechette : n,강철제 화살
fleck : n,vt,반점,반점을 내다,작은 조각(을 흩뿌리다)
flecked : a,얼룩(반점)이 있는
flecker : vt,얼룩덜룩하게 하다,얼룩지게 하다
fleckered : a,얼룩점이 있는,얼룩덜룩한
fleckless : a,얼룩이 없는,오점이 없는,결백한,죄없는
flecklessly : ad,
flection : n,굴곡,어미변화
fled : v,flee와fly의과거(분사)
fledg(e)ling : n,깃털이 갓난(겨우 날 수 있게 된)새 새끼,풋내기,애송이
fledge : vt,vi,새끼를 기르다,깃털로 덮다,깃털이 나다
fledged : a,깃털이 다 난,날아갈 수 있을 만큼 성장한,다 자란,제 구실을 할 나이가 된,성인이 된
flee : vi,vt,도망하다,질주하다,사라지다,~에서 도망하다
fleece : n,vt,양털,한 마리에서 한번 깎는 양털,양털 모양의 것,보풀이 보드라운 피륙,(양의)털을 깎다
fleeceable : a,벗겨 낼 수 있는,속아 넘어가기 쉬운
fleecy : a,양털로 덮인,양털 같은,푹신푹신한
fleer : vi,vt,n,조소,조소하다
fleet : n,a,vi,함대,선대,기단,차량,빠른,빨리,지나가 버리다,후미
fleet admiral : x,해군원수
fleet admiral : x,해군 원수
Fleet Air Arm : x,영국 해국 항공대
fleetfooted : a,발이 빠른,쾌속의
fleeting : a,빨리 지나가는,덧없는,무상한
fleeting : a,어느덧 지나가는,잠깐 동안의,무상한,덧없는
fleetingly : ad,빨리
fleetingness : n,
Fleet parson (chaplain) : 플리트 감옥에서 비밀 결혼(Fleet marriage)의 중매를 한 감옥 전속의 목사
Fleet street : x,플리트가(런던의 신문사 거리),영국의 신문계
Fleming : n,플랑드르인,벨기에 사람
Flemish : a,n,플라드르의,플랑드르인
Flemish brik : x,플랑드르 벽돌
Flemish school : x,플랑드르파
flench : vt,가죽을 벗기다,기름을 뺨다
flency : n,유창함
flense : vt,가죽을 벗기다,기름을 뺨다
flesh : n,살,살집,식육,고기,과육,살색,육체,육욕,인류,생물,친척(flesh and blood 피가 통하는 육체,인간성)
flesh : n,살,살집,식육,고기,과육,살색,육체,육욕,인류,생물,친척(flesh and blood 피가 통하는 육체,인간성)
fleshbrush : n,피부 마찰용 솔,때미는 솔
fleshcolored : a,살색의
flesheater : n,육식자,육식 동물
flesheating : a,육식성의
flesher : n,=FLESHING KNIFE,고기 장수
fleshette : n,플레셧(용기가 폭발하면 사방으로 터져나가는 작은 (화)살 모양의 무기)
flesh fly : x,쉬파리(동물의 날고기에 쉬를 스는)
flesh glove : ,피부 마찰용 장갑
fleshhook : n,(푸주의) 고기 거는 갈고리
fleshiness : n,살집이 좋음,비만,(과실의) 다육성
fleshing knife : x,(껍질에서) 살을 벗겨내는 칼
fleshings : n,(무대용의)살색타이츠,(가죽에서 벗겨낸살,수구레
fleshing tool : x,살을 깎아내는 도구
fleshless : a,살없는,살빠진
fleshliness : n,육체적 성질,육욕에 빠진,육욕성,세속적임
fleshly : a,육체의,육욕의,육감적인,세속적인
flesh peddler : x,매춘부,갈보,뚜쟁이,여체로 손님을 끄는 흥행주
fleshpot : n,고기냄비,미식,사치,유곽
flesh side : x,가죽의 뒷면(살이 붙은 쪽)
flesh tights : x,살빛 타이즈
flesh tint : x,(인체의) 살빛
flesh tints : x,(인체의) 살빛
flesh traffic : x,=SLAVE TRAFFIC
flesh worm : x,고기에 꾀는 구더기
flesh wound : x,얕은상처,경상
fleshy : a,살의,육질의,살집이 좋은,다육질의(과실)
fletch : vt,(화살에) 깃을 붙이다
Fletcherism : n,플레처식 식사법(배고플 때 소량씩 충분히 씹어먹기)
fleurdelis : n,붓꽃,(프랑스 왕가의)붓꽃 문장
fleuret : n,작은 꽃모양(장식무늬)
fleuron : n,(건축,화폐 등의) 꽃무늬 장식
fleury : a,붓꽃 모양의 문장으로 장식한
flew : v,FLY의 과거
flew : n,=FLUE
flews : n,아래로 축 처진 윗입술
flex : vt,vi,n,(관절등을)구부리다,구부러지다,굽히다,(근육을) 수축시키다,굽다,굽힘,굽음,(전기의)코드,(가터 등과 같은) 탄력성 있는
flex. : x,!flexible
flexagon : n,플렉사곤(종이를 접어 만든 다면체)
flexibility : n,구부리기 쉬움,굴곡성,유연성,다루기 쉬움,적응성,융통성
flexible : a,구부리기 쉬운,어거하기 쉬운,융통성 있는,유순한,다루기 쉬운,시키는대로 하는. flexibly ad.
flexible response : x,신축적대응
flexible response : x,신축적 대응(1967년 NOTO가 바르샤바 조약군에 대해서 채책한 전략)
flexile : a,=FLEXIBLE
flexion : n,=PLECTION
flexitime : x,=FLEXTIME
flexography : n,플렉소(아닐린) 인쇄(인쇄물)
flexor : n,굴근
flextime : n,자유 근무 시간제
flexuose : a,굴곡성의 꾸불꾸불한,굽이치는,물결 모양으로 움직이는,동요하는,유연성 있는. flexuously ad.
flexuosity : n,굴곡성(물결 모양의) 굽이침
flexuous : a,굴곡성의 꾸불꾸불한,굽이치는,물결 모양으로 움직이는,동요하는,유연성 있는. flexuously ad.
flexure : n,굴곡,습곡,굴곡부,휨,요곡. flexural a.
flge station : x,신호 정차역
flibbertigibbet : n,수다쟁이,촐랑거리는 여자,경박한 사람
flick : n,vt,vi,가볍게 침,탁(하는 소리),튐,가볍게 때리다,(충격 따위로)떨다,퍼덕이다,훌쩍 날다,영화필름,영화,퍼럭이다
flicker : vi,n,(빛이)가물거리다,흔들거리다,펄럭이다,얼른거리다,언뜻 보이다,깜박이는빛,반짝임,번득임,딱다구리,(나뭇잎 등의) 살랑거림,영화. flickery a.
flickering : a,깜박거리는,명멸하는,꺼질 것 같은,약한. flickeringly ad.
flickertail : n,리처드슨 땅 다람쥐
Flickertail State : x,미국 North Dakota주의 속칭
flick knife : x,날이 자동적으로 튀어나오게 된 칼
flick roll : x,급회전
flied : v,FLY의 과거,과거 분사
flier : n,비행기,나는 사람,급행 열차,쾌속정,투기,전단,삐라,쾅하고 떨어지다,(직선 계단의) 한단,(풍차의) 날개
flight : n,vt,vi,비행,날기,(나는 새의)떼,(시간의)경과,항공여행,우주여행,(사상,야심의)고양,비행술,도주,패주,(떼지어 나는 새를) 쏘다,(새가) 떼지어 날다
flight control : x,관제소
flight data recorder : x,비행기록 장치
flight deck : x,(항공모함의)비행갑판,(항공기의)조종실
flight engineer : x,(탑승하는)항공기관사
flight feather : x,(새의)칼깃
flight formation : x,비행 대형(편대)
flight information region : x,비행 정보 구역
flightless : a,(새가) 날지 못하는
flight lieutenant : x,공군 대위
flight line : x,(격납고 주변의) 비행 대기선,(비행기,철새의) 비행 경로
flight manifest : x,적하 목록
flightmuscle : n,(새 날개의) 비상근
flightnumber : n,(정기 항공기의) 비행편 번호
flight officer : x,공군장교
flight path : x,비행 경로
flight pay : x,(다달의) 비행 수당
flight recorder : x,(사고해명에 필요한)비행기록장치
flight shooting : x,원시 경사
flight simulator : x,(항공기 승무원 훈련용) 모의 비행 장치
flight strip : x,활주로,긴급 착륙장,연속 항공 사진
flight surgeon : x,공군 의무관,항공 군의관
flighty : a,들뜬,머리가 좀 돈. flightily ad. flightiness n.
flimflam : n,vt,엉터리,터무니 없는 소리,속임,사기,엉터리 말을 하다,속이다,사기치다
flimsily : ad,박약하게,천박하게,가냘프게
flimsy : a,n,무른,취약한,천박한,박약한,얇은 종이,얇은 원고지,얇은 여성복. flimsiness n.
flinch : vt,=FLENSE
flinch : n,vi,vt,주춤함,주춤하다,꽁무니 뺌(빼다),...에서 손을 떼다. flincher n. flinchingly ad.
flinder : n,파편,단편
flinders : n,파편,부서진 조각
fling : vt,vi,n,내던지다,(두 팔을)갑자기 내뻗다,태질치다,메어치다,(돈을)뿌리다,돌진하다,발질,방종,욕,시험,시도
flinger : n,던지는 사람,(야구) 투수,욕설하는 사람,차는 버릇이 있는 말
flint : n,부싯돌,라이터돌,아주 단단한 물건
flint : a,부싯돌 같은,냉혹한,아주 단단한,고집 센
flint corn : x,낟알이 딴딴한 옥수수의 일종
flint glass : x,납유리,플린트 유리(주로 렌즈,프리즘 등 광학용의 고급 유리)
flinthead : n,화살촉(부싯돌로 만든)
flinthearted : a,냉혹한
flintiness : n,수석질,(극단적인) 냉혹,무정
flintlock : n,부싯돌식 발화장치,화승총
Flints. : x,Flintshire
flintshire : n,플린트셔(영국 웨일스 북동부의 예 주)
flinty : a,부싯돌 같은,몹시 딴딴한,아주 완고한,무정한,피도 눈물도 없는. flintily ad.
flip : n,플립(맥주,브랜디에 달걀,향료,설탕 등을 넣고 따듯하게 한 음료)
flip : a,n,약빠른 (사람),참견 잘하는 (사람),건방진 (사람)
flip : vt,vi,n,a,손톱으로 튀기다,흠칫 움직이(게 하)다,홱 움직임,톡 치다,(비행기의)한 번 날기,정신을 잃다,가볍게 침,공중제비
flip chart : x,플립 차트(강연 등에서 사용하는 한 장씩 넘기게 된 도해용 카드)
flip chip : x,플립 칩(초소형 반도체 소자의 하나)
flipflap : n,vi,a,ad,역공중제비,(방향,의견의) 급변,전환,회전 시소(놀이터의),고무 슬리퍼,퍼덕퍼덕하다,방향을 전환하다,(방향을) 전환하는,퍼덕퍼덕하며,덜컥덜컥하며
flipflop : n,vi,a,ad,역공중제비,(방향,의견의) 급변,전환,회전 시소(놀이터의),고무 슬리퍼,퍼덕퍼덕하다,방향을 전환하다,(방향을) 전환하는,퍼덕퍼덕하며,덜컥덜컥하며
flippancy : n,경솔,경박
flippant : a,주제넘은,경박한. flippantly ad.
flipper : n,(바다표범 따위의)물갈퀴,(잠수용)고무 물갈퀴,손,팔
flipping : a,ad,n,지독한(하게),괘씸한(하게),이자에 이자를 붙이기
flippy : n,mini floppy disk의 별명
flip side : x,레코드의 B면
fliptop table : x,(엄지 손가락 등으로) 뚜껑을 밀어 올려서 여는 식의 테이블
FLIR : n,전방 감시 적외선 암시 장치
flirt : vt,vi,n,(활발히)흔들어대다,던지다,깡총깡총 움직이다,(남녀가)새롱거리다,가지고놀다,짐,바람둥이 여자(남자),급격한 움직임
flirtation : n,(남녀의) 희롱,시시덕거림,연애 유희,(어떤 일에의) 일시적 흥미(관심),가지고 놀기
flirtatious : a,(특히 여자가) 불장난하는,시시덕거리는,들뜬,경박한. flirtatiously ad.
flirting : a,희롱하는,시시덕거리는,장난삼아 연애하는. flirtingly ad.
flirty : a,시시덕거리는,들뜬,경박한
flit : vi,n,훌쩍날다,훌쩍 날기,이리저리 날아다니다(다니기),(시간이)지나가다,날아지나감,야반 도주
flitch : n,vt,소금에 절여 훈제한 돼지의 구리살,저미다
flitch beam : x,겹들보,합량
flitched beam : x,겹들보,합량
flite : vi,n,말다툼하다,욕하다,악담하다,말다툼,악담
flitgun : n,살충제용 분무기
fliting : n,=FLITE
flitter : vi,n,vt,훨훨날다,훨훨나는것,훨훨 날게하다
flittermouse : n,박쥐
flitting : n,a,이사,훨훨 나는
flivver : n,vi,값싼 고물자동차,(특히 소형의 낡은) 싸구려 자동차,실패,실패자,여행하다(사구려 자동차 등으로),실패하다
FLN : x,Front de liberation nationale (알제리) 민족 해방전선
Flo : n,여자 이름
float : vi,vt,n,뜨다,띄우다,표류하다,(소문이)퍼지다,떨어져가다,(회사가)세워지다,(어음이)유통되다,부표,뜨는 물건,부유물,부레,흙손,소액 현금,자유시간,흔들거리다,동요하다
floatable : a,뜰 수 있는,떠오르는 성질의,(강물이 배,뗏목 등을) 띄울 수 있는
floatage : n,=FLOTAGE
floatage : n,부유,부양,부력,부유물,표류물,(하천에 떠있는) 배,건현
floatation : n,=FLOTATION
floatation : n,=FLOTATION
floatation : n,뜸,(회사)설립,(공채)발행,부유선광
floatationer : n,집을 자꾸 옮기는 사람,여러 곳에서 투표하는 부정 투표자
floatboard : n,물받이 판자,물갈퀴
float bridge : x,부교,뗏목을 만든 다리
floater : n,뜨는 사람,(낙시) 찌,부척,뜨내기,이중 투표자,부동 투표자,설립 발기인,부동 증권,포괄 보험
float fishing : x,배 낚시질,찌 낙시질
float glass : x,플로트 유리
float grass : x,=FLOATING GRASS
floating : a,n,떠있는,부동하는,유동하는,부유,부동,부동적인,변동하는,유동하는
floating anchor : x,부묘,시 앵커
floating battery : x,부유 포대,부동 축전지
floating bridge : x,부교,뗏목 다리
floating bridge : x,부교,배다리
floating capital : x,유동 자본
floating capital : x,유동자본
floating crane : x,해상 기중기,기중기선
floating debt : x,유동 부채
floating dock : x,부양식 독
floating exchange rate system : x,변동 환율제
floating grass : x,(소택지의) 부초,부평초
floating island : x,뜬섬(부유물이 뭉쳐 섬같이 된 것),일종의 커스터드(식후에 먹는)
floating kidney : x,유쥬선
floating lever : x,유동 레버
floating light : x,부표등,등대선,야간 구명 부표
floating money : x,유휴자금
floating rate : x,자유 변동 시세,선하세
floating rib : x,유리늑골
floating stock : x,부동주(항상 매매 또는 투기의 대상이 되는)
floating supply : x,(물품,증권 등의) 재고량(액)
floating vote : x,부동표
floating voter : x,부동성 투표자
floatplane : n,플로트(부주형) 수상 비행기
float process : x,플로트법(녹은 유리를 녹은 주석 위에 붓는 유리 제조법)
floatstone : n,속돌,부석,숫돌
floaty : a,뜨는,뜰 수 있는,뜨기 쉬운,(배가) 홀수가 얕은
floccinaucinihilipilification : n,(재물 등에 대한) 경시,무가치하게 여김
floccose : a,수북이 털이 난,양털 모양의
flocculate : vt,vi,(구름,침전물 등을) 양털 뭉치 모양으로 하다(되다),응집시키다(하다). flocculator n.
flocculation : n,양털 모양의 침전,응집
floccule : n,한 뭉치의 양털,미세한 면상,침전물
flocculence : n,양털 모양
flocculent : a,양털의,유모성의,보드라운 털로 덮인
floccus : n,a,(사자 등의 꼬리 끝의) 털뭉치,방모,(새 새끼의) 솜털,(식물 표면의) 송이 모양의 털,방상운,(떼지은) 방상의
flock : n,vt,한뭉치의 양털(머리털),털 부스러기,솜 나부랑이,넝마,(이불 등에) 털 부스러기를 채우다
flock : n,vi,(양,새의)떼,군중,무리,신도,무리짓다,모이다,떼지어 오다
flockbed : n,털부스러기를 채운 침대
flockmaster : n,목양주,목양업자,양치기
flock paper : ,나사지(털을 넣어서 만든 벽지 등)
flocky : a,양털 모양의,털술 같은
floding money : x,지폐
floe : n,빙원(바다 위에 떠 있는),부빙
flog : vt,세게 때리다,매질하다,채찍질하다
flogging : n,채찍질,매질,태형
flogging chisel : n,큰 끌(정)
flokati : n,그리스산 수직 양탄자
flong : n,지형 용지(원지)
flood : n,vt,vi,홍수,만조,(물건의)범람,쇄도,대해,호수,강,넘쳐 흐르다,관개하다,다량의 물을 쏟다,밀어닥치다,범람하다,범람 시키다
floodable : a,홍수나기 쉬운
flood control : x,치수
flooded : a,물에 잠긴,침수된
flood fallowing : x,관수 휴한법(휴작 중에 물을 채워 토양에 매개 하는 병원균을 죽임)
floodgate : n,수문,방조문,(노여움 등의) 방출구,출구
flooding : n,범람,큰물,홍수
flood lamp : x,투광 조명등
floodlight : n,vt,플러드라이트,플러드라이트를 비추다,투광 조명등,투광기
floodlighting : n,(건물에 대해 밖에서부터) 투광 조명
floodmark : n,홍수 흔적,만조표
floodometer : n,(밀물의) 수량 기록기,홍수계,만조계
floodplain : n,범람원(수위가 높을 때 물에 잠기는)
floodstricken : a,수해를 입은
flood tide : x,밀물,만조,최고조
floodwall : n,홍수 방벽(제방)
floodwater : n,홍수(의 물)
floodwood : n,물에 떠내려오는 재목,유목
floopy disk : x,외부 기억용의 플라스틱제 자기 원판
floor : n,vt,마루,층,의원석,발언권,입회장,촬영소,제작,최저가격,마루를 깔다,마루에 때려 눕히다,마루바닥에 앉히
floorage : n,바닥 면적,건평
floorboard : n,마루청,바닥널,청널,(자동차 등의) 바닥
floor broker : x,(미국 증권 거래소의) 다른 회원을 위해 수수료를 받고 매매를 하는 회원
floorcloth : n,마룻걸레,마룻깔개
floorcrossing : n,(영국 의회 등에서) 반대당에의 찬성 투표
floorer : x,마루를 놓는 사람,마룻바닥에 쓰러뜨리는 사람,두말 못하게 하는 발언,단번에 기둥을 모두 넘어뜨리도록 던지기
floor exercise : x,(체조의) 마루운동
flooring : n,마루,바닥,바닥깔기,마루까는 재료
floor lamp : x,(방바닥에 세우는) 전기 스탠드
floor leader : x,(정당의)원내총무
floor light : x,마루 채광(유리블록으로 마루를 깔아 아래층에 빛이 들어오게 한 것)
floorman : x,마루 청소부,(증권거래소 입회장에서 활동하는) 매매 거래원
floor manager : x,(정당대회등의)지휘자,(텔레비젼의)무대감독
floor mat : x,마루 매트(의자와 융단사이에 까는 플라스틱판
floor model : x,(탁상형에 대하여) 마루형,콘솔형,(상점의) 전시품 (기구 등)
floor partner : x,(미국 증권 거래소의) 플로어 파트너(회원의 자격을 가지고 소속 증권 중매 회사를 위해 FLOOR BROKER로서 일하는 사람)
floor plan : x,건물의 평면도
floor price : x,(수출) 최저 가격
floor sample : x,견본 전시품(후에 할인해서 판매됨)
floorshift : x,(자동차의) 플로어 시프트(바닥에 장치한 기어 변환 장치)
floor show : x,(나이트클럽의)플로어쇼
floor space : x,(건물의) 바닥 면적,건평
floorthrough : n,하나의 층 전체를 차지하는 아파트
floor trader : x,(증권 거래소의) 자기 계정을 갖고 매매 감독
floorwalker : n,(백화점의)매장,감독
floosie : n,매춘부,품행이 나쁜 여자
floosy : n,매춘부,품행이 나쁜 여자
floozie : n,매춘부,품행이 나쁜 여자
floozy : n,매춘부,품행이 나쁜 여자
flop : vi,vt,n,int,ad,털썩 넘어지다,퍼덕거리다,싹 변하다,실패하다,펄떡펄떡거리다,털썩 떨어짐,실패,여인숙,퍽(하고),털썩(하고),펄썩(하고)
flopeared : a,귀가 축 늘어진 (개 등)
flophouse : n,여인숙,간이 숙박소
flopnik : n,실패(한) 위성
flopover : n,플랩오버(영상이 상하로 흔들리기),전복
flopper : n,(정치등의)변절자,룸펜,FLOP하는 사람
floppy : a,퍼덕퍼덕 펄럭이는,흘게늦은,늘어진,느슨한,기운 없는,약한. floppily ad. floppiness n.
flor. : x,floruit
Flor. : x,Florida
Flora : n,여자이름,플로라(꽃의 여신)
flora : n,(한시대,한지역의)식물상,식물군,식물지
floral : a,꽃의,식물(군)의,꽃 비슷한,(꽃의 여신) Floral의. florally ad.
floral emblem : x,(나라,주,도시,학교 등을) 상징하는 꽃
floral envelope : x,화피,꽃덮이
floral leaf : x,꽃잎
floral tribute : x,헌화
floral wedding : x,화혼식(결혼 7주년 기념)
floral zone : x,식물(초본)대
Florence : n,피렌체,플로렌스(이탈리아 중부의 도시)
Florentine : a,n,피렌체 사람,Florence의,능견의 일종
florescence : n,개화기,전성기
floret : n,작은꽃,(엉거시과 식물의)작은 통상화
floriated : a,꽃무늬의,꽃무늬 장식을 한
floribunda : n,플로리번다(중간 크기의 꽃이 피는 장미의 일종)
floricultural : a,화초 재배(상)의
floriculture : n,화초재배(법),화초 원예
floriculturist : n,화초 재배자
florid : a,불그레한,혈색이 좋은,화려한,현란한. floridly ad. floridness n.
Florida : n,미국동남쪽 끝의 주,프로리다주 및 그 남부의 반도
Florida Keys : n,플로리다키스제도
Floridan : a,n,플로리다의,플로리다주의 주민
Florida water : x,플로리다수(오드콜로뉴 비슷한 향수)
Florida wood : x,상감 세공용의 단단한 나무의 일종
Floridian : a,n,플로리다의,플로리다주의 주민
floridity : n,색깔이 화려,장미빛,혈색이 좋음,화려,호화
floriferous : a,꽃이 피는,꽃이 많은,화려한. floriferously ad. floriferousness n.
florigen : n,화성소,플로리겐(개화 호르몬)
florilegium : n,추려서 모은 꽃,화보
florin : n,영국의 2실링은화,플로린 은화
florist : n,화초재배자,꽃장수
floristic : a,꽃의(에 관한),식물상의
floristics : n,식물상 연구
floruit : n,(사람의) 존명기,활약기
flory : a,=FLEURY
floscular : a,작은 꽃으로 된,통상의
floscule : n,작은 꽃
flosculous : a,작은 꽃으로 된,통상의
floss : n,(누에고치의)괴깔,풀솜,삶은 명주실
Flossie : n,여자 이름
floss silk : x,명주실,풀솜
flossy : a,풀솜 같은,(복장 등이) 멋부린,야한
FLOT : n,아군(자기편 부대)의 최전선
flotage : n,부유,부양,부력,부유물,표류물,(하천에 떠있는) 배,건현
flotation : n,뜸,(회사)설립,(공채)발행,부유선광
flotation collar : x,(우주선의 착수 직후에 다는)환산 부양 장치
flotation gear : x,(수상 비행기 등의) 부양 장치
flotilla : n,소함대,정대
flotsam : n,(난과선의)부하,표류하물,표류자( flotsam and jetsam 표류 하물,잡동사니,부랑자)
flounce : n,vt,(스커트의)자락주름장식(을달다),(물,진탕 따위속에서)허위적거리다,(몸이나 팔을 흔들며)뛰어나가다,버둥거림,(성이나서) 몸부림침
flouncing : n,주름 장식(의 재료)
flounder : n,vi,가자미목 물고기의 총칭,넙치류,버둥거리다,허위적거리다,갈팡대다,버둥거림,허덕임
flounderingly : ad,허둥대며,실수를 저지르며
flour : n,vt,vi,밀가루,가루,가루를 뿌리다,가루로 만들다,가루가 되다
flour beetle : x,밀가루에 꾀는 벌레
flour box : x,=FLOURDREDGER
flourdredger : n,가루 뿌리는 기구
flourish : vi,vt,n,번영하다,활약하다,휘두르다,자랑해 보이다,문자로 쓰다,화려하게 쓰다,세찬 휘두름,과시,융성,번영
flourishing : a,무성하는,번영하는,융성하는,성대한. flourishingly ad.
flourishy : a,화려한,장식체의,꾸며 쓴
flour mill : x,제분기
floury : a,가루가 많은,가루의,가루모양의
flout : n,vt,vi,조롱(하다)
flow : vi,vt,n,머리칼이 늘어지다,(바람에)쓸리다,(조수가)밀다,많이있다,흐르게하다,범람시키다,흐름,유출량,밀물,흐르다
flowage : n,유동,유출물,(점성 물질의)유동
flowchart : x,생산공정도,순서도
flow diagram : x,컴퓨터 문제처리를 위한 순위표
flower : n,vi,vt,꽃,화초,만개,개화,꽃이 피다,번영하다,꽃으로 꾸미다,...에 꽃을 피우다
flowerage : n,꽃,꽃무늬(장식),개화(상태)
flower arrangement : x,꽃꽃이
flowerbearing : a,꽃이 피는,꽃을 피우는
flower bed : x,꽃밭,화단
flower bud : x,꽃망울
flower children : x,히피족
flower cup : x,꽃받침
flowerdeluce : n,=FLEURDELIS
flowered : a,꽃으로 덮인,꽃무늬로 장식한,...으로 (꽃이)
flowerer : n,꽃이 피는 식물
floweret : n,작은꽃
flower garden : x,꽃밭,화원
flower girl : x,꽃파는 아가씨
flower head : x,두상화
flowerily : ad,꽃같이,아름답게,찬란하게
floweriness : n,꽃이 많음,찬란함,화려함
flowering : a,n,꽃이 피는,꽃을 감상하기 위해 재배되는,개화,개화기,꽃 장식을 달기
flowering dogwood : x,말채나무 무리의 일종
flowering fern : x,고비
flowering plant : x,꽃식물,화훼
flowerless : a,꽃이 없는,꽃이 피지 않는,은화의
flowerlet : n,=FLORET
flowerlike : a,꽃 같은
flower people : x,히피족
flower piece : x,꽃그림
flowerpot : n,화분
flower power : x,히피족(의 세력)
flower service : x,꽃 예배(교회를 꽃으로 꾸미고 예배한 다음 그 꽃을 병원 등에 기증함)
flower shop : x,꽃가게,꽃집
flower show : x,화초품평회
flower show : x,화초 전시회
flower stalk : x,화경,꽃자루
Flower State : x,미국 Florida주의 속칭
flower vase : x,꽃병
flowery : a,꽃이 많은,꽃 같은,(문체가)화려한
flowery kingdom : x,중국
flowery language : x,미사어구
flowing : a,흐르는(듯한),(말이)유창한,(멋지게)늘어진. flowingly ad.
flow line : x,유문(화성암 유동 때에 생기는 줄무늬)
flowmeter : n,유량계
flown : v,fly의 과거분사
flown : a,혼합 색으로 장식한
flow sheet : x,=FLOW DIAGRZM
fltout : a,솔직한,전적인,최고의 속도의
flu : n,인플루엔자,유행성 감기,독감
flub : vt,n,실패하다,실수하다,꼴사나운 실패,실수
flubdub : n,허세,허풍,호언 장담
fluctuant : a,변동하는,파동하는.기복있는
fluctuate : vi,vt,변동하다,파동하다,오르내리다,동요(변동) 시키다
fluctuating : a,변동이 있는,동요하는,오르내리는
fluctuation : n,파동,동요,오르내리는 변동,불안정,성쇠,흥망,간만
fludemic : n,악성 인플루엔자
flue : n,(연통의)연기구멍,송기관
flue : n,보풀,털 부스러기
flue : n,=FLU
flue : vt,vi,(벽면의 창틀,총안 등이) 나팔꽃 모양으로 벌어지(게 하)다
flue : n,(큰 깃털의) 깃가지,닻혀,(창의) 미늘,(화살)촉
flue : n,후릿 그물,쳐두는 그물
fluence : n,(최면술 등에 의한) 영향력
fluent : a,n,유창한,능변의,흐르는 듯 한,(움직임,곡선 등이) 완만한,부드러운,변수,변량,
fluently : ad,유창하게,거침없이
flue pipe : x,순관
flueric : a,=FLUIDIC
flue stop : x,(오르간의) 순관 음전
fluework : x,순관 음전
fluey : a,털 부스러기 같은,보풀 같은
fluff : n,vt,vi,괴깔,솜털,괴깔이 일게 하다,푸해지다,보풀다,가볍게 내려앉다,보풀리다,실패하다,실수
fluffer : n,(런던 지하철 등의) 선로 청소부
fluff stuff : x,펄펄 날리는 것,눈
fluffy : a,괴깔의,푸한,보풀의,모호한. fluffily ad. fluffiness n.
fluid : n,a,유동체,유체,유동성의,변하기 쉬운,아름답고 부드러운. fluidly ad. fluidness n.
fluid compass : x,액체 나침판
fluid drachm : x,액량 드램
fluid dram : x,액량 드램
fluid drive : x,(자동차 등의) 유체 구동(장치)
fluid dynamics : x,유체 역학
fluid fuel : x,유체 연료(액체,기체,화학 연료의 총칭)
fluidic : x,유체(공학)의
fluidics : n,응용유체역학
fluidify : vt,vi,유동(유체)화 하다
fluidity : n,유동성
fluidization : n,유동화
fluidize : n,유동화
fluid mechanics : x,유체역학
fluidonics : n,=FLUIDICS
fluid ounce : n,액량 온스
fluidounce : n,액량 온스
fluid power : x,유체동력
fluid pressure : x,유체 압력,유압
fluidrachm : n,=FLUID DRACHM
fluidram : n,=FLUID DRAM
fluke : n,vi,vt,닻혀,(창,작살 등의)미늘,요행수,가자미류,간디스토마,고래꼬리,요행수로 맞(히)다,달걀모양의 감자
flukey : a,요행수의,요행의,변덕스러운
flukicide : n,디스토마 구충제
flukily : ad,요행수로
fluky : a,요행수의,요행의,변덕스러운
flume : n,vi,vt,용수로,홈통,물받이,좁은 계류,(물이 흐르는 가파르고 좁은) 골짜기,홈통을 놓다,도랑으로 (물을) 끌다
flummery : n,오트밀(밀가루)죽,허튼소리,겉치레말
flummox : vt,vi,n,어리둥절하게 하다,(계획 등이) 실패하다,실패
flummux : vt,vi,n,어리둥절하게 하다,(계획 등이) 실패하다,실패
flump : vt,vi,n,털썩 내던지다,털썩 떨어지다,털썩(하는 소리)
flung : v,fling의과거(분사)
flunk : vi,vt,n,(시험따위에)실패하다,낙제점을 매기다,단념하다,실패,낙제
flunker : n,낙제생,퇴학자,퇴학시키는 교사
flunkey : n,(제복입은)하인,(하인처럼 구는)아첨꾼
flunkout : n,낙제생
flunky : n,(제복입은)하인,(하인처럼 구는)아첨꾼
flunkydom : n,하인배,측근배
flunkyism : n,하인 근성,추종주의,사대사상
flunkysim : n,하인근성,아부주의
fluor : n,=FLUORITE
fluoresce : vi,형광을 내다
fluorescein : n,플루오레세인(이 용액은 강한 형광을 내므로 해난 표지에 쓰임)
fluorescence : n,형광성
fluorescent : a,n,형광성의,형광
fluorescent lamp : x,형광등
fluorescent light : x,형광
fluorescent microscope : x,형광 현미경
fluorescent screen : x,형광판
fluorescent tube : x,형광등
fluorescer : n,형광 물질
fluoric : a,형석의,플루오르의,불소(성)의
fluoridate : vi,(충치예방으로)음료수에 불소를 넣다
fluoridation : n,불화물 첨가법
fluoride : n,불화물
fluoridize : vt,플루오르화물로 처리하다
fluoridizer : n,(섬유 가공용) 불소 처리제
fluorinate : vt,플루오르를 화합시키다,불소를 첨가하다
fluorine : n,불소(기호F)
fluorite : n,형석
fluorocarbon : n,탄화불소,플루오르화 탄소
fluorochrome : n,형광 색소(생물 염색에 사용)
fluorometer : n,형광계
fluoroscope : n,vt,(X선의)형광 투시경,형광 투시법으로 검사하다
fluoroscopy : n,형광 투시법
fluorosis : n,불소(침착)증
fluorspar : n,=FLUORITE
flurried : a,혼란한,동요한,당황한
flurry : n,vt,vi,휘몰아치는 비,소동,당황(케 하다),(작살 맞은 고래의)단말마의 고통,일진 광풍,혼란,동요,눈보라,당황하다
flush : vt,vi,n,(물이)물을 흘려서 씻다,얼굴을 붉히다,득의양양하게 하다,(얼굴이)붉어지다,왈칵흐름,홍조,흥분
flush : a,ad,vt,동일 평면의,같은 높이의,(물이) 가득찬,잔뜩 가진,풍부한,평평하게,같은 높이로,바로 정면으로,꼭,평평하게 하다
flush : vi,vt,n,(새가)푸르르 날아 오르다,(새를) 푸르르 날아 오르게 하다.(범인을) 몰아내다.날아오름,날아올림,새떼
flush : n,플러시(특히 poker에서 같은 종류의 패가 모이기)
flush deck : x,(이물에서 고물까지 평평한) 평갑판
flushdeck vessel : x,평갑판선
flush door : x,플러시도어(전면과 뒤에 합판을 대어 만든 문)
flusher : n,하수도 씻어내는 청소부,유수 장치,살수차
flushing : n,a,수세(식의)
flush lavatory : x,수세식 변소
flushness : n,(특히 돈이)많음
flush times : x,호경기
flush toilet : x,수세식 변소
fluster : vt,=FLUSTER
flustrate : vt,=FLUSTER
flustration : n,당황,혼란
flute : n,vi,vt,플루트,피리(를 불다,같은 소리를 내다),(옷감,기둥 따위의)세로골(을 내다,파다),플루트를 불다,피리같은 음을 내다,피리 같은 소리로 노래하다
fluted : a,피리 소리의,세로 홈을 판 (기둥),홈이 있는
flute player : x,=FLUTIST
fluter : n,홈파는 기구,=FLUTIST
fluting : n,필 불기,플루트 연주,홈파기
flutist : n,피리 부는 사람,플루트 취주자
flutter : vi,vt,n,퍼덕거리다,홰치다,훨훨날다,나부끼다,(가슴이)두근거리다,(맥박이)빠르고 불규칙하게 뛰다,퍼덕이다,날개치다,펄럭임,팔랑거림,활개짓,불규칙재생,불규칙 진동. flutterer n.
flutteringly : ad,펄렁펄렁,들썩들썩
flutter kick : x,(크롤영법에서)물장구질
flutter wheel : x,(낙수로 움직이는) 물레바퀴
fluttery : a,펄럭이는,퍼덕거리는
fluty : a,(음조가)피리 소리 같은,부드럽고 맑은
fluvial : a,하천의,냇물의 작용으로
fluviatile : a,하천의(작용으로 생긴)
fluviology : n,하천학
fluviometer : n,하천 수량 기록계
flux : n,vt,vi,흐름,유동,밀물,연속적인 변화,용제,이상유출,(하제로)설사시키다,녹이다,융제로 처리하다,녹다,흐르다,변전하다
flux density : x,유속 밀도,플럭스 밀도
flux gate : x,지구 자장의 방향과 세기를 나타내는 장치
fluxion : n,유동,유출,유율,미분계수
fluxional : a,유동성의,미분의. fluxionally ad.
fluxionary : a,=FLUXIONAL
fluxmeter : n,자속계
fluxoid quantum : x,자속양자
fly : n,v,vi,vt,날다,파리,비행하다,달리다,달아나다,순식간에없어지다,펄럭이다,날리다,조종하다,도망하다,비행날리다,날아오르게하다,...을 비행기로 날리다,날기,비행,(피아노,오르간의)건반의 뚜껑인쇄지를 집어넣는 장치
fly : a,약삭빠른,기민한,날씬한
flyable : a,(날씨가) 비행하기에 알맞은
fly agario : x,광대 버섯
fly amanita : x,광대 버섯
fly ash : x,비산회(시멘트 혼합제 등으로 씀)
flyaway : a,n,바람에 나부끼는,헐렁하게 입은,언제든 공수(비행)할 수 있는(군수품,비행기 등),경솔한 사람,도주자
flybait : n,시체,송장
fly ball : x,플라이,비구,형사,괴짜
flybane : x,(파리잡는)끈끈이,파리를 죽이는 독
flybane : x,파리잡는 끈끈이
flybelt : n,체체파리가 창궐하는 지대
flyblow : vt,n,부패시키다,쉬파리의 쉬,구더기가 끓음
flyblown : a,파리가 쉬를슨,더러워진
flyboat : n,바닥이 판판한 배
fly bomb : x,=BUZZ BOMB
fly book : x,(지갑 모양의) 제물낚시 쌈지
flyboy : n,항공기 승무원,항공대원
fly bridge : x,=FLYING BRIDGE
flyby : n,의례비행,(우주선의 천체에의)근접통과,저공 비행
flybynight : a,n,금전적으로 믿을 수 없는,(빚에 몰려) 야반도주하는 사람,믿을 수 없는 사람
flybywire : a,플라이바이와이어로 비행하는(조종 계통을 컴퓨터를 통해 전기 신호 장치로 바꾼)
flycast : vt,vi,=FLYFISH
fly casting : x,제물 낚시질
flycatcher : n,파리통,딱새
flychaser : n,(야구의) 외야수
fly cop : x,형사
flycruise : n,vi,비행가와 배를 이용하는 유람 여행,비행기와 배로 여행하다
fly dick : x,형사
flydrive : n,vi,비행기와 렌트카로 하는 여행. flydrive를 하다
flyer : n,비행기,나는 사람,급행 열차,쾌속정,투기,전단,삐라,쾅하고 떨어지다,(직선 계단의) 한단,(풍차의) 날개
flyer : n,=FLIER
flyfish : vi,제물낚시로 낚시질하다
flyfisher : n,제물낚시로 잡는 사람
flyfishing : n,제물낚시로 낚시질
flyflap : n,파리채
fly gallery : x,무대 양쪽의 무대 장치 조작대
flyin : n,병력,물자의 공수,자가용 비행기를 탄채 구경할 수 있는 야외 극장
flying : n,a,비행,질주,나는,급히 서두르는,공중에 뜨는,나는 듯이 빠른,솜나부랑이
flying barrel : x,(원통형 날개의) 수직 상승식 비행기
flying boat : x,비행정
flying bomb : x,비행폭탄
flying boxcar : x,대형 수송기
flying bridge : x,최상층의 선교,가교
flying buttress : x,부연 벽받이,벽날개(조붓한 연결 아치)
flying circus : x,(전투기의) 원형 사다리꼴편대,곡예 비행(단)
flying club : x,비행(가) 클럽
flying colors : x,휘날리는 깃발,승리,성공
flying column : x,유격대
flying corps : x,항공대
flying crane : x,배행하는 크레인(수송용 대형 헬리콥터)
flying deck : x,(항공모함의)비행갑판
flying disk : x,비행 접시
flying doctor : x,먼곳의 환자에 비행기로 왕진하는 의사
flying dragon : x,날도마뱀
Flying Dutchman : x,희망봉 부근에 출몰한다고 하는 유령선(의 선장)
flying fatigue : x,=AERONEUROSIS
flying field : x,작은 비행장
flying fish : x,날치
Flying Fortress : x,하늘의 요새(2차 대전시의 B17 증폭격기)
flying fox : x,큰박쥐
flying frog : x,날개구리
flying gurnard : x,가슴지느러미로 활공하는 죽지성대과의 바닷물고기
flying handicap : X,FLYING START로 행하는 핸디캡 경주
flying horse : x,=HIPPOGRIFF,(회전목마 등의) 말모양의 자석
flying jib : x,세모꼴 돛
flying jump : x,도움닫기 높이 뛰기
flying leap : x,도움닫기 높이 뛰기
flying lemur : x,날다람쥐 원숭이
flying lizard : x,=FLYING DRAGON
flying machine : x,항공기
flying man : x,비행가
flying mare : x,(레슬링)업어치기
flyingoff : n,이륙
flying officer : x,공군장교,공군중위
flying party : x,유격대
flying phalanger : x,날다람쥐
flying rings : x,(체조용)조환
flying saucer : x,비행접시
flying school : x,항공비행학교
flying sheet : x,=FLY SHEET
flying spot : x,TV비점
flying squad : x,기동경찰대
flying squadron : x,유격 함대,유격대
flying squid : x,대형 오징어의 한종류
flying squirrel : x,날다람쥐
flying start : x,(자동차 경주 등에서) 달리면서 끊는 스타트,신속한 시작
flying trapeze : x,공중그네
flying visit : x,황급한(화급한) 방문,지나기는 길의 방문
flying wedge : x,(선수,경찰관 등의) V자꼴이동 대형
flying wing : x,무미익 비행기
flyleaf : n,(책의권두,권말의)백지
fly loft : x,무대 천장
flyman : n,전세 유람 마차의 마부,무대 장치를 맡아 보는 사람
fly net : x,방충망
flyoff : n,(복수 후보기의) 성능 비교 비행,기종 선정 비행
flyover : n,전시(공중 분열) 비행,의례 비행,고가 횡단 도로
flypaper : n,파리잡이 끈끈이
flypast : n,=FLYOVER
fly pitch : x,무허가 노점장
fly pitcher : x,무허가 노점상
flypost : vt,(포스터를) 몰래 붙이다,...에 삐라를 몰래 붙이다
fly rail : x,(테이블의 접게된 판을 받치는)회전 까치발
fly rod : x,제물 낚싯대
fly sheet : n,삐라,전단,안내(사용 설명서)
flysheet : n,(우천때 천막위에 덧치는) 방수 외포
flyspeck : n,vt,파리똥 자국,...에 조그마한 얼룩을 찍다,더럽히다
fly spray : x,파리 잡는 분무약
flyswatter : n,파리채
flyte : vi,n,말다툼하다,욕하다,악담하다,말다툼,악담
flyte : n,vi,=FLITE
flytip : vt,(쓰레기를)아무데나 버리다. flytipper n.
flytrap : n,파리통,파리풀
flyunder : n,고가 철도 밑을 지나는 철도
flyway : n,철새의 통로
flyweight : n,플라이급 선수
flywheel : n,조속륜,플라이 휠
fly whisk : x,(말총 등으로 만든 자루 달린) 파리채
fnumber : n,F 넘버(렌즈의 밝기 표시)
foal : n,vt,vi,망아지,망아지를 낳다
foam : n,vi,vt,거품,거품을 일게 하다,(말이)거품을 내뿜다,바다,거품이 일다. foamingly ad. foamless a. foamlike a.
foam block : x,폼 블록
foam extinguisher : x,거품 소화기
foam glass : x,발포 유리
foam rubber : x,스폰지 고무
foamy : ,거품의,거품이 이는,거품 같은. foamily ad. foaminess n.
fob : n,바지의 시계 주머니,fob에서 늘어진 시곗줄
fob : vt,속이다(fob some thing off on a person 아무에게 안기다)
fob chain : x,시계줄(끈,리본)
FOBS : x,fractional orbital bombardment system,(유도탄의) 저 궤도 폭격 체제
fob watch : ,FOB에 넣는 시계
focal : a,초점의
focal distance : x,초점거리
focal distance : x,초점거리
focal infection : x,병소감염
focalization : n,초점 집중
focalize : vt,초점에 맞추다,(주의 등을) 집중시키다
focal length : x,초점거리
focal plane : x,촛점면(개폐식셔터)
focal plane shutter : x,포컬 플레인셔터(사진기의 초점면 개폐 장치)
focal point : x,초점
focal ratio : x,=F-NUMBER
foci : n,FOCUS의 복수
foco : n,게릴라 거점
focus : n,vt,vi,초점,초점 맞춤,중심,집중점,진원,병소,초점거리,초점에 모으다,초점을 맞추다,집중시키다. focusable a. focuser n.
focus group : x,포커스 그룹(테스트할 상품에 대해서 토의하는 소비자 그룹)
focusing cloth : x,(초점을 맞출 때 씌우는) 덮개천
focusing coil : x,집속 코일
focusing glass : x,초점 확대경
fodder : n,vt,마초(를주다),가축의 먹이,사료,꼴,마초,(적의 포화에 희생되는) 병사들
FOE : x,Friends of the Earth 지구의 벗(국제 환경보호 단체)
foe : n,적,원수,적군,(경기 등의)상대
foehn : n,푄(산에서 내리 부는 건조하고 따뜻한 바람)
foeman : n,적(병)
foetal : a,=FETAL
foetalization : n,=FETALIZATION
foetation : n,=FETATION
foeticide : n,=FETICIDE
foetus : n,=FETUS
foetus : n,fetus
fofarraw : n,=FOOFARAW
fog : n,vt,vi,안개,혼미,당혹,안개로 덮다,당황케 하다,안개가 끼다,(음화,인화가) 흐려지다
fog : n,vt,(벤 뒤에 자라난) 두번째 풀 (베기),선채로 마른 풀,풀을 서서 마른 채로 내버려 두다
fog(e)y : n,시대에 뒤진사람,구식 사람
fog alarm : x,농무 경보
fogball : n,연구,강속구
fog bank : x,무봉
fogbank : n,무봉(해상에 층운 모양으로 끼는 짙은 안개)
fog bell : x,무종(짙은 안개 속에서 경계신호로 배가 울리는)
fogbound : a,(배가) 짙은 안개로 오도 가도 못하는
fogbound : a,(배가)짙은 안개로 오도 가도 못하는
fogbow : n,안개 무지개,무홍
fogbroom : n,(비행장 등의) 안개 소산 장치
fogdog : n,=FOGBOW
fogey : n,=FOGY
fogger : n,살충제 분무기,농무 신호수
foggily : ad,안개가 짙게,(안개가) 침침하여,오리무중에
foggy : a,안개짙은,흐릿한,당황한,흐린,빛이새어 흐려진
Foggy Bottom : x,미국무성의 통칭
foghorn : n,농무 경적,크고탁한 소리
fogism : n,구식 사람의 기질,구습의 고수
fog lamp : x,(자동차의) 안개등
fogle : n,명주 손수건(목도리)
fogle heister : x,소매치기
fogle hunter : x,소매치기
fogless : a,안개 없는,뚜렷이 보이는
fog level : x,(현상된 필름의) 미노출 농도
fog light : x,(자동차의) 안개등
fog signal : x,철도의 농무 신호(궤도 위에 놓는 폭명 장치),안개신호
fog siren : x,농무(경보)사이렌
fogy : n,시대에 뒤진 사람,구식 사람
fogyish : a,케케묵은,구식의
foh : int,=FAUGH
fohn : n,푄(고산에서 불어내리는 건조한 열풍)
FOI : x,freedom of information
FOIA : x,Freedom on Information Act
foible : n,약점,결점
foie gras : x,집오리의 간장 요리,진미
foil : vt,(상대방,계략 등을) 좌절시키다,뒤엎다,(공격을) 물리치다,(쫑겨 달아난) 짐승의 발자취
foil : n,플러레(칼끝을 동그랗게 해 놓은 연습용 펜싱칼),(펜싱의) 플러레 종목
foil : n,vt,(금속의)박,(요리용)알루미늄 박,(보석의 밑에 까는)금속 조각,(거울 뒤의)아말감,박을 입히다,뒤에 박을 붙이다
foil capsule : x,(고급 술병 등의) 구경부를 싼 금속박
foiling : n,꽃잎 장식,(사슴등의) 냄새 자국,취적
foilsman : n,FOIL로 펜싱하는 사람
foin : n,vi,(검,창 등으로) 찌름,찌르기,찌르다
foison : n,풍작,풍부,힘,능력
foist : vt,(가짜를)안기다,슬그머니 삽입하다,(부정한 기록 등을) 몰래 써 넣다
Fokker : n,포커기(제1차 대전 때의 독일 전투기)
folacin : n,a,엽산(의),엽산염
fold : vt,vi,n,접다,개키다,(팔을)끼다,안다,싸다,접히다,개켜지다,접음,주름,켜,주름살,접은 금(자리),습곡,양우리
fold : n,vt,가축 우리,양 떼,집회,(양을) 가두다,우리에 넣다
foldaway : a,접는 방식의
foldboat : n,=FALTBOAT
folded dipole : x,접친 다이폴(안테나)
folder : n,접는 사람(기계),접지기,접책,접이 팜플릿,종이 끼우개
folderol : n,겉꾸민 싸구려,하찮은 장신구,객적은 수다
folding : a,접는,접을 수 있는,저게된
folding door : x,접게된 문
folding green : x,=FOLDING MONEY
folding money : x,지폐
foldout : n,(잡지의) 접어 넣은 페이지
foldup : a,접을 수 있는,접게 된
Foley Square : x,연방 수사국,FBI
folia : n,FOLIUM의 복수
foliaceous : a,잎같은,잎이 많은 얇은 조각으로 이루어진. foliaceousness n.
foliage : n,(한초목의)잎,잎장식
foliaged : a,잎으로 덮인,잎무늬 장식이 있는,...의 잎을 가진
foliage leaf : x,보통 잎,본엽
foliage plant : x,관엽 식물
foliar : a,잎의,잎모양의,잎의 성질을 가진
foliate : a,n,vt,vi,잎이있는,잎이 남,잎 장식,책의 장수 매기기,입을 내다,얇은 잎으로 갈라지다,입사귀 모양의 장식으로 꾸미다
foliated : a,잎모양의,잎이 달린,얇은 잎사귀 모양의
foliation : n,잎이 남,잎 장식,책의 장수 매기기
folic acid : x,엽산(빈혈의 특효제)
folie de grandeur : x,과대망상
folio : n,a,vt,이절지,전지의 2절,한장,(책의) 장수,(문서의 길이의) 단위 어수,2절판의,장수를 세다
foliolate : a,작은 잎의,작은 잎으로 이루어진
foliole : n,작은 잎
folio publishing : x,종이에 인쇄하는 재래식 출판업
foliose : a,잎의,잎이 많은,잎과 같은
folium : n,박층,엽선
folivore : n,엽식동물
folk : n,사람들,민족,가족
folk art : x,민속 예술
folkcraft : n,민속 공예(품)
folk custom : x,민속
folk dance : x,향토무용(곡)
Folkestone : n,포크스턴
folk etymology : x,통속어원설
folkie : n,a,민요가수,포크 뮤직 팬,포크 뮤직의
folkish : a,미속풍의
folklife : n,민중 생활(연구)
folklike : a,미속풍의
folk lore : n,민간 전승,민속학
folklore : n,민간전승,민속학. folkloric a.
folklorism : n,민속 연구
folklorist : n,민속학자
folkloristics : n,민속학,민속연구
folk mass : x,포크 미사(전통적 음악대신 포크 뮤직을 곁들이는 미사)
folk medicine : x,민간 요법
folk memory : x,한 민족이 공유하는 기억
folkmoot : n,(앵글로 색슨 시대의 주나 도시의) 민회
folkmot : n,(앵글로 색슨 시대의 주나 도시의) 민회
folkmote : n,(앵글로 색슨 시대의 주나 도시의) 민회
folk music : x,민속음악
folknik : n,포크송 팬,가수
folkpop : n,a,포크팝(민요의 멜로디와 가사를 채택한 팝 음악)(의)
folk psychology : x,민족 심리학
folkrock : n,포크록(포크송에 록의 리듬을 가미한 것)
folkrock : n,포크록(포크송에 록의 리듬을 가미한 것). folkrocker n.
folksay : n,통속어,속어 표현
folksinger : n,민요 가수
folk society : x,민속 사회(작고 고립하여 동질성을 갖고 결속이 강한 지역 사회)
folk song : x,민요
folkster : n,=FOLKSINGER
folk story : x,=FOLKTALE
folksy : a,서민적인,상냥한,사교적인. folksiness n.
folk tale : x,민간설화,전설
folkways : n,습속,민속,사회적 관행
folkweave : n,결이 거친 직물
folky : a,n,=FOLKSY,흔해 빠진,진부한,=FOLKIE
follicle : n,소낭,난포,골돌과
follicular : a,소낭 모양의,여포성의,(과실이) 대과 모양의
folliculin : n,폴리큘린(발정 호르몬)
follow : vt,vi,n,~을 따라가다,~에 계속하다,~에 따르다,~의 결과로 일어나다,추적하다,종사하다,이해하다,뒤따르다,추종,추구,(음식점에서) 더 청하는 음식
follower : n,수행자,종자,부하,추적자,선봉자,애인
followership : n,=FOLLOWING,피지도자의 능력
following : a,n,prep,다음(의),순풍의,종자,문하,...에 이어,...후에,수행원,부하
followingup : a,=FOLLOWUP
followmyleader : n,=FOLLOWTHELEADER
followon : n,속행 제2회전,후속되는 것,후속 공격
follow scene : x,이동 촬영한 장면
follow shot : x,밀어치기,(피사체에 맞춘) 이동 촬영
followtheleader : n,대장놀이(대장이 된 어린이의 동작을 모두가 흉내내는 어린이 놀이)
followthrough : n,배트를 완전히 휘두름,(계획 등의) 실행,완수
followup : n,a,추적,연속적인(권유편지)
folly : n,어리석음,어리석은 짓,우론,어리석게 돈만 많이 들인 물건(사업,건물)
Folsom : a,폴섬 문화의(북미 대륙로키 산맥 동부의 선사시대 문화)
Folsom man : x,(선사시대의)폴섬인
foment : vt,찜질하다,(반란 따위를)조장하다,선동하다
fomentation : n,선동,찜,찜질약
fomenter : n,조장자,유발자
fomites : n,(감염) 매개물(옷,침구 등)
fond : a,좋아서,애정있는,다정한,정에 무른,사랑에 빠진,실없는,어리석은
fond : n,레이스의 바닥 천,기초,토대
fondant : n,퐁당(과자의 장식용으로 쓰이는 크림모양의 당과)
fondle : vt,vi,귀여워하다. fondler n.
fondling : n,귀여워하는 아기,애완 동물
fondly : ad,다정하게,귀여워해서,무르게,어리석게도
fondness : n,도타운 사랑,자애,기호,취미,경신
fondu : n,폰듀(백포도주에 치즈를 녹인 냄비요리로 빵 등에 얹어 먹음)
fondue : n,폰듀(백포도주에 치즈를 녹인 냄비요리로 빵 등에 얹어 먹음)
font : n,세례,원천,샘,기름통
font : n,종류와 크기가 같은 활자 한벌
Fontainebleau : n,퐁텐블로(파리 남동쪽의 도시)
fontal : a,샘의,원천의,근원을 이루는,세례반의,세례의
fontanel : n,솟구멍,정문
fontanelle : n,솟구멍,정문
fontina : n,(이탈리아산) 양젖 치즈
font name : x,세례명
food : n,식품,식량,자양분,(마음의)양식
food additive : x,식품 첨가물
foodaholic : n,식욕 과잉인 사람,병적인 대식가
Food and Agriculture Organization : x,(유엔) 식량 농업 기구
Food and Drug Administration : x,식품 의약국(보건 교육 복지성의 일부)
food bank : x,식량 은행(극빈자용 식량 저장 배급소)
food basket : x,곡창지대
food blockade : x,식량봉쇄
food chain 1 : x,먹이연쇄,식료품 연쇄점
food color : x,식품 착색제
food control : x,식량 관리(비상시의)
food cycle : x,먹이순환
foodgatherer : n,(수렵) 채집민
foodgathering : a,(수렵) 채집생활의
food irradiation : x,(보존을 위한 감마선의) 식품조사
foodless : a,먹을 것이 없는
foodlift : n,식량의 긴급 공수
food poisoning : x,식중독
food processor : x,식품 가공기
food pyramid : x,먹이 피라미드
food science : x,식품 과학
food stamp : x,식량 배급표(저소득자에 대해 연방 정부가 발행하는)
foodstuff : n,식료품,식량,영양소
food value : x,(식품의) 영양가
food web : x,먹이망
fooey : int,=PHOOEY
foofaraw : n,싸구려 장신구,싸고 번지르르한 것,과시,하찮은 일로 야단 법석을 떨기
foofoorah : n,싸구려 장신구,싸고 번지르르한 것,과시,하찮은 일로 야단 법석을 떨기
fool : n,vt,vi,a,바보,어릿광대,우롱하다,속이다,어리석은 짓을 하다,농담하다,희롱하다,=FOLLISH
fool : n,풀(삶은 과일을 으깨어 우유 또는 크림에 섞은 것
fool's cap : x,어릿광대의 방울달린 깔때기 모자
fool's errand : x,헛걸음,헛수고,도로
fool's gold : x,황철광,황동광
fool's paradise : x,가공의행복,헛된 기대
fool duck : x,오리의 일종(사람을 겁내지 않음)
foolery : n,어리석은 짓
foolhardy : a,무모한,소견머리 없는. foolhardily ad. foolhardiness n.
fool hen : x,뇌조(사람을 겁내지 않으므로 쉽게 잡힘)
fooling : n,어리석은 짓,광대짓,장난
foolish : a,미련한,바보같은,하찮은
foolishly : ad,바보같이,어리석게도
foolishness : n,어리석음
foolocracy : n,우인 정치,지배 계급의 우인들
foolproof : a,바보라도 할 수 있을만큼 수월한
foolscap : n,대판양지(13x17인치)
foot : n,vt,vi,발,발부분,걸음,보병,산기슭,(페이지)아랫 부분,(물건의)최하부,말석,꼴찌,운각,걷다,딛다,(양말에)족부를 대다
footage : n,피트수,피트 단위의 척도
footandmouth disease : x,아구창(가축의 입이나 발굽에 생기는 전염병)
football : n,vt,vi,축구(공),손님을 끌기 위한 싸구려 상품,축구를 하다,손님을 끌기 위하여 원가 이하로 팔다
football : n,축구경기자,축구 선수
football pool : x,풋볼 도박
footbath : n,발씻기,발씻는 대야
footboard : n,발판,디딤판
footboy : n,사환
foot brake : x,밟는 브레이크
footbridge : n,인도교
footcandle : n,1피트촉광(1피트거리에 있는 표준초의 밝기)
footcandle : n,1피트 촉광(1피트 거리에 있는 표준 초의 밝기)
footcloth : n,깔개,(말의 등에 걸치는) 장식용 천
footdraggng : n,지체,느림,망설임
footed : a,발이 있는,발이...한,...발의
footer : n,보행자,축구,신장,(키가) ...피트인 사람(것)
footfall : n,발걸음,발소리
foot fault : x,(테니스)서브 할 때 라인을 밟는반칙
footfault : vt,vi,...에게 풋폴트를 선언하다,풋폴트를 범하다
foot front : x,(집 등의) 정면의 폭
footgear : n,발에 신는 것
Foot Guards : x,근위 보병 연대
foothill : n,산기슭의 작은언덕
foothold : n,발판,거점
footie : n,=FOOTSIE
footing : n,발밑,발판,입장,확고한 지반,지위,관계,합계,스텝 밟기,편제,정원
footinmouth : a,실언을 잘하는
footinmouth disease : x,실언벽
footle : n,vi,a,바보같은일,바보같은 소리하다,바보같은 짓을 하다,일을 적당히 하다,헛소리. footler n.
footless : a,발 없는,실체가 없는,미답의,서투른,쓸모없는,무능한
footlights : n,각광,풋트라이트,무대,배우직업
footling : a,바보같은,시시한,하찮은
footlocker : n,(침대곁에 두는 군인의)사물함
footloose : a,가고싶은 곳에 갈 수 있는,자유로운
footman : n,(제복입은)종복,하인
footmark : n,발자국
footmuff : n,(보온용)발싸개
footnote : n,각주
footpace : n,보통걸음(속도),연단,(층계의)층계참
footpad : n,(도보의)노상강도,우주선 연착륙용 각부
foot page : x,급사,(예전의) 시동
footpan : n,발 씻는 대야,탕파
foot passenger : n,보행자,통행인
footpath : n,작은길
foot pavement : x,(포장된) 인도,보도
footplate : n,(초기 기관차의) 발판
footpound : n,피트파운드(일의 양의 단위)
footpoundsecond : a,피트,파운드,초 단위계의
footprint : n,발자국
foot pump : x,발로 밟는 공기 펌프
footrace : n,도보 경주
footrail : n,발걸이
footrest : n,(이발용 의자 등의) 발판,발결이
footrope : n,디딤줄(돛을 걷을 때의),건널 밧줄
foot rot : x,(소,양의) 부제증
foot rule : n,피트자
footscald : n,발바닥의 염증
footscraper : n,신발 흙털개
footsie : n,농탕질,시룽거리기,걸음마
footsiewootsie : n,발,댄스
footslog : vi,(진창길,장거리를) 애써 나아가다,도보 행진을 하다
footsloger : n,도보자,보병
footslogging : n,a,보행자(의),보병(의),도보 행진(의)
foot soldier : x,보병
footsore : a,발병 난
footstalk : n,엽병,잎자루,화경,잎자루 꼴의 돌기
footstall : n,등자(여성용 안장의),주충돌(기둥 등의)
footstep : n,걸음걸이,발소리,보폭,발자국
footstock : n,(공작 기계의) 심압대
footstone : n,받침돌,초석
footstool : n,발판,발받침
footsure : a,발디딤이 든든한
footton : n,피트톤(1톤의 중량을 1피트 올리는 일의 양)
foot warmer : x,각로,탕파,발 보온 장치(예전에 철도 객차에서 사용)
footway : n,보도,작은길
footwear : n,신는 것(양먈,신발,슬리퍼 따위)
footwell : n,(차의 운전석 또는 조수석의) 발 밑 공간
footwork : n,발놀림,걸어다니는 취재,발 기술
foot worn : a,밟아서 닳은,너무 걸어 피곤한,발이 아픈
footy : a,n,빈약한(사람)(것)
footy : n,=FOOTSIE,축구
foozle : n,vt,vi,실책,잘못침,서투른 짓을 하다,실수하다,잘못 치다
fop : n,멋쟁이,멋
fopling : n,경박한 맵시꾼
foppery : n,겉치레,멋부리기,어리석은 짓
foppish : a,멋 부리는,맵시내는. foppishly ad. foppishness n.
for : prep,conj,...,대신,...을 향하여,...을 위해,...을 지지하여,...용으로,...동안,...와 교환으로,...때문에,...에 관해서,...치고는,...에게(는),...에 대하여,왜냐하면 ...이니까
fora : n,FORUM의 복수
forage : n,vt,vi,꼴,마초,징발,식량을 찾아헤맴,식량을 주다,마초를 찾아 다니다,...에게서 마초를 징발하다,약탈하다,마초를 주다
forage cap : x,(보병의) 약모
forager : n,마초 징발 대원,약탈자
foramen : n,소공,구멍,주공
foramen magnum : x,대후두공
foraminate : a,작은 구멍이 있는
foraminated : a,작은 구멍이 있는
foraminifera : n,유공충
forasmuch as : x,...이므로
forasmueh : ad, forasmueh as ...인 까닭에
foray : n,vt,vi,침략하다,약탈하다,침략,약탈,손대기. forayer n.
forbad : n,forbid의 과거
forbade : n,forbid의 과거
forbear : n,=FOREBEAR
forbear : vt,vi,억누르다,참다,삼가다,그만두다
forbearance : n,관용,인내,참음,자제,(채권자의 권리 행사의) 보류
forbearing : a,참을성 있는 관대한. forbearingly ad.
forbid : vt,금하다,금지하다,허락지않다,방해하다
forbiddance : n,금지
forbidden : v,a,forbid의과거,금지된,금단의
Forbidden Ciy : x,금단의 도시(북경의 자금성)
forbidden degree : x,금혼 촌수
forbidden fruit : x,금단의 열매(아담과 이브가 따 먹고 에덴 동산에서 쫓겨남),불의 쾌락
forbidden ground : x,금단의 장소,토의해서는 안되는 문제,말해서는 안되는 일
forbidden line : x,(스펙트럼의) 금제선
forbidder : n,금지하는 사람,금지자
forbidding : a,싫은,장소,가격등 가까이하기 어려운,인상 등이 험상궂은
forbidding : a,가까이하기 어려운,험학한,무서운. forbiddingly ad.
forbore : v, forbeardml 의 과거
forborne : v,FORBEAR의 과거분사
forby : prep,ad,...의 가까이에,...이외에,...은 말할 것도 없이,곁에,그 위에
forbye : prep,ad,...의 가까이에,...이외에,...은 말할 것도 없이,곁에,그 위에
force : n,vt,힘,완력,폭력,무력,경찰대,지배력,압력,효력,(억지로) 떠맡기다,강요하다,억지로 ...시키다,강탈하다
force : n,폭포
force cup : X,=PLUMBER'S HELPER
forcedchoice : a,강제 선택의,양자 택일의
force de dissuasion : n,(핵무기의) 억제력
force de frappe : n,핵무 장군
forcedful : a,힘있는,힘찬,세찬. forcefully ad. forcefulness n.
forcedlanding : n,불시착
forcedly : ad,무리하게,강제로
forcedmarch : n,강행군
forced sale : x,공매(집달리가 하는 경매 처분)
force feed : x,압력 급유
forcefeed : vt,억지로 먹이다,억지로 받아들이게 하다
force field : x,힘의 장
forceland : vi,vt,(항공기가) 불시착하다,(항공기를) 불시착시키다
forceless : a,힘없는,무력한
forcemajeure : n,(강국의 약소국에 대한)압력,불가항력(계약 불이행이 허용되는)
forcemeat : n,양념한 다진고기
forceout : n,병살
force play : x,포스플레이
forceps : n,핀셋,겸자,핀셋처럼 생긴 기관(곤충 등의)
force pump : x,밀펌프,무자위
forcer : n,강제자,밀펌프의 피스톤
forcible : a,강제적인,강력한,유효한,설득력 있는. forcibleness n. forcibility n.
forciblefeeble : a,힘센 듯하나 실은 약한,겉보기만 센
forcibly : ad,억지로,힘으로,강제적으로,힘차게
forcing : n,강제,폭행,탈취,발육 촉진(법),촉성(재배)
forcing bed : x,촉성 재배용 온상 온실
forcing house : x,촉성 재배 온실,교과 과정이 한정되어 있는 학교
forcing pump : x,=FORCE PUMP
forcipate : a,핀셋 모양의
forcipated : a,핀셋 모양의
forcite : n,포사이트(발파용 다이너마이트의 일종)
Ford : n,Gerald R(1913,)미국 38대 대통령(재직1974~1977),Henry(1863~1947)미국의 자동차 제작자
ford : n,vi,vt,여울,여울을 건너다,걸어서 건너다
fordable : a,걸어서 건널 수 있는
fordo : vt,죽이다,멸망시키다,지치게하다
fordone : a,지친
fore : a,ad,n,prep,int,전방에,전방,전면(to the fore 전면에,눙에 띄는 곳에,곧 도움되어,살아 있어),(항공기) 기수(쪽)에,...의 에,이 위험하다
foreandaft : a,이물에서 고물까지의,세로의
foreandaft cap : x,뒤에 챙이 있는 모자
foreandafter : n,종범선
foreandaft rig : x,종범 장치
foreandaft sail : x,종범
forearm : n,팔뚝
forearm : vt,미리 무장하다,준비하다
forebay : n,취수지,상부 저수지
forebear : n,조상
forebode : vt,vi,전조를 보이다,예감이 들다,예언하다. foreboder n.
foreboding : n,전조,예감
forebodingly : ad,전조로서,예감적으로
forebrain : n,전뇌
forecabin : n,이물 선실
forecaddie : n,포캐디(공이 멈춘 위치를 알리는 캐디)
forecast : n,vt,예상,예보,예정,예상하다
forecaster : n,예측자,(일기) 예보관,기상 통보관
forecastle : n,전면간판,선수루
forecd : a,강제의,억지로 지은,억지의(forced snile 억지 웃음)
forecited : a,앞서 인용한
foreclosable : a,(저당물의) 유질 처분이 가능한
foreclose : vt,vi,못들어오게 하다,방해하다,배제하다
foreclosure : n,저당물,환수권 상실,유전
forecourse : n,포코스,전장 돛
forecourt : n,마당,(테니스,베드민턴 등의) 포어 코트
foredated : a,당긴 날짜를 적은
foredeck : n, 갑판
foredo : vt,=FORDO
foredone : a,=FORDONE
foredoom : vt,미리 운명을 정하다
fore edge : x,가장자리,(책의 등에 대하여)  단면
foreend : n,(물건의) 끝,(총상의) 전상
foreface : n, 얼굴(네발짐승의 눈보다	부분)
forefather : n,조상
Forefathers' Day : x,청교도 상륙 기념일(12월21일)
forefeel : vt,n,예감하다,예감
forefend : vt,=FORFEND
forefinger : n,집게 손가락
forefoot : n,앞발
forefront : n,맨앞,최전부,최전방
foregift : n,권리금,보증금
forego : vt,선행하다,앞의,전술한
foregoer : n,선 사람(것),지도자,선례,선인,선대,조상
foregoing : a,n,앞의,전술한,앞서 말한 것
foregone conclusion : n,처음부터 알고 있는 결론
foreground : n,전경,가장 두드러진 지위
forehand : a,n,ad,vi,vt,정타의,최전부의,선두의, 위치,말의 반신,포핸드로,포핸드로 치다
forehanded : a,정타의,장래에 대비한,검약한,유복한. forehandedly ad. forehandedness n.
forehead : n,이마,(물건의) 부분
forehock : n,돼지의 다리 위쪽의 고기
foreign : a,외국의,외래의,이질의,관계없는
foreign affairs : n,외무,국제관계
Foreign Affairs Committee : x,하원 외교 위원회
foreignaffiliated firm : x,외국계 회사
foreign aid : n,해외원조
Foreign and Commonwealth Office : x,외무 연방성
foreign bill : x,외국환 어음
foreign bill of exchange : x,외국환 어음
foreignborn : a,외국태생의
foreignbuilt : a,외국에서 건조한
foreign capital : x,외자
foreign correspondent : x,(신문,잡지의) 해외 특파원
foreign currency reserve : x,외화 보유(고)
foreign debt : x,외채
foreign deposit : x,해외 예금
foreign devil : x,양놈
foreigner : n,외국인,이인,이방인,외국선
foreignexchange : n,외국환
foreignflag : a,(비행기,선박이) 외국 국적의
foreigngoing : a,외국행의,외항의 (선박)
foreign investment : x,해외 투자
foreignism : n,외국품 모방,외국 어법,외국풍(의 습관)
foreignlegion : n,외인부대
foreign loan : x,외채
foreign mail : x,외국 우편
Foreign Minister : x,(영,미 이외의) 외무부 장관
foreign mission : x,외국 사절단,외국인 선교(단체)
foreignness : n,외래성,이질성,외국풍
Foreign Office : x,외무부
foreign policy : x,외교 정책(방침)
foreign relations : x,외교 관계,외교 문제(분야)
Foreign Relations Committee : x,상원 외교 위원회
foreign reserve : x,외화 보유(고)
foreign reserve : x,외화 준비(금)
Foreign Secretary : x,(1969년까지의) 외무부 장관
foreign service : x,(군대의) 외국 근무,(외무부의) 외무 직원
foreign trade balance : x,해외 무역 수지
foreigntrade zone : x,외국 무역 지대
foreign word : x,외국어의 단어,외래어
forejudge : vt,(판결에 의해) (권리,물건을) 박탈하다,(사람을) 추방하다
forejudge : vt,미리 판단하다
foreknow : vt,미리알다
foreknowledge : n,예지
forel : n,앙피지의 일종
foreland : n,전면의 토지,곶
foreleg : n,앞다리
forelimb : n,(척추 동물의) 다리,(다리에 해당하는) 날개,지느러미
forelock : n,vt,쐐기(로 고정시키다)
forelock : n,앞머리
foreman : n,십장,직공장,배심장
foremast : n,앞돛대
foremilk : n,(사람의) 초유,(소의) 짜기 시작한 우유
foremost : a,ad,맨앞의,일류의,맨 먼저
forename : n,(SURNAME에 대한) 이름
forenamed : a,전술한,전기한
forenoon : n,오전
forenoon market : x,전장
forenotice : n,예고
forensic : a,법정의,토론의. forensically ad.
forensic medicine : x,법의학
forensics : n,웅변술,토론학
foreordain : vt,운명을 미리정하다
foreordination : n,(운명의) 예정,전생의 약속,숙명
forepart : n,앞부분
forepaw : n,앞발(개,고양이 등의)
forepeak : n,이물 화물창
fore plane : x,막대패
foreplay : n,(성행위의) 전희
forequarter : n,앞4반부
forereach : vi,vt,(엔진을 끄고) 타력으로 나아가다,다른 배를 앞지르다,(다른 배를)앞 지르다,우세하다
forerun : vt,앞장서다,앞지르다,예고하다
forerunner : n,선구자,전조,선인,선조
foresaid : a,전술한,앞서 말한
foresail : n,앞돛대,큰돛
foresaw : vt,vi,foresee의 과거
foresee : vt,예견하다,미리알다
foreseeable : a,예지할 수 있는
foreseeing : a,선견지명이 있는
foreseer : n,선견지명이 있는 사람
foreshadow : vt,예시하다,징조를 보이다
foreshank : n,(쇠고기의)앞다리 윗부분
foresheet : n,앞돛 아랫 밧줄,뱃머리의 좌석
foreshock : n,지진의 초기미동
foreshore : n,물가(간조선과 만조선과의 사이)
foreshorten : vt,원근법에 따라 그리다,...을 단축하다
foreshow : vt,예시하다
foresight : n,심려,전망,선견지명이 있음. foresightedness n.
foresighted : a,선견지명이 있는
foreskin : n,(음경의) 포피
forespent : a,=FORSPENT
forest : n,vt,숲,삼림,식림하다,숲으로 만들다,...에 식목하다
forestage : n,산림세,삼림 거주민의 부역,입목 벌채권
forestage : n,앞무대
forestal : a,삼림(지대)의,숲을 이룬
forestall : vt,앞지르다,선수쓰다,매점하다. forestaller n.
forestation : n,식림
forestay : n,앞돛대의 버팀줄
forestaysail : n,앞돛대의 앞밧줄에 맨 삼각돛
forested : n,vt,수목으로 뒤덮인,숲을 이룬
forester : n,삼림관,산림 감독관,산림지 거주자,산림 노동자,숲의 동물,(특히 숫놈의) 대형 캥거루,알락나방의 일종
forest fire : x,산불
forest green : x,짙은 황록색,암녹색
forestland : n,삼림지
forest preserve : x,보호림
forest ranger : x,삼림 감시원
forestry : n,임학,조림학,임업,산림 관리,삼림지
forest tree : x,삼림수,임목
foreswear : v,=FORSWEAR
foretaste : n,vt,시식,기대,예상,시식하다,예상하다
foretell : vt,예고하다,예언하다. foreteller n.
forethought : n,사전의 고려,심려
forethoughtful : a,(장래에 대한) 생각이 깊은,선견지명이 있는,미리 고려하는. forethoughtfully ad. forethoughtfulness n.
foretime : n,이전,왕년,과거
foretoken : n,vt,전조,조짐,~의 전조가 되다,전조를 보이다
foretold : n,앞니,문치
foretop : n,앞돛대의 망루
foretopgallant : a,앞돛대의 위쪽, 돛대의앞 
foretopman : n,앞돛대 망루 선원
foretopmast : n,앞돛대 톱슬(앞돛대의 가운데 돛을 다는 돛)
forever : ad,n,영원히,언제나,끊임없이,항상,영원
forevermore : ad,앞으로 영원히
forewarn : vt,미리 경계하다,경고하다
forewent : v,FOREGO의 과거
forewing : n,(곤충의) 앞날개
forewoman : n,여성직공장,여성배심원장
foreword : n,머리말,서문
forex : n,외국환,외환
foreyard : n,앞돛대의 (맨 아래)활대
forfeit : n,a,vt,벌금,몰수물,상실하다,몰수되다,상실,박탈,몰수된,상실한
forfeitable : a,상실할,몰수당할
forfeited game : x,몰수 게임
forfeiter : n,몰수 처분을 받는 사람
forfeiture : n,상실,몰수,벌금
forfend : vt,지키다,방호하다,피하다
forgat : v,forget의 과거
forgather : vi,=FORGATHER
forgather : vt,모으다,만나다,교제하다
forgave : v,FORGIVE의 과거
forge : n,vt,vi,철공장,쇠를 불리다,꾸며대다,단조공장,위조(모조)하다. forgeable a.
forge : vi,서서히 나아가다
forger : n,위조자(범인),날조자,거짓말쟁이,대장장이
forgery : n,위조,문서 위조(죄),위조 문서(도장,작품,화폐)
forget : vt,vi,잊어버리다,게을리하다,잊고 두고오다(가다),잊다,깜빡하다. forgeter n.
forgetful : a,잘 잊는,잊고
forgetfully : ad,잘 잊어버리고,깜빡 잊어서
forgetfulness : n,건망증,소홀,태만
forgetmenot : n,물망초
forgettable : a,잊기 쉬운,잊어야 할
forging : n,대장일,위조,단조품
forging industry : x,닺조물 산업
forgivable : a,용서할 수 있는
forgive : vt,vi,용서하다,빚을 탕감하다,삭히다
forgiven : v,FORGIVE의 과거분사
forgiveness : n,용서,면제,관대
forgiver : n,용서하는 사람,면제자
forgiving : a,(쾌히) 용서하는,관대한. forgivingness n.
forgivingly : ad,관대히
forgo : vt,없이때우다,절제하다,삼가다,끊다. forgoer n.
forgone : n,a,forego의 과거 분사,기왕의,선. foregoneness n.
forgot : v,FORGET의 과거 분사
forgotten : n,FORGET 과거분사(forgotten man 실업자)
forgotten man : x,(부당하게) 망각된 사람(중산 계급,노동자 계급에 속하는)
forhire : a,임대하는(자동차 등),돈으로 고용되는 (탐정 등)
forinstance : n,예,실례(example)
forint : n,포린트(헝가리의 화폐단위),1포린트 화폐
forjudge : vt,(판결에 의해) (권리,물건을) 박탈하다,(사람을) 추방하다
fork : n,vi,vt,a,포크,쇠스랑,아귀,갈래,갈라지게 하다,쇠스랑으로 던지다,가랑이꼴이 되다,포크를 쓰다,포크 모양으로 하다,포크로 찌르다,서서 먹는,입식의(식사)
forked : a,가랑이진,갈래진
forked tongue : x,일구 이언
forkedtongued : a,일구 이언하는
forkful : n,한포크 분
forkhander : n,왼손잡이 투수
forklift : n,포크리프트(짐을 들어올리는 크레인),지게차
fork lunch : x,(포크로 먹는) 입식 점심
fork supper : x,(포크로 먹는) 입식 만찬
forktailed : a,꼬리가 두 갈래 난
fork truck : x,지게차
forky : a,=FORKED
forlorn : a,버림받은,고독한,비참한,절망적인. forlornness n.
forlorn hope : x,허망한 기대,절망적 기도
forlornly : ad,쓸쓸한,의지할 곳 없이,절망적으로
form : n,vi,vt,모양,외형,모습,몸매,형식,방식,형,형성되다,생기다,대형이되다,형성하다,형체를 이루다,단련하다. formable a.
formagen : n,포르마겐(기관의 형태 등에 영향을 주는 물질)
formal : a,n,ad,모양의,형식상의,정식의,의례적인,딱딱한,정식으로하다,형식화하다,(야회복을 입고 가는) 정식 무도회,야회복,야회복으로. formalness n.
formal cause : x,형상인
formaldehyde : n,포름알데히드(방부,소독제)
formaldehyde : n,포름알데히드
formal education : x,형식적(정규) 교육
Formalin : n,포르말린
formalism : n,형식주의,허례허식,형식론
formalist : n,형식주의자,형식에 구애되는 사람
formalistic : a,형식주의의,형식에 지나치게 구애되는
formality : n,형식존중,딱딱함 형식적 행위,정식의 절차,의식
formalization : n,형식화,의례,의식을 갖춤
formalize : vt,vi,정식으로 하다,형식화하다,일정한 형태를 갖추게 하다,형식을 갖추다. formalizer n.
formal language : x,(수학,논리학 등) 형식언어
formally : ad,정식으로,형식적으로,의식에 얽매여,딱딱하게
formant : n,포르만트(모음의 구성 소음)
format : n,vt,체재,형,판,구성,테이프나 펀치가트에 넣는 기호 체계,...의 포맷을 지정하다
formate : n,포름산염
formate : vi,(비행기가) 편대비행하다
formation : n,형성,조직,구조,대형,편대. formational a.
formative : a,n,형성하는,구성하는,발달의,구성 요소(접두사 따위). formatively ad. formativeness n.
formative element : x,(단어의) 구성 요소(접미사,접두사,연결형 등)
form board : x,(콘크리트 공사의) 형틀
formbook : n,(경주마의 과거) 성적 안내서,(경주마,운동 선수에 대한) 예상
form class : x,형태류(형태적 특징을 공유하는 어군 등)
form criticism : x,양식 비평학
forme : n,판
formed : a,형성된,생물적 특징을 갖춘
former : n,형성자,구성자,만드는 도구,형,모형,권형
former : a,앞의,이전의,전자의
formerly : ad,먼저,전에,이전에(는),지난날(에)
formfitting : a,몸에 꼭끼는
form frag : x,(유체 속을 운동하는 물체의) 형상 항력
formful : a,폼이 멋진(볼만한)
form genus : x,형태속
formic : a,개미의,포름산의
Formica : n,포마이커(가구 등에 쓰는 내열성 합성 수지)
formic acid : x,포름산
formicary : n,개미집,개미탑
formicate : vi,개미처럼 기어다니다(떼지어 움직이다)
formication : n,의주감
formidable : a,만만찮은,무서운,방대한. formidableness n. formidability n.
formidably : ad,무섭게,만만하지 않게
formless : a,형태없는,무정형의,혼동한. formlessly ad. formlessness n.
form letter : x,같은 글의 편지(인쇄,복사된)
form master : x,학급 담임 교사
Formosa : n,대만
Formosan : a,n,대만의,대만 사람
form sheet : x,(경마의) 예상지,(후보자,경기자에 관한) 상세한 기록
formula : n,a,일정한 형식,식,공식,법식,처방,상투어,공식규격에 따른. formulaic a.
formula investing : x,포뮬러 플랜에 따른 투자(일정 계획에 따라 하는 증권 투자)
Formula One : x,포뮬러 원(배기량 1500-3000 c.c.의 엔진이 달린 경주차)
formula plan : x,FORMULA INVESTING에 있어서의 일정한 투자 계획
formularize : vt,공식으로 나타내다,식으로 하다. formularization n.
formulary : a,n,방식의,정식문,상투어,규정의,의식상의
formulate : vt,공식으로 나타내다,공식화하다. formulator n.
formulation : n,공식화,공식 표시,계통적 서술
formula writing : x,(교과서 등을) 정해진 규정에 의해서 쓰기
formulism : n,법식(공식)주의
formulist : n,법식(공식)주의자
formulistic : vt,=FORMULATE
form word : x,=FUNCTON WORD
fornicate : vi,사통하다,간음하다
fornication : n,사통,간음,우상숭배
fornicator : n,사통자,간음자
fornix : n,원개,뇌궁
forprofit : a,(공공 기관,병원 등이) 이윤을 목적으로 운영되는
forrader : ad,더 앞으로 (나아가)
forrarder : ad,더앞으로 (나아가)
forrel : n,앙피지의 일종
forrel : n,=FOREL
forsake : vt,저버리다,버리다
forsaken : a,버림받은,고독한. forsakenly ad. forsakenness n.
forsook : v,FORSAKE의 과거
forsooth : ad,참말이지,정말
forspent : a,지쳐 버린
forster child : x,양자
forswear : vt,vi,맹세코 끊다,거짓맹세하다,위증하다
forsworn : v,a,FORSWEAR의 과거 분사,위증한
forsythia : n,개나리속
fort : n,보루,성채
fortalice : n,작은 요새,요새
forte : n,장점,장기
forte : n,장점,특기,칼 몸의 가장 강한 부분
forte : a,ad,n,강음의,강하게,강음자리
fortepiano : ad,강하게 그리고 곧 약하게
forth : ad,prep,앞으로,보이는 곳에,밖으로(and so forth ...,등등,come forth 나타나다),...에서 바깥에
forthcoming : a,n,곧 나오려고,준비돼 있는,곧(닥쳐)올,출현,접근
forthcoming : a,곧 나오려고하는,준비돼있는,나타나려고 하는
forth market : n,장외시장
forthright : ad,a,솔직히,똑바로,솔직한,곧게 나아가는
forthwith : ad,n,당장,즉시,곧 실행해야할 명령
fortieth : a,n,제40의,40분의 1의,제 40,40번째
fortifiable : a,요새로 방비할 수 있는,방어 공사를 할 수 있는
fortification : n,방비,축성,방비시설,요새,강화
fortified wine : x,보강 포도주(알코올을 첨가한)
fortifier : n,축성가,강화하는 사람(물건),강장제,술
fortify : vt,vi,견고하게 하다,방어공사를 하다,높이다,요새화하다,요세를 쌓다,축성하다
fortis : n,a,경음,경음의
fortissimo : ad,매우 센,매우 강하고 크게,가장세게
fortississimo : ad,a,가능한 한 강하게(강한),포르티시시모로(의)
fortitude : n,용기,불굴의 정신,꿋꿋함
fortitudinous : a,불굴의 정신이 있는(을 가진)
Fort Knox : n,포트 녹스(Kentucky주의 연방 금괴 저장소 소재지)
fortnight : n,2주간,14일
fortnightly : a,ad,n,2주일에 한번의,격주 발간의,2주일 마다,격주 간행물
fortress : n,vt,요새,안전지대,요새로 방어하다
FORTRN : n,포트란
fortuitism : n,우연설. fortuitist n.
fortuitous : a,우연한,뜻밖의. fortuitously ad.
fortuity : n,우연성,우연,우연한 일
Fortuna : n,포르투나(운명의 여신)
fortunate : a,행운의. fortunateness n.
fortune : n,vi,vt,운,행운,부,재산,운명(have fortume on one's side),운수,우연히 일어나다,(남에게) 재산을 주다
fortune cookie : x,(중국 음식점 등에서 만들어 파는) 점괘가 든 과자
fortune cooky : x,(중국 음식점 등에서 만들어 파는) 점괘가 든 과자
fortune hunter : n,재산을 노리고 결혼하려는 사람
fortunehunting : a,n,재산을 노리는,재산을 노려 구혼하는,재산을 노린 구혼
fortuneless : a,불운한,재산이 없는,가난한,지참금이 없는
fortuneteller : n,점쟁이
fortunetelling : n,a,점,점치는
forty : n,pron,a,40의,40개,40,40세,
fortyeightmo : n,48절판(의 책,종이,페이지)
fortyfive : n,45구경 권초(보통,45라고 씀)
fortyfold : a,ad,40배의(로)
fortyniner : n,1849년 Californis로 금광을 찾아간 사람
forty winks : n,낮잠
forum : n,공회의 광장,법정,토론회,공공 광장
forward : ad,a,vt,n,앞으로,앞에,전방의,급진적인,진보적인,촉진하다,회송하다,발송하다,전방으로의,전진하는,자진해서 ...하는,철 이른,조숙한,나아가게 하다,전위적 분자,선봉
forward base : x,전진기지
forwardbased : a,(미사일 등이) 전진 기지에 배치된
forward bias : x,순 바이어스(반도체 소자에 전류가 흐르는 방향으로 거는)
forward contract : x,선물 계약
forward delivery : x,선도
forwarder : n,운송업자
forwarding : n,추진,촉진,발송,운송,회송
forwarding agent : x,운송업자
forwardlooking : a,앞을 향한,적극적인,진보적인
forwardly : ad,주제넘게,잘난 체하고,자진하여,앞으로
forward mutation : x,전진 돌연 변이
forwardness : n,진보의 빠름,(작물의) 올됨,조숙성,재빠름,건방진
forward pass : x,볼을 적의 골 방향으로 패스하기
forward rate : x,(외국환의) 선물 시세
forwards : ad,=FORWARD
forward voltage : x,순전압
forward wall : x,포워드 월
forwearied : a,기진맥진한
forwent : v,FORGO의 과거
forworn : a,기진맥진한
Fosbury flop : x,(도움닫기 높이 뛰기에서) 등을 밑으로 해서 넘기
foss : n,해자,도량,운하
fossa : n,와,(작은)구멍
fosse : n,해자,도량,운하
fossette : n,조그맣게 오목한 곳,보조개
Fosse Way : x,(영국의)포스 가도
fossick : vt,vi,폐광 등을 파헤쳐 (금을) 찾다,돈벌이 구멍을 찾다
fossicker : n,폐광 뒤지는 사람
fossil : a,n,화석의,시대에 뒤진,화석,구습의 사람,구제도. fossillike a.
fossil fuel : x,화석 연료(석유,석탄,천연 가스 등)
fossiliferous : a,화석을 함유한
fossilization : n,화석화,폐습화
fossilize : vt,vi,화석으로 만들다,화석 채집을 하다,시대에 뒤지게 하다
fossorial : a,굴을 파는,굴을 파기에 알맞은
foster : vt,기르다,양육하다,돌보다,촉진하다,(친부모와 같은) 애정을 주는(받는)
Foster : n,Stephen Collins(1826~1864)미국의 작곡자
fosterage : n,(수양 자녀의) 양육,양자로 보냄,양자임,육성,촉진,장려
foster brother : x,젖형제
foster care : x,수양 자식의 양육
foster daughter : x,양녀
fosterer : n,양육하는 사람,양부모,유모
foster home : x,수양아이를 맡아 기르는 집
fosterling : n,양자
fostermother : vt,양모(보모)로서 ...을 기르다
fostetr father : x,양부
fotog : n,사진가,카메라맨
foudroyant : a,전격적인,번개 같은,전격성의,급증의
fouette : n,푸에테(들어올린 다리를 채찍질하듯 급히 움직이기
fought : v,FIGHT의 과거 분사
foul : a,ad,n,vt,vi,더러운,악취있는,엉클어진,꽉막힌,반칙,더럽히다,더러워지다,반칙하다,불결해지다,(배가) 충돌하다,엉클어지다
foul anchor : x,엉클어진 닻
foulard : n,풀라천(일종의 얇은 비단),풀라천의 손수건
foul ball : n,파울볼
foul berth : x,(충돌 위험이 있는) 나쁜 정박 위치
foul bill : x,전염병 유행지 출항 증명서
foulbrood : n,(세균에 의한 꿀벌의 유충의) 부저병
foule : n,가벼운 모직 옷감
fouledup : a,혼란한,무질서한
foul fiend : x,악마
foul line : n,파울선
foully : ad,지저분하게,상스러운 말로,악랄하게,부정하게
foulmouth : n,입버릇이 상스러운 사람
foulmouthed : a,입이 건
foulness : n,불결,입이 상스러움,(날씨의) 사나움,불결한것,부정,악랄
foul papers : x,초고
foul play : n,반칙,부정행위
foul proof : x,교정을 본 교정지
foul shot : x,=FREE THROW
foulspoken : a,=FOULMOUTHED
foul strike : x,파울 스트라이크
foul tip : x,파울팁
foulup : n,혼란,(기계의) 고장
foumart : n,악취를 내는 족제비(유럽산)
found : a,n,FIND의 과거,과거분사,(방,배 등이) 설비를 갖춘,지식,교양이 있는,(급료 이외의 무료 제공의) 숙식
found : vt,vi,기초를 두다,근거로하다,창설자,시조,주조하다,설립하다,...에 근거하다
found : vt,(금속을) 녹이다,녹여 붓다,주조하다,(유리 제품을) 만들다
found art : x,파운드 아트(쉬르레알리슴에서 주장되는 예술)
foundation : n,토대,기초,근거,창설,설립
foundational : a,기본의,기초적인. foundationally ad.
foundation cream : x,밑화장 크림
Foundation Day : x,=AUSTRALIA DAY
foundationer : n,장학생
foundation garment : x,(몸매를 맵시있게 하는) 여자용 속옷
foundation muslin : x,안감용 모슬린
foundationnet : n,파운데이션 네트(빳빳한 레이스,망사)
foundation school : x,재단 설립 학교
foundation stone : x,주춧돌,초석
founded : a,기초(근거)가 ...한
founder : n,창설(설립)자,창건한 사람
founder : n,주조자,주물공
founder : n,제엽염
founder : vi,vt,무너지다,넘어지다,침수되어 침몰하다,계획이 실패하다,(배를) 침수하여 침몰시키다,(토지,건물 등을) 무너뜨리다
founder's kin : x,설립자의 근친
founder member : x,창립회원,발기인
founders' shares : x,(회사의) 발기인주
foundership : n,창설자임,발기인의 자격
founding father : x,(국가,제도,시설,운동의) 창립자,창시자
foundling : n,기아,주운아이(founding hospital 고아원)
foundling hospital : x,기아 양육원
found object : x,=OBJET TROUVE
foundress : n,여성창립자
foundry : n,주조장,주조법
foundry iron : x,주철
foundry proof : x,정판전의 최종 교정쇄
foundry type : x,수조판 활자
fount : n,샘
fount : n,=FONT
fountain : n,vi,vt,샘,분수,원천,분출하다(시키다)
fountain : n,샘,분수,원천,기름통,잉크 통
fountainhead : n,수원,근원
fountain pen : x,만년필
four : n,pron,n,4(on all fours 네 발로 기어,꼭 들어 맞아),4의,4개(명)의,넷,4개 한벌,4시,4개
four ale : x,1 quart 4펜스의 맥주
fourale bar : x,싸구려 맥주집,술집
fourbagger : n,2조의 페어로 하는 시합
four balls : x,사구
fourbit : a,50센트의
four bits : x,50센트
fourbyfour : n,4단 변속의 4륜 구동의 트럭
fourchannel : a,=QUADRAPHONIC
fourchette : n,음순 소대,(말의) 제차,차골
fourcolor : a,(황,적,청,흑의) 4색에 의한,4도의
fourcolor conjecture : x,(지도 제작의) 4색 가설
four corners : x,네거리
fourcycle : a,4주기의
fourdimensional : a,4차원의
fourdimensioned : a,=FOURDIMENSIONAL
foureyed : a,네눈의,안경을 쓴
foureyes : a,네눈박이 물고기,안경을 쓴 사람
four flush : x,(포커에서) 다섯장 중 같은 조의 패 넉장밖에 안되는 것,허풍,허세
fourflush : vi,(포커에서)같은 조의 패가 넉장밖에 안되는데 다섯 장인 체하다,허세 부리다,허풍치다
fourflusher : n,허세를 부리는 사람,(포커에서) FOURFLUSH하는 사람
fourfold : a,n,4중의 ,4배의,4배,4중
fourfooted : a,네발달린,네발의
fourfoot way : x,4피트 규격의 궤간(표준 궤간)
four freedoms : x,4개의 장(1941년 미국 대통령 F,D,Rossevelt가 선언한 인류의 기본적 자유)
fourfunction calculator : x,사칙 (전자) 계산기
fourgon : n,(프랑스의) 포장 짐수레
fourhand : a,네 손 달린 (원숭이 등),네사람이 하는(게임 등),2인 합주의 (피아노 곡)
fourhanded : a,네 손 달린 (원숭이 등),네사람이 하는(게임 등),2인 합주의 (피아노 곡)
FourH club : x,4H 클럽(head,hand,heart,health를 모토로 하는 농촌 청년 교육 기관)
Four Hundred : x,사교계의 사람들
Fourier : n,푸리에
Fourierism : n,푸리에주의(푸리에의 공상적 사회주의)
Four IIundred : x,지역 사회의 엘리트,상류 사회
fourinhand : n,a,ad,4두마차,매듭넥타이,말 네필이 끄는,마부 한사람이 네필의 말을 몰아
fourleaf clover : n,네잎클로버
fourleafed clover : n,네잎클로버
fourleaved clover : n,=FOURLEAF CLOVER
fourlegged : a,네다리의
fourletter : a,외설의,난잡한
fourletter man : x,역겨운 남자,바보 같은 녀석
fourletter word : x,4글자 말(비속한 말)
fourminute mile : x,4분이내에 주파하는 1마일 경기
Four Modernizations : x,(중공의) 네가지 근대화(농업,공업,국방,과학기술)
fouro'clock : n,분꽃
fouroar : n,노가 넷인 보트
fourpart : a,4부 합창의
fourpence : n,4펜스,옛영국의 4펜스 은화
fourpenny : a,4펜스의
fourpenny bit : x,4펜스 은화
fourpenny one : x,강타
fourpenny piece : x,4펜스 은화
fourplex : a,n,=QUADPLEX
four pointer : x,(성적 평가의) A,수,우수한 학생
four point stance : x,4점 스탠스
fourpost : a,사주식의 (침대)
fourposter : n,4기둥의 대형침대
fourpounder : n,4파운드 포,무게 4파운드의 물건
fourragere : n,(프랑스,미 육군에서 왼쪽 어깨의) 장식술
fourscore : a,80의
four seas : x,(영국을 둘러 싼) 사면의 바다
fourseater : n,4인승
foursome : n,a,포섬(4인이 2조로 나눠)그것을 하는 4사람,4인조,넷으로 된,4인용의
foursquare : a,ad,n,4각의,솔직한,견고한,정사각형으로,견고히,정사각형,정방형
fourstar : a,4성의,(호텔 등이) 우수한
fourstriper : n,해군 대령
fourstroke : a,(내연 기관이) 4행정의
fourteen : a,n,pron,ad,14의,네(번)째의,4분의 1,제4,4등품,4번째의 사람(것),네(번)째로
fourteenly : ad,네(번)째로
fourteenth : n,a,제14회의 열네째의,14분의 1의
fourth : a,제 4의,4분의 1의
fourth class : ㅌ,4등급,4종우편물
fourthclass : a,4종우편물의
fourth cover : x,(잡지의) 표지 4
fourth dimension : n,제4차원. fourthdimensional a.
fourth estate : ,제4계급,언론계
fourthestate : n,신문계,언론계
fourth generation computer : x,제4세대 컴퓨터
Fourth International : x,제4인터내셔널
fourthly : ad,네째로
Fourth Republic : x,(프랑스의) 제4공화국
Fourth Revolution : x,제4의 혁명
fourth wall : x,제4의 벽(무대와 관객 사이를 떼어 놓는 보이지 않는 수직면(공간)
Fourth World : x,제4세계(제3세계 가운데서 자원이 없는 나라들)
fourwall : vt,(영화를) 영화관을 세내어 자주 상영하다
fourway : a,사방으로 통하는,네사람이 하는
fourwheel : a,4륜식의
fourwheel drive : x,4륜 구동
fourwheeled : a,4륜식의
fourwheeler : n,4륜차,4륜 합승 마차
fourwheeler : n,4륜마차
fovea : n,=FOVEA CENTRALIS
fovea centralis : x,(망막의) 중심와
fowl : n,vi,닭,가금,새,들새를 잡다,엽조를 사냥하다
fowl cholera : x,가금 콜레라
fowler : n,들새 사냥꾼
fowling : n,들새 포획,새사냥
fowlingpiece : n,새총
fowl pest : x,가금 페스트
fowlrun : n,양계장
fox : n,vi,vt,여우,여우모피,교활한 사람,속이다,변색시키다
Foxbat : n,소련의 전투기,MIG-25의 속칭
fox brush : x,여우 꼬리
fox earth : x,여우굴
foxed : a,시어진 (맥주),변색한,여우 빛 얼룩이 진 (책 등)
fox farming : x,양호업,여우 사육
fox fire : x,썩은 나무의 발광,도깨비불
foxglove : n,디기탈리스(약용)
fox grape : x,(북미 원산의) 신 야생 포도
foxhole : n,참호
foxhound : n,여우사냥 개
fox hunt : x,여우사냥
foxhunt : vi,여우사냥을 하다
fox hunter : x,여우사냥꾼
foxhunting : n,a,여우사냥(하는)
foxily : ad,교활하게
fox mark : x,(습기 때문에 생긴 책 등의) 갈색 반점
fox paw : x,과오
fox sleep : x,꾀잠
fox squirrel : x,여우 다람쥐
foxtail : n,여우의 꼬리,금강아지풀,뚝새풀
foxtail millet : x,조
fox terrier : x,폭스테리어(애완견)
foxtrot : vi,n,폭스트롯을 추다,폭스트롯,그 무곡,완만한 속보의 일종,
foxy : a,여유같은,교할한,여우털빛의,변색한
foxy : a,n,여우 같은,교활한,여우 빛깔의,(맥주 등) 신,=FOX TERRIER. foxiness n.
foyer : n,휴게실,현관의 홀
Fra : n,수사의 칭호(이름 앞에 붙임)
frabjous : a,멋진,즐거운
fracas : n,싸움,소동
fractal : n,차원 분열 도형
fraction : n,단편,부분,분수,파편,조금
fractional : a,분수의,단편의,우수리의
fractional currency : x,소액 통화
fractional distillation : x,분류
fractionalize : vt,(기구,조직 등을) 분할하다,나누다
fractionally : ad,분수적으로,단편적으로
fractional orbital bombardment system : x,부분 궤도 폭격 체제
fractional page space : x,(페이지의) 소분할 스페이스
fractionary : a,분수의,아주작은,단편적인
fractionate : vt,분별하다
fractionation : n,분류(법)
fractionize : vt,작게 나누다,분수로 나누다
fractious : a,성마른,다루기 힘든
fractography : n,금속 파면 등의 현미경 관찰
fractural : a,파쇄성의,골절의
fracture : n,vt,vi,부숨,갈라진 틈,금,골절,부수다,부러뜨리다,골절하다,부서지다
fraenum : n,=FRENUM
frag : vt,수류탄으로 죽이다
fragile : a,부서지기 쉬운,몸이 약한. fragilely ad.
fragility : n,부서지기 쉬움,여림,허약,허무함
fragment : n,vt,vi,파편,단편,미완성 유고,부서진 조각,산산이 부수다,산산 조각이 되다,부서지다
fragmental : a,=FRAGNENTARY,쇄설질의. fragmentally ad.
fragmentarily : ad,단편적으로,단편으로서,토막토막으로
fragmentary : a,파편의,단편으로 이루어진
fragmentate : vt,vi,파편으로 만들다,파편이 되다,부수다
fragmentation : n,파쇄,분열,붕괴
fragmentation bomb : x,파쇄 폭탄
fragmentation grenade : x,파쇄 수류탄
fragmentize : vt,vi,분열시키다,분단하다
fragrance : n,방향,향기로움
fragrancey : n,방향,향기로움
fragrant : a,냄새가 좋은,상쾌한
fragrantly : ad,향기롭게
fraidcat : n,겁쟁이
fraidycat : n,겁쟁이
frail : n,골풀바구니(건포도,무화과 등을 담는),한바구니 분
frail : a,n,허약한,무른,성격이 약한,유혹에 빠지기쉬운,여자. frailly ad. frailness n.
frailty : n,여림,무름,약함,약점,단점
fraise : n,와책
fraise : n,(시계 톱니바퀴의 톱니를 깎는) 프레즈반,구멍 넓히는 송곳
framable : a,짜 맞출 수 있는,편제할 수 있는,고안해 낼 수 있는
frambesia : n,=YAWS
framboise : n,프랑부아즈(나무 딸기로 만드는 브랜디)
frame : n,a,vt,vi,구조,조직,기구,뼈대,모양,체격,액자,테,나무테의,목조의,틀을 잡다,짜맞추다,틀어 끼우다,(어떤 목적에) 적합하게 하다,진행하다,(일이) 됨직하다
frame aerial : x,프레임 안테나
frame antenna : x,프레임 안테나
framed : a,틀에 낀
frame house : x,(판자를 댄) 목조 가옥
frame house : x,목조 가옥
frameless : a,틀 없는
frame line : x,테두리 선,(영화 필름의) 토막줄
framer : n,짜는 사람,액자 세공사
framesaw : n,틀톱
frameshift mutation : x,프레임시프트 돌연 변이
frame timber : x,뼈대용 재목,늑재
frameup : n,(아무를 조에 빠뜨리는)계략,음모,조작된 죄
framework : n,틀,뼈대,구성,구조,체제
framing : ,구성,짜맞추기,구상,획책,틀ㅜ
franc : n,1프랑화폐,프랑
France : n,프랑스
France : n,프랑스
Frances : n,여자 이름
Francesca : n,여자 이름
franchise : n,vt,선거권,특권,총판권,...에 특권을 주다
franchisee : n,총판권을 받는 사람
franchiser : n,=FRANCHISEE,=FRANCHISOR
franchise tax : x,면허세,영업세
franchisor : n,총판권을 주는 사람
francicize : vt,(상업활동등을) 프랑스어로 하다
Francis : n,남자이름
Franciscan : a,n,프란체스코회의(수사)
Francis of Assisi : x,아시아의 성 프란체스코
francium : n,프란슘
Franck : n,Cesar(1882~1890)벨기에 태생의 프장스 작곡가
Franco : n,Francisco(1892~1975)스페인의 군인,총통
FrancoAmerican : n,a,프랑스계(특히 프랑스 캐나다계)미국인(의)
francolin : n,자고새속의 총칭
Francophil : a,n,친불의,친불파의 사람
Francophile : a,n,친불의,친불파의 사람
Francophobe : a,n,프랑스를 무서워하는(사람)
Francophobia : n,프랑스 공포
francophone : n,a,프랑스어를 하는 (사람)
Francophonic : a,프랑스어를 말하는
francophonic : a,프랑스어를 하는
franctireur : n,(프랑스 육군의) 비정규병,게릴라병
Frandkenstein : n,자기를 파멸시키는 괴물이나 파괴력을 창조하는 사람
franger : n,=CONDOM
frangible : a,부서지기 쉬운,약한. frangibleness n. frangibility n.
frangipane : n,프랜지페인
frangipani : ,협죽도과의 관목,그 향수
Franglais : n,프랑스어화한 영어
frank : a,솔직한,터놓은,숨김없는,공공연한
frank : vt,무료로 부치다,무료 송달이 되게 ...에 서명하다,무료 송달의 서명
frank : n,=FRANKFURT(ER)
Frank : n,프랑크족의 사람
Frankenstein : n,프랑켄슈타인
Frankenstein's monster : x,자기가 만들어낸 저주의 씨
Frankenstein monster : x,자기가 만들어낸 저주의 씨
frankfort : n,프랑크푸르트 소시지
frankforter : n,프랑크푸르트 소시지
frankfurt : n,프랑크푸르트 소시지
frankfurter : n,프랑크푸르트 소시지
frankincense : n,유향
frankingmachine : x,=POSTAGE METER
Frankish : a,n,프랑크 족의,프랑크 족의 언어
Franklin : n,남자이름,프랭클린
franklin : n,자유 보유 지주,미국의 정치가,과학자
frankly : ad,솔직히,숨김없이,터놓고
frankness : n,솔직,터놓음
frankpledge : n,10인조,10인조의 일원
frantic : a,심히 흥분한,미친,광란의,미친 사람 같은. franticly ad. franticness n.
frantically : ad,미친 듯이,극도로 흥분하여
frap : vt,(밧줄로) 꼭 졸라매다
frappe : a,n,(얼음으로) 차게 한,살짝 얼린 과즙,진한 밀크셰이크
frappe : a,얼음으로 냉각한
frass : n,(유충의) 똥,(벌레가 나무를 파먹고 내는) 가루 부스러기
frat : n,=FRATERNITY
fratch : vi,n,다투다,언쟁하다,언쟁,불화,싸움
frater : n,동포,형제,남학생 클럽 회원
fraternal : a,형제의,우애의. fraternally ad.
fraternal association : x,우애 조합
fraternalism : a,우애
fraternal order : x,우애 조합
fraternal society : x,우애 조합
fraternal twins : n,이란성 쌍생아
fraternity : n,형제간,우애 조합,동업자들
fraternity house : x,남학생 클럽 하우스
fraternization : n,친화,친목,친교
fraternize : vi,형제로 사귀다,친하게 사귀다. fraternizer n.
fratery : n,수도원의 식당
fratricide : n,형제 살해(자). fratricidal a.
fratry : n,수도원의 식당
frau : n,부인,아내,독일 여인
fraud : n,사기,협잡,부정 수단,사기꾼,가짜
fraudulence : n,기만,사기,부정
fraudulency : n,기만,사기,부정
fraudulent : a,사기의,사기적인,속여서 손에 넣은. fraudulently ad.
fraught : a,~을 내포한,~으로 가득 차 있는,~을 가득 실은,충분한
Fraunhofer lines : x,프라운호퍼선
fraxinella : n,백선
fray : vt,vi,문지르다,닳아 빠지게 하다,풀다,해지다,해어지다,풀리다,마모되다
fray : n,떠들 썩 한 싸움,다툼
fraying : n,닳아 해어짐,닳아 해어진 것
frazil : n,(격류중에 생기는) 결빙
frazzle : vt,vi,n,닳아 빠지다,지치게 하다,너덜 너덜 한 상태,지치게 하다(지치다),(너덜너덜) 닳아 해어짐,기진맥진(한 상태)
frazzled : a,닳아빠진,지친,술에 취한
freak : n,a,vi,vt,변덕,기형,괴물,진기한,별난,변덕을 부리다,괴상한 짓을 하다
freak : vt,n,얼룩지게 하다,얼룩
freaked : a,얼룩진
freakish : a,변덕스러운,일시적 기분의,기형적인,괴상한. freakishly ad. freakishness n.
freakout : n,마약 사용에 의한 황홀상태,히피화
freaky : a,n,=FREAKISH,마약으로 어찔어찔한,히피의,환각제 상용자. freakily ad. freakiness n.
freckle : n,주근깨,얼룩이 생기다
freckly : a,주근깨투성이의
Fred : n,남자이름
Freda : n,여자이름
Freddy : n,남자이름
Frederick : n,남자이름,프로이센의 여러 왕
free : a,n,vt,자유로운,자주적인,분방한,솔직한,규칙에 구애되지 않는,한가한,고정되어 있지않은,자유롭게,무료로,(사람을) 자유의 몸으로 하다
free agent : x,자주적인 행위자,자유계약 선수
free air : x,자유대기
freeair : a,야외의,(도시 아동을 위한) 교외 산책의
free alongside ship : x,수출항 선측도로
free alongside vessel : x,수출항 선측도로
freeassociate : vi,자유 연상하다
free association : x,자유 연상(법)
free atmosphere : x,자유대기
free baggage allowance : x,무료 수하물 허용 중량
free ball : x,프리볼
free base : x,프리 베이스(코카인과 에테르의 혼합물)
freebasing : n,마약을 순화하기
freebie : n,공짜의 것
freeboard : n,건현(홀수선과 상갑판과의 사이)
freeboot : vi,(해적이) 약탈하다
freebooter : n,약탈자,해적
freebooter : n,해적
freebooting : n,해적 행위
freeborn : a,자유민으로 태어난,자유민 다운
freeby : n,공짜의 것
Free Church : x,자유 교회,비국교파 교회
free city : x,자유시(독립 국가로 된)
free coinage : x,자유 주화(제)
free companion : x,용병단의 일원
free company : x,용병단
free competition : x,자유 경쟁
freed : v,free의 과거분사
freedman : n,노예 신분에서 해방된 자유민
freedom : n,자유,자유독립,특권,해면,면제,자유사용권
Freedom 7 : x,프리덤 세븐(미국 최초의 유인 위성)
freedom fighter : x,자유의 투사,반체제 운동가
Freedom Flotilla : x,자유의 선단
freedom of information : x,정보의 자유
Freedom of Information Act : x,정보의 자유법
freedom of the city : x,도시 공민권,명예 시민권
freedom of the seas : x,공해의 자유,(특히 전시의 중립국 선박의) 공해의 자유 항행권
freedom ride : x,(인종 차별 철폐를 위한) 남부 지방에의 버스,기차 여행
freedom rider : x,자유의 기수
freedoraller : n,무법자
freedwoman : n,(노예의 신분에서 해방된) 여자 자유민
free economy : x,자유(주의) 경쟁
free electron : x,자유 전자
free energy : x,자유 에너지
free enterpeise : n,(정부의 간섭을 받지 않은)자유기업
freefall : n,자유 낙하
free fight : x,난투,난전
freefirezone : n,무차별 폭격지대(움직이는 것을 빠짐 업시 사격 당하는 지대)
free flight : n,타력비행(로켓의 동력 정지 후의)
freefloating : a,(기분이) 막연한 상태에 있는,자유로이 움직이는,부동성의
free flyer : x,자유 비행 페이로드
freeflying system : x,자유 비행 시스템
freeforall : n,a,누구나 참가할 수 있는 경기,난투,입장 자유의,누구나 참가할 수 있는
free form : n,자유형식
freeform : a,자유형의,좌우 불균형의,자유로운 형식의
Free France : x,자유 프랑스
freefree : a,고도로 이온화된 기체중의 자유 전자의 운동에 의한
Free French : x,자유 프랑스 인민
free gold : x,프리골드
free goods : n,비과세품,자유재
freegratis : ad,무료로
free hand : x,자유 재량,행동의 자유
freehand : a,ad,n,손으로 그린(freehand drawing 자재화),자재화법으로,자재화
freehanded : a,통이큰 ,한가한
freehearted : a,쾌할한,자발적인,솔직한
freehold : n,자유보유권
freeholder : n,자유보유권의 권리 보유자
free house : x,여러가지 상표의 주류를 파는 수집
free jazz : x,프리 재즈
free kick : n,프리킥
freekle : n,vt,vi,주근깨,얼룩이 생기게 하다,기미,주근깨가 생기다
freekled : a,주근깨가 있는
free labor : x,자유민의 노동,비조합 노동자
free lance : x,(중세의) 영주에 소속되지 않은 무사,용병,자유로운 입장에 있는 사람
freelance : vi,vt,a,자유계약으로 일하다,자유 계약의
freelancer : n,자유계약자,프리랜서
free list : x,자유 출입 허가 명단,기증자 명부
freeliver : n,미식가,쾌락주의자
free living : x,식도락
freeliving : a,미식의
freeload : vi,음식 등을 공짜로 얻어먹다,식객이 되다. freeloading n.
freeloader : n,(음식을) 공짜로 얻어먹는 사람,아무나 갈 수 있는 파티
free love : x,자유 연애
free lunch : x,서비스로 내는 간단한 점심,겉보기만 공짜 같은 것
freely : ad,자유로이,마음대로,인심 후하게,아낌없이
freeman : n,자유민,시민권등이 있는 공민
free market : x,자유시장
freemartin : n,(수컷과 쌍둥이로 태어난) 생식 기능이 없는 암송아지
Freemason : n,프리메이슨단 의회원. Freemasonic a.
Freemasonry : n,프리메이슨단의 주의,자연적인 우정
free money : x,자유 화폐
freeofcharge : a,공짜의,무료의,요금이 안드는
free on board : x,본선 인도의
free on rail : x,화차 인도의
free pardon : x,특사,은사
free pass : x,무임 승차(권),무료 입장권
free pistol : x,자유 권총
free port : n,자유항
freepost : n,요금 별납 우편
free press : ,자유 언론,출판의 자유
free radical : x,유리기
freerange : a,(닭 등을) 놓아 기르는
free rein : x,(행동의) 무제한의 자유
freereturn trajectory : x,자동 귀환 궤도
free ride : x,무임 승차,불로 소득
free rider : x,무임 승객,불로 소득자
free safety : x,프리 세이프티
free school : x,무료 학교,자유 학교
freesia : n,프리지어
free silver : x,은화의 자유 주조
free soil : x,자유 토지(노예의 사용을 허용하지 않은 지대)
freesoil : a,(남부 전쟁 전부터 노예 제도를 인정하지 않은)자유지역의
free speech : x,자유 언론,언론의 자유
free speecher : x,언론의 자유를 부르짓는 학생
freespoken : a,마음먹은대로 말하는,솔직한
freestanding : a,(조각,담 등이) 독립되어 있는,버팀 없이 서 있는
freestanding insert : x,(신문의) 별쇄 광고판
Free State : x,자유주
freestone : a,n,어느 쪽으로나 쪼개 지는,씨를 발라내기 쉬운,자르기 쉬운 암석,씨를 발라내기 쉬운 과일
freestyle : n,자유형. freestyler n.
freeswimmer : n,자유유영의 동물
freeswimming : a,자유 유영성의
freethinker : n,자유사상가
freethinking : a,자유 사상(을 지닌)
free thought : n,자유사상
free throw : x,자유퉁,(게임에서) 주사위를 굴리는 특권
free ticket : x,무료 입장표,사구
Freetown : n,프리타운
free trade : n,자유무역
free transportation : x,사구
free union : x,(남녀의) 동서
free university : x,(대학의) 자주 강좌,자유 대학
free verse : n,자유시
freeway : n,무료 고속도로
freewheel : n,vi,(자전거,자동차의) 자재륜,자유 회전 장치,(페달을 멈추고 또는 동력을 끊고) 타성으로 달리다
freewheeling : n,a,FREEWHEEL의 사용,자재륜의,자유 분방한,제멋대로의
free will : n,자유 의사
freewill : a,자유 의사의
Free World : n,자유세계
freeze : vi,vt,n,얼다,얼게하다,얼다,섬뜩하다,동결시키다,얼어죽다,결빙시키다,결빙,결빙기,혹한,(물가,임금 등의) 동결,고정
freezedry : vt,냉동 건조하다
freezedrying : n,냉동 건조(법)
freezeetching : n,동결 식각법
freezefracture : vt,vi,동결 파단하다
freezeframe : n,정지화면,스톱모션
freezeout : n,내쫓음,포커 놀이의 일종
freezer : n,냉동기,냉장고
freezer burn : x,냉동상
freezeup : n,결빙기,혹한기
freezing : a,n,어는,얼어 붙는,몹시 추운,냉동용의,태도가 쌀쌀한,냉동,결빙
freezingly : ad,얼 것처럼,얼도록,냉담하게
freezing mixture : n,한제(얼움과 소금의 혼합물 따위)
freezing point : n,빙점
freezing works : x,냉동 공장
freezling drizzle : x,결빙성의 진눈깨비
free zone : x,자유 지역
F region : x,(전리층의) F 층
freight : n,vt,화물수송,수상화물수송,운송화물,적하,운임,화물을싣다,출하하다
freight car : n,화차
freight depot : x,화물역
freight engine : x,화물 기관차
freighter : n,화물선
freight forward : x,운임 수취인 지불
freight forwarder : x,화물 운송업자
freight house : x,(철도의) 화물 보관소
freight insurance : x,운임 보험
freightliner : n,컨테이너 열차
freight rate : x,운임률
freight terminal : x,화물 조차장
freight ton : x,용적 톤
freight train : x,컨테이너 화물 열차,화물열차
freinghtage : n,화물 운송,운임,운송 화물
FRELIMO : n,모잠비크 해방 전선
fremitus : n,진탕음
French : a,n,vt,프랑스의,프랑스어,프랑스인,(꼬투리 완두를) 가늘게 자르다
French Academy : x,프랑스 한림원
French bean : n,강남콩
French boot : x,(주차 위반 차량의 바퀴에 끼워 발차를 못하게 하는) 바퀴 고정구
French bread : x,프랑스 빵
French Canadian : x,프랑스계 캐나다인,그 프랑스어
French chalk : x,(재단사의) 활석 분필,초크
French Community : x,프랑스 공동체(프랑스와 그 옛 식민지로 구성)
French Connection : x,프렌치 커넥션
French cricket : x,프랑스식 크리켓
French cuff : x,접어 커프스버튼을 끼우게 된 소매
French curve : x,운형자
French door : x,(경첩에 의해)좌우로 열리는 두짝 유리문
French dressing : x,프렌치 드레싱
French fact : x,Quebec주에 있어서의 프랑스어,프랑스 문화의 우위
French fried potatoes : n,프랑스식 감자튀김
French fries : x,프랑스식 감자 튀김
Frenchfry : vt,많은 기름에 담가 튀기다
French gray : x,초록색을 띤 회색
French Guiana : x,프랑스령 기아나
French heel : x,프렌치 힐
French horn : x,프렌치호른(소리가 부드러운 금관 악기)
French ice cream : x,우유와 계란 노른자로 만드는 커스터드
Frenchify : vt,프랑스식으로 하다,프랑스말 식으로 하다. Frenchification n.
Frenchism : n,=GALLICISM
French kiss : x,입속에 혀를 넣는 키스
French knickers : x,(폭이 넓은) 니커 바지
French knot : x,프랑스식 매듭
French leave : x,인사없이 가버리기
French letter : x,콘돔
French loaf : x,(가늘고 긴) 프랑스 빵
Frenchman : n,프랑스인,프랑스 말을 쓰는 사람
French pastry : x,프랑스식 파이
French polish : x,프랑스 니스,락칠
Frenchpolish : vt,락을 바르다,락으로 끝손질하다. Frenchpolisher n.
French postcard : x,춘화,외설 사진
French Republic : x,프랑스 공화국
French Revolution : x,프랑스대 혁명(1789~1799)
French Revolutionary calendar : x,프랑스 혁명력,공화력
French roll : x,프렌치롤(빵)
French roof : x,프랑스식 지붕
French seam : x,통솔
French telephone : x,=HANDSET
French toast : x,프렌치 토스트
fRench Union : x,프랑스 연합(본국 및 영토의 연맹:1958년 French Community로 개칭)
French Window : x,프랑스식 창(도어겸용의 좌우로 열게 된 큰 유리창)
Frenchwoman : n,프랑스 여자
Frenchy : a,n,프랑스풍(식)의,프랑스 사람
frenetic : a,열광적인. frenetically ad.
frenzy : vt,n,격앙시키다,격앙,열광,광란
Freon : n,프레온가스
frequency : n,자주 일어남,빈번한,빈발
frequency band : x,주파수대
frequency changer : x,주파수 변환기
frequency converter : x,주파수 변환기
frequency distribution : x,도수 분포
frequency modulation : n,주파수변조
frequency response : x,주파수응답
frequent : a,vt,자주 일어나는,상습적인,수많은,자주가다,늘모이다
frequentation : n,자주 감,습관적인 독서
frequentative : a,n,반복 표시의,반복 동사
frequenter : n,자주 가는 사람,단골 손님
frequently : ad,자주,종종
frere : n,형제,동지,수도사
fresco : n,vt,프레스코화,프레스코 그림을 그리다
fresh : a,n,ad,vt,vi,새로운,신선한,원기좋은,상쾌한,선명한,경험이없는,건방진,뻔뻔스러운,초기,새로이,새롭게하다
fresh air : x,공기가 신선한 야외의
fresh breeze : x,맑은 바람,(초속 9미터 전후의) 흔들바람,질풍
freshcaught : a,갓 잡은
freshen : vt,vi,새롭게하다,염분을 없애다(freshen up기운 나다,기운을 돋우다,몸치장하다),신선하게 되다
fresher : n,=FRESHMAN
freshet : n,큰물,홍수
fresh gale : x,큰 바람
freshly : ad,새로이,신선하게
freshman : n,a,(대학의) 신입생,1년생,(대학,고교의) 1학년생의
freshman week : x,(대학) 신입생 오리엔테이션 주간
freshness : n,새로움,신선미,생생함,선명
freshperson : n,(대학의) 신입생,1년생,새로 온 사람
freshrun : a,(연어 등이) 바다에서 강으로 방금 올라온
fresh water : x,민물,담수
freshwater : a,담수의
fresh water college : x,시골 대학
Fresnel mirrors : x,프레넬의 복경
fret : vt,vi,n,초조하다,먹어들어가다,부식하다,물결치게하다,애타다,안달하다,애달음,초조
fret : n,vt,뇌문,만자무늬,격자세공,뇌문으로 장식하다,만자형 세공으로 하다
fret : n,vt,프렛,...에 프렛을 달다
fretful : a,화를 잘내는,성마른. fretfully ad. fretfulness n.
fret saw : x,실톱
fretted : a,안달이 난
fretted : a,뇌문 무늬의
fretty : a,=FRETFUL
fretwork : n,도림질 세공,뇌문 세공,뇌문 무늬의 것
fretwork : n,뇌문,도림질 세공,뇌문 세공,뇌문 무늬의 것
Freud : x,Sigmund(1856~1936)오스트리아의 정신 분석학자
Freudian : a,n,프로이드설의 Geographical Society,프로이드파의 학도
Freudianism : n,프로이트설,정신분석학
Freudian slip : x,본심을 드러낸 실언
Freudism : n,프로이트설,정신분석학
Frey : n,프로이,프로이르
Freya : n,프로이야,피리야
Freyja : n,프로이야,피리야
Freyr : n,프로이,프로이르
FRF : x,flight readiness firing 예비 연소
friable : a,부서지기 쉬운
friar : n,수사,탁발승,수도원,수도회
friar's balsam : n,안식향
friar's lantern : n,도깨비불
Friar Minor : x,프란체스코회 수사
friary : n,수도원,탁발 수도회
fribble : vi,vt,n,쓸데없는 짓을하다,허비하다,낭비하다,쓸데없는 일(에 세월을 보내는 사람)
fricandeau : n,프리캉도(송아지,칠면조의 고기로 된 스튜)
fricando : n,프리캉도(송아지,칠면조의 고기로 된 스튜)
fricassee : n,vt,프리카세,프리카세 요리로 하다
frication : n,마찰,불화. frictionless a.
fricative : a,n,마찰로 생기는,마찰음
frictional : a,마찰의,마찰로 일어나는. frictionally ad.
frictional unemployment : x,마찰적 실업
friction ball : x,(베어링의)마찰 감소 볼
friction brake : x,마찰 브레이크
friction clutch : x,마찰 연축기
friction coupling : x,마찰 접합
friction gear : x,마찰기어
friction gearing : x,마찰 전동 장치
frictionize : vt,...에 마찰을 일으키다
friction loss : n,마찰손실
friction match : n,마찰성냥
friction pulley : x,마찰륜
friction tape : x,전선 절연용 테이프
friction wheel : x,마찰륜
Friday : n,ad,금요일,금요일에
Fridays : ad,금요일마다
fridge : n,냉장고
fried : v,a,fry의 과거,과거분사,기름에 튀긴
friedcake : n,도넛
fried egg : x,일장기,젖통
Friedman : n,프리드만 Milton
Friedmanite : n,프리드만 이론 신봉자
Friedmann universe : x,프리트만 우주
friend : n,vt,친구,벗,자기편,지지자,동지,근친,...의 친구가 되다
friendless : a,친구 없는. friendness n.
friendlily : ad,친구답게,친절하게
friendliness : n,우정,친절,친선
friendly : a,ad,n,친구의,우정이있는,친한,친절한,호의를보이는,형편좋은,붙임성 있는,친구처럼,친절,친선경기
friendly action : x,우호적 소송
friendly fire : x,아군에 대한 오발
Friendly Islands : x,프렌들리 제도
friendly lead : x,(지역 공동 사업의) 공제 자금 모집을 위한 위안회
friendly society : x,=BENEFIT SOCIETY
friendship : n,벗으로서 사귐,우정
friendship 7 : x,우정 7호(미국 최토로 지구 궤도를 비행한 유인 위성)
friendship treaty : x,우호조약
Friend virus : x,프렌드 바이러스
frier : n,=FRYER
Friesian : n,a,=FRISIAN,=HOLSTEIN
Friesic : a,n,=FRISIAN
Friesland : n,프리즐란드
frieze : n,프리즈,띠모양의 장식
frieze : n,프리즈,보풀을 세우다
frig : vi,vt,수음하다,(여자와) 성교하다,사기치다
frig : n,=REFRIGERATOR
frigate : n,세대박이 군함,프리깃함
frigate bird : x,군함새
Frigg : n,프리가,프리그
Frigga : n,프리가,프리그
frigging : a,빌어먹을
fright : n,vt,돌연한 공포,추악한 사람,우스운 사람,깜짝 놀라게 하다
frighten : vt,vi,소스라쳐 놀라게 하다,겁내다,을러대어 ~을시키다,놀라다,무서워하다
frightened : a,깜짝 놀란,겁먹은
frightener : n,공갈 전문의 깡패
frightening : a,무서운,놀라운,위급한. frighteningly ad.
frightful : a,무서운,추악한,지독한. frighteningness n.
frightfully : ad,무섭게,무시무시하게,지독히,몹시
fright wig : x,깜짝 가발
frigid : a,극한의,쌀쌀한,형식적인,딱딱한,불감증의. frigidly ad.
Frigidaire : n,전기냉장고
frigidarium : n,냉욕장
frigidity : n,한랭,냉담,쌀쌀함,불감증(여성의)
Frigid Zone : x,한대
frigorific : a,냉각시키는
frijol : n,강낭콩의 일종
frijole : n,강낭콩의 일종
frill : n,vt,vi,주름장식,목털,필요없는장식품,허식,주름장식을 하다
frilled : a,주름 장식을 한
frilled lizard : x,(호주산) 목도리 도마뱀
frillery : n,주름잡기
frillies : n,주름장식이 달린,란제리
frilling : n,주름 장식,주름장식재료,필름의 주름
frill lizard : x,(호주산) 목도리 도마뱀
frilly : a,주름 장식이 달린,야하게 장식한
fringe : n,vt,술,술장식,가장자리,가두리,술을달다,가를 두르다,...에 술을 붙이다
fringe area : n,프린지에어리어(라디오 텔리비젼의 시청 불량 지역)
fringe benefit : n,부가 급부
fringed : a,가두리 장식이 달린,(꽃잎 등이) 톱니처럼 째진
fringe group : x,비주류파
fringeland : n,변경,주변지대
fringe party : x,극소 정당
fringer : x,(정당,조직내의) 과격론자,(사회로부터의) 일탈자
fringe rating : x,주변 시간대 시청률
fringe theater : x,실험 극장
fringe time : x,고시청률 전ㅎ우의 시간대
fringing : n,a,술 붙임,가두리 장식(재료),(술 모양으로) 가두리를 꾸민
Fringlish : n,a,=FRENGLISH
fringy : a,술이 있는,술 모양의
frippery : n,싸고야한 옷,허식,과식
frippet : n,경박한 젊은 여자
Frisbee : n,플라스틱 원반
Frisbee golf : x,프리스비 골프
Frisco : n,=SAN FRANCISCO
frise : n,프리제천
frisette : n,앞 머리의 고수머리(여자의)
Frisian : n,a,프리즈랜드 사람,프리즐란드 사람(말)의
frisk : vi,vt,n,껑충껑충 뛰어 돌아 다니다,까불다,(가볍게) 뒤흔들다,뛰어 돌아다님,까붊,몸수색. frisker n.
frisket : n,종이 집게,(사진 제판의) 마스크
frisking : n,몸수색
frisky : a,기운 좋게 뛰어다니는,까부는
frisson : n,떨림,전율,스릴
frit : n,vt,(용융한) 유리원료,백옥유,용융하다,프릿화하다
frit fly : x,프릿파리
frith : n,내포,강어귀
fritillary : n,(백합과의) 패모 속의 식,표범나비
fritt : n,vt,(용융한) 유리원료,백옥유,용융하다,프릿화하다
fritter : vt,짤끔짤끔 낭비하다,잘게 자르다,갈기갈기 찢다. fritterer n.
fritter : vt,튀김
fritz : n,독일사람
fritz : n,vi,(기계등이) 고장나서,(몸 등) 컨디션이 나빠,고장내다
frivol : vi,vt,허송세월하다,보람없는 생활을 하다,낭비하다
frivolity : n,천박,경박,경솔한 언동,하찮은 일
frivolous : a,하찮은 ,경박한,시시한. frivolously ad. frivolousness n.
frizette : n,=FRISETTE
frizz : vi,vt,=FRIZZLE
frizz : vt,n,지지다,보풀보풀 하게 만들다,곱슬곱슬함,지진머리
frizzle : vt,vi,(고기등을 기름에) 지글지글 튀기다,(베이컨 등을) 꼬들꼬들하도록 튀기다,뜨거운 볕에 쬐다,(고기 등이) 지글지글 소리를 내며 튀겨지다
frizzle : vt,n,곱슬곱슬 해지다,지진머리
frizzling : a,지글지글 타는,몹시 뜨거운
frizzly : a,=FRIZZY
frizzy : a,지진 머리의,곱슬하게 지져진. frizziness n.
fro : ad,저쪽으로
Fro : n,=AFRO
fro : ad,저쪽에,이리저리,
frock : n,vt,부인복,작업복,성직자의 옷,프록을 입히다,성직에 취임시키다
frock coat : x,프록코트
froe : n,=FROW
Froebel : n,프뢰벨. froebelism n.
Froebelian : a,프뢰벨식의
frog : n,vi,개구리,말굽중앙의 연한 부분,늑골모양의 장식,개구리를 잡다. froglike a.
frogeater : n,개구리를 먹는 사람,프랑스 사람
frogeye : n,(탐배 등의) 백성병
frogfish : n,빨간씬벵이 무리
frogged : a,늑골 모양의 장식이 붙은
froggy : a,n,개구리가 많은,개구리 같은,차가운,개구리
frog hair : x,정치 자금 ,정치 헌금
frog kick : n,개구리차기
frogman : n,잠수 공작원
frogmarch : vt,넷이 팔다리를 붙들고 나르다
frogskin : n,1달러 지폐,콘돔
frog spawn : x,개구리 알,민물 홍조
frog spit : x,(거품 벌레의) 거품,민물 녹조의 일종
frog spittle : x,(거품 벌레의) 거품,민물 녹조의 일종
frolic : n,vi,장난,들떠떠듦,까붊,법석,장난치다,까불다,장난치며 놀다
frolicsome : a,까불거리며 뛰노는 흥겨운. frolicsomeness n.
frolicsomely : ad,까불거리며
from : prep,...에서 ...부터,...때문에...과달라,구별하여
fromenty : n,=FRUMENTY
Fromm : n,프롬(독일 태생의 미국 정신 분석학자)
frond : n,엽상체,잎
frond : n,잎,엽상체
frondage : n,잎,우거진 잎
Fronde : n,프롱드당,프롱드의 난
frondescence : n,발엽 상태. frondescent a.
front : n,a,vi,vt,ad,int,전면,표면,싸움터,전선,용모,태도,정면의,앞의,...을 향하다,앞면에 붙이다,정면으로,(군대 등에서) 으로
frontage : n,정면,가옥,토지의 정면의 폭,빈터,건물과 도로사이의 공지
frontage road : x,(고속도로와 평행으로 만든) 연락 도로
frontal : a,n,정(전)면의,전두골,이마뼈
frontal lobe : x,(대뇌의) 전두엽
frontal lobotomy : x,전두엽 절제술
front bench : n,의회의 정면석
front bencher : n,장관,야당간부
front burner : x,(가스레인지의) 앞쪽 버너,최우선
front court : x,프론트 코트
front door : n,정문현관
front edge : x,(책의) 앞마구리
front end : x,프론트 엔드(증폭,중간 주파수 변환부)
frontend : a,(사업 자금이) 착수 준비의,선불용의,착수금의
frontend bonus : x,프론트 엔드 보너스(장래의 회사 간부 유망자를 놓치지 않기 위해서 주는 통상 급여,수당 이외의 보너서)
frontend processor : x,전치계산기(단말 장치와 주계산기 사이에 두는)
frontenis : n,프론테니스(3벽면 코트에서 하는 테니스)
front foot : x,(집 등의)앞 면의 폭
front four : x,프론트 포(좌우의 trckle과 end로 형성되는 수비의 최전선)
front group : x,(위장한) 표면상의 조직(단체)
frontier : n,a,국경지방,개척의 영역,국(변)경의,국경에 있어서의
frontier industry : x,=PIONEERING INDUSTRY
frontier orbital theory : x,프론티어 전자 궤도 이론
frontiersman : n,변경의 주민,개척자 정신
frontier spirit : x,개척자 정신
frontispiece : n,vt,권두 삽화,정면,입구 위쪽의 합각머리,...에 권두화를 넣다
frontlash : n,(정치적 반동에 대한) 대항 조처
frontless : a,정면이 없는,뻔뻔스러운,염치없는
frontlet : n,이마,이마장식
front line : x,(활동,투쟁에서 책임있는 입장에 서는)선두,최전선,전선
frontline : a,전선(용)의,최전선의,비우호국과 인접한,우수한,일류의
front man : n,(부정단체 따위의)간판으로 내세운 사람
front matter : x,(책의) 전문
front money : x,착수자금
front name : x,(성에 대한) 이름,세례명
front office : n,회사따위의 본사,수뇌부
frontogenesis : n,전선의 발달
front page : x,(책의) 표제지,(신문의) 제1면
frontpage : a,신문의 제1면감의,중요한,제1면에 싣다
frontrank : a,일류의,최상의,가장 중요한
front room : x,앞쪽의 방
frontrunner : n,선두주자(말),선구자
frontrunning : a,선두를 달리는
frontsman : n,가게 전면에 서서 파는 점원
front vowel : n,앞모음
frontward : a,ad,정면을 향하는,전방으로
frontwards : a,ad,정면을 향하는,전방으로
frontwheel : a,(차 등의) 앞바퀴에 작용하는
frontwheel drive : x,전륜 구동,
front yard : x,(집의) 앞뜰
frore : a,서릿발치는,혹한의
frosh : n,대학1년생
frost : n,vi,vt,서리,빙결,결상,빙점이하의온도,냉담,서리로덮다,서리피해를 주다,서리가 내리다,(식품을) 급속 냉동하다
Frost : n,프로스트(미국의 시인)
Frostbelt : n,미국 북부를 동서로 뻗은 한랭 지대
frostbite : n,vt,동상,동상에 걸리게하다
frostbite boating : x,빙상 요트 경기
frostbiter : n,빙상 경기용 요트,빙상 요트 경기자
frostbiting : n,=FROSTBITE BOATING
frostbitten : a,동상에 걸린,상해를 입은
frostbound : a,얼어 붙은
frosted : a,n,서리로 덮인,서리가 내린,설탕을 하얗게 친,(우유,향로가 든) 진한 음료
frostfish : n,(북미산) 작은 대구류
frostfree : a,자동 성에 제거 장치가 달린,성에가 안 끼는
frost heave : x,땅이 얼어 지면을 밀어올리기
frostily : ad,서릿발치듯,냉담하게
frostiness : n,결상,혹한,냉담,서리같이 흼
frosting : n,설탕을 입힘,윤을 없앰,유리가루
frostlike : a,서리 같은
frost line : x,지하 동결 한계선
frostproof : a,얼지 않는
frostwork : n,성에,성에무늬 장식
frosty : a,서리가 내리는,추위가 매서운,싸늘한
frosty : a,서리가 내리는
froth : n,vt,vi,거품,시시한것,쓸데없는 얘기,거품을 일으키다,거품을 뿜다
frothblower : n,맥주 애음가
frothily : ad,거품을 뿜으며,헛되이,속없이
frothspit : n,(좀매미의) 뿜는 거품
frothy : a,거품 같은,거품 투성이의,천박한. frothiness n.
frottage : n,문지르기,성기를 남에게 대고 문지르는 자위
froufrou : n,비단스치는 소리,고상한 체함
frouzy : ,=FROWZYㅁ
frow : n,(통나무에서 통 짜는 널을 쪼개내는) 손도끼
frow : n,(기혼의) 네덜란드(독일)여자,여자
froward : a,빙퉁그러진,완고한,고집센. frowardly ad. frowardness n.
frown : vt,vi,n,눈살을 찌푸리다,상을 찡그리다,언짢은 얼굴,눈살을 찌푸려서 ...하게 하다
frowning : a,언짢은,찌푸린 얼굴의,험한. frowningly ad.
frowst : n,vi,(사람이 많이 모인 방의) 후끈함,후텁지근함,탁한 공기,악취,훈김으로 숨막히는 곳에 있다
frowstly : a,(사람이 많이 모여) 후끈한,퀴퀴한
frowsy : a,=FROWZY. frowsily ad. frowsiness n.
frowzy : a,추레한,악취가 나는,후텁지근한,너저분한. frowzily ad. frowziness n.
froze : v,FREEZE의 과거
frozen : v,freeze의 과거 분사,언,냉동의,극한의,동상에 걸린,얼음으로 덮힌,냉담한
frozen carbon dioxide : x,드라이아이스
frozen custard : x,냉동 커스터드
frozen food : n,냉동식품
frozen frame : x,=FREEZEFRAME
frozen limit : x,(견딜수 있는) 극한
frozenly : ad,언것 같이,완고하게
frrghopper : n,거품 벌레
fructiferous : a,열매를 맺는
fructification : n,(식물의) 결실,과실,(고사리 등의) 결실 기관,(노력 등의) 결실
fructify : vi,vt,열매를 맺다,비옥하게하다,...에 열매를 맺게 하다
fructose : n,과당
fructuous : a,과실이 많은,다산의. fructuously ad. fructuousness n.
frug : n,vi,프루그,프루그를 추다
frugal : a,검소한,알뜰한,절약하는. frugalness n.
frugality : n,절약
frugally : ad,검소하게
frugivore : n,(특히 영장목에서) 과일을 상식하는 동물
frugivorous : a,과실을 상식하는
fruit : n,vi,vt,과실,과일,생산물,소산,결과,자손,과일이 생기다,열매를 맺다,...에 열매를 맺게하다
fruitage : n,결실,과일,열매,성과,소산
fruitarian : n,과일 상식자,과식 주의자
fruit bat : x,큰박쥐
fruit bud : x,열매가 될 싹
fruitcake : n,프루트케이크
fruit cocktail : x,과일샐러드의 일종
fruit cup : x,잘게 썬 과일을 컵에 넣은 디저트
fruiter : n,열매를 맺는 나무,과수 재배자
fruiterer : n,과일상
fruiteress : n,FRUITERER의 여성형
fruit fly : x,과일 파리
fruitful : a,열매가잘 열리는,다산인,비옥한,이익이 많은. fruitfulness n.
fruitfully : ad,잘 열어서,다산으로,효과 있게
fruiting body : x,자실체
fruition : n,결실,달성,성과,소유
fruit jar : x,유리 과일 병
fruit juice : x,과즙
fruit knife : x,과도
fruitless : a,열매를 맺지 않는,결실하지 않는,보람없는. fruitlessly ad. fruitlessness n.
fruitlet : n,작은 과일
fruit machine : x,과일 도박기
fruitpiece : n,과일 정물화
fruit ranch : x,(큰) 과수원
fruit salad : x,프루트샐러드,(군복에 단) 훈장과 훈장 띠
fruit sirup : x,과일 시럽
fruit sugar : x,과당
fruit tree : x,과수
fruit wine : x,과실주
fruit wood : x,과수 재목
fruity : a,과일같은 과일 맛이 나는,(소리 등이) 성량이 풍부한,낭랑한,노골적인,남성애의. fruitiness n.
frumentaceous : a,밀 같은,밀로 만든
frumenty : n,우유밀죽
frump : n,추레한 여자,지저분한 여자(남자)
frumpish : a,지저분한. frumpishly ad.
frumpy : a,=FRUMPISH. frumpily ad. frumpiness n.
frustrate : vt,좌절시키다,사람을 실망시키다
frustrated : a,좌절감을 느낀,실망한
frustration : n,타파,좌절,실패,욕구 불만
frustration tolerance : x,욕구 불만 내성
frustule : n,돌말의 껍질
frustum : n,절두체
fry : vt,n,vi,기름에 튀기다,프라이로 되다,전기의자로 처형되다,튀김(요리),프라이,감자튀김,흥분,고뇌
fry : n,물고기 새끼,치어,작은 것
fryer : n,프라이 요리인,프라이용 고기
frying pan : x,프라이팬
fryup : n,(먹다 남은 것으로 만드는) 즉석 볶음 음식
fstop : n,F 넘버 표시 조리개
fubar : a,n,엉망인,손댈여지가 없는,=SNAFU
fubsy : a,똥똥한,땅딸막한
fuchsia : n,퓨셔,수령초
fuchsin : n,푹신
fuchsine : n,푹신
fuck : vt,vi,n,int,...와 성교하다,가혹하게 대하다,실수하다,성교하다,말썽부리다,성교,성교의 상대,바보,제기랄,더러워
fuck : vt,vi,n,int,성교하다,가혹한 취급을하다,실수하다,...와 성교하다,성교,성교의 상대,바보,제기랄,더러워
fucker : n,fuck하는 사람,바보 같은 놈
fuckhead : n,바보,얼간이
fucking : a,ad,지독한,대단히,지독히
fucking hell : x,=DUCK
fuckup : n,몹쓸사람,얼간이
fuctionword : n,기능어(전치사,접속사등)
fucus : n,푸쿠스속의 녹갈색 해초
fuddle : vt,vi,n,취하게하다,혼란시키다,술에 젖어 지내다,만취,혼미
fuddyduddy : n,a,귀찮은 사람,불평가,시대에 뒤진,낡아빠진
fudge : vt,vi,int,n,캔디의 일종,허튼소리,당치않은,실없는 소리,(신문 기삿거리 등을) 날조하다,적당히 꾸며 내다,속이다
fuel : n,vt,vi,연료,감정을 불태우는 것,핵연료,(에너지원이 되는) 음식물,연료를 공급하다,연료를 얻다
fuel air explosive : x,기화 폭탄
fuel capacity : x,연료 적재력
fuel cell : x,연료전지
fuel cycle : x,(핵의) 연료 사이클
fuel depot : x,연료 보급창,연료 저장고
fuelefficient : a,(자동차 등) 연료 효율이 좋은
fueler : n,연료 공급자(장치)
fuel gas : x,연료 가스
fuel gauge : x,연료계
fuelguzzling : a,연료를 많이 먹는
fueling station : x,연료 보급소
fuelish : a,연료를 낭비하는. fuelishly ad.
fuel oil : x,연료유,중유
fuel rate : x,초간 연료 소비율
fuel rod : x,연료봉
fug : n,vi,(환기가 나빠) 숨이 막힐 것 같은 공기,숨이 막힐 것 같은 곳에 있다
fugacious : a,손에 잡히지 않는,허무한,덧없는. fugaciously ad.
fugacity : n,달아나기 쉬움,덧없음,도산능
fugal : a,둔주곡의
fugally : ad,둔주곡식으로
fuggy : a,(방등이) 숨이 막힐 것 같은,답답한
fugitive : a,n,도망친,도망자,일시적인,덧없는,도망하는,도주한. fugitively ad. fugitiveness n.
fugue : n,vt,vi,푸가,둔주곡,푸가로 작곡하다,푸가를 작곡하다. fuguelike a.
Fuhrer : n,지도자
Fulbright : a,풀브라이트 장학기금의
fulcrum : n,(지레의)받침점,지렛목,지레 받침
fulfill : vt,수행하다,따르다,달성하다,완성시키다,만족시키다!. fulfiller n.
fulfillment : n,수행,실행,달성
fulfilment : n,수행,실행,달성
fulgent : a,눈부시게 빛나는,찬란한. fulgently ad.
fulgid : a,찬란히 빛나는
fulgurant : a,번개처럼,번쩍이는
fulgurate : vi,vt,번개처럼 번쩍이다,(종양 등을) 고주파로 파괴하다
fulgurating : a,번개 같은,고주파 요법의
fulguration : n,고주파 요법
fulgurite : n,풀구라이트,섬전암
fulgurous : a,전광 같은
fuliginous : a,검댕의,가무스름한. fuliginously ad.
full : a,ad,n,vt,vi,가득 찬,충분한,최대한의,(천을)축융하다,충분한,완전히,꼭,필요이상으로,전부,완전,한창,낙낙히 주름 잡다,보름달이 되다
full : vt,(빨고 삶아서) 천의 올을 배게 하다,더운 물에 넣었다 꺼내다
full age : x,성년
fullback : n,풀백
full base : x,만루
full binding : x,총피 제본
full blast : x,전가동(으로)
full blood : x,순종의 사람
fullblooded : a,순종의,혈기왕성한
fullblown : a,만발한
full board : x,3식이 딸린 숙식
fullbodied : a,(여자가) 가슴이 풍만한
fullbodied : a,내용이 충실한,진한맛이 있는
fullbottomed : a,(가발이) 뒤가 퍼진
fullbound : a,가죽으로 제본한
full brother : x,부모가 같은 형제
full circle : x,완전히 1회전하여
full cock : x,(총의) 공이치기를 완전히 세운 상태,준비가 된 상태
fullcourt press : x,총공격,전면적 노력,총공세
fullcream : a,탈지하지 않은,전유의
fullcustom : a,(제품이) 특별 주문의
fullcut : a,프릴리언트 컷의(보석),58면체로 깎인 (다이아몬드)
full dress : x,정장,정장의
fulldress : a,정장의,예복을 입는
full duplex : x,양방향 동시 전송 방식
full employment : x,완전고용
fullemployment surplus : x,완전 고용 잉여
fuller : n,vt,둥근 홈을 내는 연장,둥근 홈을 내다
fuller : n,직물의 축융공
fuller : n,(직물의)축융공,천의 올을 배게하는 직공
fuller's earth : x,백토,표토
fullface : n,a,ad,둥근 얼굴,정면의(으로)
fullfaced : a,둥근 얼굴의,정변을 향한,활자가 굵은
fullfashioned : a,다리에 꼭 맞게 짠
fullfledged : a,깃털이다난,충분히 자격이있는
full frontal : x,세부가 전부 드러난(상태),완전 누드의(사진)
full gainer : x,=GAINER
fullgrown : a,충분히 자란
full hand : x,동점의 패 두장과 석장을 갖춤
fullhearted : a,용기에 찬
full house : x,(극장따위의)만원
fulllength : a,등신대의
fulllength : a,ad,n,등신대의,등신대로,전신상
full load : x,전부하
full measure : x,부족이 없는 계량
full moon : x,만월
fullmouthed : a,큰소리의,목소리가 우렁찬,(마소등이) 이가 다 난
full name : x,name
full nelson : n,풀넬슨(목누르기의 일종)
fullness : n,차 있음,비만,풍부함
fullness : n,충분,풍족,충만,비만,풍부함
fulloptimization : n,종합 최적화
fullorbed : a,만월의
fullout : a,전면적인,본격적인
fullpage : a,페이지 가득 찬,전면에 걸친
full pay : x,전액 급여,현역급
full pitch : x,바운드하지 않고 직접 wicket에 던져진 공
fullpitched : a,(공이) 바운드하지 않고 삼주문에 던져진
full point : x,종지부
full professor : n,대학교수
fullrigged : a,전장비를 갖춘 (돛단배),완전장비의
fullround : a,철저한,고른
full sail : x,만범,돛을 다올리고,총력으로
fullsailed : a,돛을 다 올린
fullscale : a,실물대의,본격적인,전면적인
fullservice agency : x,풀서비스 대리점
full sister : x,부모가 같은 형제
full stop : x,종지부
full swing : x,최대 능력,최대 활동
fullthroated : a,(목이 터질 정도로) 크게 소리치는
full tilt : x,전속력으로
full time : x,(작업,근무상의 정규의) 전시간,(구기 등에서)소정의 시합 시간 전부
fulltime : a,ad,전시간의,전임의,전시간제로
fulltimer : n,상근자,전임자,전일제 학교에 다니는 아동
full toss : x,=FULL PITCH
fullturnkey : n,일괄 수주,발주 방식
fullweight : a,정량의
fully : ad,충분히,(수사에서) 꼬박,꼭
fully fashioned : a,=FULLFASHIONED
fully fledged : x,=FULLFLEDGED
fullygrown : a,=FULLGROWN
fullyillustrated : a,전면 삽화가 들어간,삽화가 많은
fulmar : n,풀마갈매기
fulminant : a,별안간 폭음을 내며 터지는,(우뢰 같이) 울리는
fulminate : vi,vi,n,번쩍하다,천둥치다,호통치다,폭발하다,맹렬히 비난을받다,(비난등을)퍼붓다,뇌산염
fulminating powder : n,=FULMINATE
fulmination : n,폭발,맹렬한 비난
fulminator : n,야단치는 사람
fulminatory : a,천둥의,쩡쩡 울리는,노호하는
fulmine : vi,vt,=FULMINATE
fulminic : a,폭발성의,폭명하는
fulminic acid : x,뇌산
fulminous : a,뇌전성의
fulness : n,=FULLNESS
fulsome : a,몹시 역겨운,치근치근한,(아첨등이) 지나친,집요한,지겨운. fulsomely ad. fulsomeness n.
Fulton : n,풀턴
fulvescent : a,암황갈색의
fulvous : a,황갈색의
Fu Manchu mustache : x,양끝이 아래로 처진 코밑 수염
fumaric acid : x,푸마르산
fumarole : n,(화산의)분기공
fumatorium : n,훈증소,훈증 소독실
fumatory : n,훈증(용)의,훈증소
fumble : vi,n,vt,손으로 더듬다,만지작거리다,주물럭거리다,불을 펑붙이다,더듬질,펌블(공을 잡았다 떨어뜨림),어설프게 다루다. fumbler n.
fumbling : a,n,만지작거리는,어설픈,실수
fumblingly : ad,손으로 뒤져,어설프게
fume : n,vi,vt,연기,향기,훗훗한기,연기나다,그을리다,연기,김 등을 뿜다,그을리게 하다,향을 피우다
fumed : a,(목재가) 암모니아로 찐
fumifator : n,훈중기
fumigant : n,훈증약
fumigate : vt,그을다,훈증 소독하다,(향을) 피우다
fumigation : n,훈증,훈증 소독(법)
fumigator : n,훈증 소독자
fumitory : n,서양 현호색 무리의 식물
fumy : a,연기로 가득 찬,증기모양의
fun : n,vi,a,장난,놀이,희롱,농담,장난하다,농담하다,즐거운,재미나는
funabout : n,(레저,스포츠용의) 각종 소형 자동차
funambulism : n,줄타기,머리가 빨리 돌아감
funambulist : n,줄타기 곡예사
Fun City : x,환락의 도시
function : n,vi,기능,작용,임무,의식,함수,작용하다,직분을 다하다
functional calculus : x,=PREDICATE CALCULUS
functional change : x,기능 전환
functional illiterate : x,기능적 문맹자
functional illiterate : x,읽기,쓰기의 능력부족으로 사회생활에 지장이있는 사람
functionalism : n,(건축,가구 등의) 기능주의,기능 심리학
functional representation : x,직능 대표제
functional shift : x,기능 전환
functionary : a,n,직원,관리,기능의
functionate : vi,기능을 하다,직능을 다하다
function word : x,기능어(전치사,접속사,조동사 등)
fund : n,vt,기금,적립금,온축,재원,(일시 차입금을)장기 부채로 바꾸다,이자 지불에 자금을 공급하다,적립하다,축적하다
fundament : n,둔부,항문,기초,원리,입지조건
fundamental : a,근본적인,중요한,근본,원리
fundamental bass : x,(화음을 구성하는) 기초 저음
fundamentalism : n,근본주의,원리주의. fundamentalist n.
fundamentality : n,기본성,(근본적인) 중요성
fundamentally : ad,근본적으로,기초부터
fundamental particle : x,=ELEMENTARY PARTICLE
fundholder : n,국채 투자자
fundi : n,(동부,남부 아프리카에서) 기능자,숙련자,전문가
fundic : a,FUNDUS에 관한
fundraiser : n,기금 조달자
fundraising party : x,모금 파티,자선 파티,정치자금 모금 파티
fundus : n,(안구,자궁 등의) 기저부,밑
funeral : n,장례식의,장례행렬,장례식
funeral director : x,장의사
funeral home : x,장례식장
funeralmarch : n,장송행진곡
funeral parlor : x,장례식장
funeral rites : x,장례
funerary : a,장례식의,장송의
funereal : a,장례식다운,슬픈,음울한. funereally ad.
funetional : a,기능의,직무상의,함수의
funetionalist : n,기능 주의자
funetionally : ad,기능상,직무상,함수적으로
fun fair : x,=anusement
funfair : n,유원지,이동 유원지
fun fur : x,싼 모조 모피옷
fungal : a,=FUNGOUS
fungi : n,FUNGUS의복수
fungible : a,n,(재화가) 대체 가능의,(딴 것으로) 대신할 수 있는,대체물
fungicide : n,살균제
fungiform : a,균상의,버섯 모양의
fungo : n,연습플라이,수비 연습을 위한 타구
fungoid : a,버섯과 비슷한,균성의,=FUNGOUS,자꾸 증식하는,균상종
fungology : n,균류학
fungous : a,균성의,버섯의,버섯 비슷한,부드럽고 연한,균상종의,갑자기 생기는
fungus : n,진균류,균,버섯,갑자기 생기는 것,일시적 현상
fun house : x,(유원지의) 유령의 집
funicle : n,배주병
funicular : a,n,밧줄의 견인력에 의한,밧줄의,탯줄의,주병의,강삭 철도,케이블카
funicular railway : n,케이블카,강삭 철도
funiculus : n,삭조,탯줄,주병
funk : vt,vi,n,연기를 내뿜다,연기가 나다,(연기 등의) 고약한 냄새,악취,펑키 재즈
funk : n,vi,vt,무서움,겁,의기 소침,공황,겁쟁이,겁내다,(겁나서) 기가 죽다
funk art : x,색다른 조형 예술의 한 형식
funk hole : x,참호,대피호,병역면제의 핑계가 되는 직무
funkia : n,비비추속의 총칭
funk money : x,=HOT MONEY
funk music : x,=FUNK
funky : a,겁먹은,겁쟁이의
funky : a,몹시 구린,관능적인,케케묵은,구역질 나는. funkiness n.
funky music : x,=FUNK
funnel : n,vt,vi,깔때기,통풍통,채광구멍,(손 등을) 깔대기 모양이 되게 하다,(정력 등을) 집중하다,깔때기 모양이 되다,깔때기를 통과하다
funneled : a,깔때기가 있는,깔때기꼴의,(...개의) 굴뚝을 같춘
funnelform : a,깔때기 꼴의 (나팔꽃 등)
funnily : ad,우습고 재미있게,우스꽝스럽게,기묘하게
funniment : n,익살,농담,어리광을 부림
funniness : n,우스꽝스러움
funny : a,ad,n,우스운,이상한,우습게,재미있게,농담,(신문의) 만화란
funny : n,혼자서 젓는 길쭉한 보트
funny bone : x,척골의 끝
funny book : x,만화책
funny business : x,우스운 짓,농담,사기
funny farm : x,정신 병원
funnyhaha : a,재미있는,우스운
funny house : x,=FUNNY FARM
funnyman : n,익살꾼
funny money : x,가짜돈,장난감 돈
funny paper : x,신문의 만화부록
funnypeculiar : a,이상한
funraising : n,a,(정당,복지 단체의) 모금 활동(의),자금 조달(의)
fur : n,a,vt,vi,모피,부드러운 털,(여성의) 거웃,외음부,모피(제)의,부드러운 모피를 붙이다,백태가 생기다
furan : n,푸란
furane : n,푸란
furazolidone : n,푸라졸리돈
furbelow : n,옷단 장식,복잡한 장식을 하다
furbish : vt,갈다,다듬어 연마하다,새롭게하다,부활시키다
furcate : a,vi,(끝이)갈라진,두갈래지다
furcation : n,분기
furfur : n,비듬
furfuraceous : a,비듬 모양의,겨 같은
Furies : n,복수의 세여신
furious : a,격노한,미쳐 날뛰는,맹렬한,노하여 펄펄 뛰는,(폭풍우,바다 등이) 사납게 날뛰는
furl : vt,vi,n,감다,접다,감기,접히다,(희망등을)버리다,말아넣음,마는 법,만 것
furless : a,털이 없는
furlong : n,펄롱(거리의단위)
furlough : n,vt,말미,사가,휴가,일시해고,...에게 휴가를 주다
furmenty : n,=FRUMENTY
furmety : n,=FRUMENTY
furnace : n,화덕,용광로,작열하는 곳,시련
furnish : vt,vi,공급하다,설비,비치된 가구,가구를 갖추다
furnished : a,가구 달린,재고량이 ...한,구색을 갖춘
furnisher : n,가구상,공급자,조달자
furnishings : n,가구의 설비,비치된 가구,복식품
furniture : n,가구,비품,내용
furor : n,노도와 같은 감격,열광
furor colligendi : n,수집광
furore : n,=FUROR,푸로레,격정,정열
furosemide : n,푸로세미드(부종 치료용의 강력 이뇨제)
furphy : n,허보,뜬소문
furred : a,털가죽을 붙인,부드러운 털로 덮인
furrier : n,모피상
furriery : n,모피상
furring : n,모피(붙임),모피 장식,초벽,초벽 재료
furrow : n,vt,vi,밭고랑,보습자리,항적,주름살,쟁기로 갈다,두둑을 짓다,주물살이 생기게 하다,이랑을 짓다,주름살이 지다
furrowy : a,이랑진,주름살이 많은
furry : a,모피의,모피로덮인,설태가 낀
fur seal : n,물개
further : a,ad,vt,더먼,더멀리,더욱,나아가다,조장,게다가,더먼,그이상의,뒤따른,진행시키다,조장하다
furtherance : n,조장,촉진
further education : x,성인교육
furthermore : ad,더욱 더,그 위에 더,더욱이,게다가
furthermost : a,가장 먼
furthest : a,ad,=FARTHEST
furtive : a,은밀한
furtive : a,은밀한,남몰래하는,아무가 남의 눈을 기이는. furtiveness n.
furtively : ad,몰래,살그머니,슬쩍
furuncle : n,절종,종기,등창. furuncular a. furunculous a.
furunculosis : n,절종증,박테리아에 의한 연어,송어의 병
fury : n,격노,격렬,표독한 여자
furze : n,바늘금작화
furzy : a,가시금작화가 무성한
fusain : n,목탄
fuscous : a,암갈색의,거무스름한
fuse : vt,vi,녹이다,융합시키다,녹다
fuse : vt,n,vi,신관,도화선,신관을 달다,퓨즈를 달다,퓨즈가 녹아서 전등이 꺼지다
fusee : n,내풍성냥,적색 섬광신호
fuselage : n,(비행기의)동체
fusel oil : n,퓨젤유
fusewire : n,도화선
fusibility : n,가용성,용해도
fusible : a,녹기쉬운
fusil : n,수발총
fusil : a,녹여서 만든,주조한,녹은,녹는
fusilieer : n,수발총병,(영국의 옛) 퓨질리어 연대 보병
fusilier : n,수발총병,(영국의 옛) 퓨질리어 연대 보병
fusillade : n,vt,일제사격,일제사격을 가하다
fusion : n,융해,융해물,(정당의)합동
fusion bomb : x,수소폭탄
fusionism : n,합동주의
fusionist : n,합동론자
fusion point : x,융점,용해점
fusion reaction : x,핵융합 반응
fusion reactor : x,핵융합로
fuss : n,vi,vt,야단법석,떠들어대는 사람,싸움,말다툼하다,속타게하다,몸달아 설침,떠들게 하다,안달복달하게 하다. fusser n.
fussbudget : n,하찮은 일에 떠들어대는 사람,수다쟁이. fussbudgety a.
fussily : ad,(쓸데없는 일에) 야단스럽게,(지나치게) 안달복달하여
fussiness : n,야단법석함,안달복달함
fusspot : n,하찮은 일에 떠들어대는 사람,수다쟁이. fussbudgety a.
fussy : a,(하찮은 일에) 야단법석하는,귀찮은,까다로운,세심한 주의를 요하는
fustian : n,a,퍼스티언(제의),과장된(말),퍼스티언 천의,야단스러운,과대한
fustic : n,퍼스틱,그것에서 뽑은 황색 염료
fustigate : vt,몽둥이로 때리다. fustigation n.
fusty : a,곰팡내나는,낡아빠진,완고한. fustily ad. fustiness n.
fut : n,=PHUT
futile : a,쓸데없는,무용,무익한짓. futilely ad. futileness n.
futilitarian : a,n,인간의 노력이 헛됨을 믿는 (사람),비관주의의(사람)
futility : n,무용,무익한 짓
futtock : n,(중간) 늑재
futtock shroud : x,중간 돛대의 삭구 아래끝을 받치는 쇠줄(쇠막대)
futurama : n,미래 생활 전시회,미래상
future : n,a,미래(in the near future,or in no distant	futurt 멀리잖아),장래,미래시제,약혼자,미래의,장래의
futureless : a,미래가 없는,장래성 없는
future life : x,저세상,내세,영계
future shock : x,미래 충격(급격한 사회 변화에 적응하지 못하는 사람의 고민)
future state : x,저세상,내세,영계
future tense : x,미래 시제
futurism : n,미래파
futurist : n,a,미래과 화가,미래파의
futuristic : a,미래파의,초현대적인,전위적인. futuristically ad
futuristics : n,미래학
futurity : n,미래,후세,미래의상태(일)
futurity industry : x,미래 산업
futurity race : x,출장 참가 신청후 오래 있다가 하는 경마
futurity stakes : x,futurity race에 건 돈,=FUTURITY RACE
futurologist : n,미래학자
futurology : n,미래학. futurological a.
fuze : n,신관,기폭장치,=fuse
fuzee : n,=FUSEE
fuzz : n,vi,vt,보풀,잔털,솜털,보풀이 일다,보풀을 일으키다,흘흘 흩어져 날다
fuzzball : n,말불버섯
fuzz box : x,전자 기타의 음을 흐리게 하는 장치
fuzzbuster : n,퍼즈버스터(스피드 레이더를 찾아내는 전자장치)
fuzzbuzz : n,야단 법석,혼란(상태),혼잡,불편,옥신각신
fuzz tone : x,(전자기타의) 탁한음
fuzzy : a,보풀의,보풀같은,보풀이 일어난,희미한. fuzzily ad. fuzziness n.
fuzzy set : x,흐림 집합(명확히 정의된 경계를 가지지 않은 집합)
FuzzyWuzzy : n,Sudan 지방의 토민병
fy : int,=FIE
fye : int,=FIE
FYI : x,for your information
fyke : n,긴 자루식 어망
fylfot : n,만자
fyloft : n,swastika
fytte : n,시가의 한절
fz : x,forzando
