H : n,알파벳 8번째 문자
H : x,hard (of pencil),henry,heroin,hydrogen
h&c : x,hot and cold(water)
H&i : x,(적군의 야간 침입을 막기 위한)위협 방해 사격,무차별 포격
h'm : int,HEM,HUM
h(H) : x,double (treble) hard (of pencil)
H.A. : x,heavy artilery,Hockey Association,Horse Artillery
H.a. : x,hoc anno
H.B.M. : x,His Britannic Majesty
H.C.F. : n,highest common factor 최대 공약수
H.F. : x,high frequency
H.F. : x,high frequency
H.G. : x,His (or) Her Grace
H.H. : x,His (or Her) Highness,His Holiness
H.I. : x,Hawaiian Islands,Human interest
H.I.M. : x,His (or Her) Imperial Majesty
H.J. : x,hic jacet
H.J.S. : x,hic jacet supultus
H.L. : x,House of Lords
H.M.S. : x,His (or Her) Majesty's Service (or Ship)
H.O. : x,head office,Home Office
H.P. : x,hIRE PURCHASE
H.S.E. : x,hic sepullus est
H.S.H. : x,His (or Her) Serene Highness
H.T. : x,high tension
ha : int,vi,하아!,허어!,어머!(놀람,기쁨,의심,불만,주저 등의 발성),하하!(웃음소리),하아! 라고 말하다,아하하 웃다
ha'nt : v,have(has) not의단축
Ha(s)sid : n,하시드교
ha. : x,hectare(s)
HAA : x,hepatitis-associated antigen간염(관련),항원,heavy antiaircraft
Habakkuk : n,히브리의 예언자,하박국서
habanera : n,하바네라(쿠바의 2/4박자의 댄스(곡))
habdabs : n,초조,공포,신경과민
habeascorpus : n,인신보호영장,인보호법(1679년CharlesII가발표)
Habeas Corpus Act : x (영)인신보호율(법)(Charles IIrk 1679년 발포)
habendum : n,(=(which is) to be had)물권 표시 조례(양도 증서 가운데서 양도되는 물권을 밝히는 조항)
haberdash : vt, (양복을0짓다,유행형으로 디자인하다,(양복에)장식적인 디자인을 하다
haberdasher : n,방물장수,남자용 장신구상인
haberdashery : n,방물(가게),남자용 장신구류
habergeon : n,(중세의)(소매 없는)사슬 비늘 갑옷
Haber process : x,하버법(암모니아 합성법의 하나)
habile : a,잘하는,솜씨 좋은,숙련된,알맞은,딱 들어맞는
habiliment : n,복장,의복
habilitate : 퍄,vi,vt,(독일 대학 교수의)자격을 얻다,자격이 있다,(사회 복귀를 위해 심신 장애자를)교육하다,(광산에)운전 자금을 주다,에 옷을 입히다
habilitation : n,
habit : n,습관,버릇,(동식물의)습성,체질,기질,복장,여성승마복,be in the(a) ~ of(doing) 
habit : vt,입히다,...에 살다
habitability : n,
habitable : a,살기에 알맞은,살 수 있는
habitancy : n,거주(inhavitant),(집합적)거주자,주민,인구
habitant : 주민,거주자(inhabitant),
habitant : (캐나다,미국Louisiana주의)프랑스계 이민(농민),
habitat : n,(동식물의)생육지,(원)산지,주소,(해저실험용)수중 거주실
habitat group : x,생태류(서식 환경을 같이 하는 동식물),(박물관에 전시된)생물 환경 모형
habitation : n,거주,주소,주택
habitforming : a,습관성의(마약 등)
habitual : a,습관(상습)적인,평소의,습관상의
habitual criminal : x,상습범,습관적 범죄자
habitualy : ad,습관(상습)적으로
habituate : vt,익히다,익숙케하다
habitude : n,습관,습성,체질,기질
habitue : n,늘오는(다니는)손님,단골 손님,마약 상습자
habitus : n,=habit,체형(특히 어떤 병에 걸리기 쉬운),체질
hachure : n,vt,운옹,선영(그림,지도에서 그늘,높낮이를 나타내는 선),(지도에)운옹(선영)을 그려 넣다,(높낮이를)선영(식)으로 나타내다
hacienda : n,(중남미의)농장,큰목장,토지,(시골의)공장,광업소
hack : vt,자르다,쳐서 자르다,난도질하다,잘게 썰다,파서 헤치다(부수다),(짤막한)마른 기침을 하다
hack : n,벤(칼)자국,새긴 자국,(발로)걷어찬(깐)창처,도끼,마른기침
hack : n,삯말,전세마차,택시(운전사),(보통의)승용말,늙은(여윈)말,짐말,(서술가의)일거드는사람,3류작가,(돈을 위해)무엇이든 하는 사람
hack : vt,삯말을 타다,말타고 가다,남의 밑에서 고된 일을 하다
hack : a,고용된,써서 낡게 한
hackamore : n,(말의)고삐
hackberry : n,(미국산)팽나무(류)
hacked : a,곤혹스러운,당혹(곤란)한,안달(짜증)난
hacker : n,컴퓨터 매니어,컴퓨터 침해자
hackerese : n,해커말(hacker language)
hack hammer : x,(석공용의)메다듬 망치
hackie : n,택시 운전사
hacking : n,컴퓨터 조작을 즐기기,무엇이나 숙고하지 않고 실행하기
hacking coat(jacket) : x,승마복,승마복과 비슷한운동복
hacking cough : x,짧은 헛기침,밭은기침
hacking pocket : x,비스듬하게 붙인 덮개 달린 호주머니(hacking jacket에 달려 있는)
hackle : n,v,빗,(닭등의)목털,(삼 따위를)빗으로 훑다
hackle : vt,,잘게 저미다(베다),동강치다,찢어 발기다
hackly : a,(-lier,-liest)거친,꺼칠꺼칠한,깔쭉깔쭉한,들쑥날쑥한
hackman : n,전세 마차의 마부,마차업자
hackmatack : n,아메리카낙엽송
hackney : n,(보통의)승용말,전세 마차
hackney : vt,(말,마차를)빌려주다,써서 낡게 하다,~ed a,낡아빠진,진부한,~ed phrase (케케묵은)상투구
hackney coach : n,전세 마차
hackneyed : a,낡은,진부한,경험을 쌓은,능숙한
hack saw : n,(금속절단용)띠톱
hacksaw : n,(금속 켜는)쇠톱
hackwork : n,(돈벌이를 위한 예술 작품 등의)하청 작업,9특히 삼류 작가의)매문쓰기
hack writer : n,삼문 문사,2류작가
had : v,have의과거(분사),
hadal : a,초심해의(수심이 6000m보다 깊은)
haddock : n,(북대서양산의)대구
hade : n,vi,언각(단층,광맥 등의 경사를 수직면에서 잰 각도,언각을 이루다,기울다
Hadean : a,Hades의
Hades : n,황천,명부,저승
Hadith : n,Muhammand 및 교우들의 언행을 기록한 성전
hadj : n,Mecca 순례
hadj : n,(회교도의)메카 순례
hadji : n,=HAJJI
hadn't : v,had not의 단축
hadron : n,하드론(강한 상호작용을 하는 소입자족)
hadst : v,have의 2인칭단수,과거
hae : vt,v,auxil,HAVEd의 1,2인칭 단수,복수 현재
haeainthesand : a,머리를 모래에 처박은,진상을 외면하는,현실 도피의
haecceity : n,(이것)임(thisness),개성 원리,개별성의 특성
Haeckel : n,헤켈,Ernst Heinrich(1834-1919)(독일의 생물학자,진화론자)
haematite : n,=HEMATITE
haemoglobin : n,=HEMOGLOBIN
haemophilia : n,=HEMOPHILIA
haemorrhage : n,=HEMORRHAGE
haemorrhoids : n,=HEMORRHOIDS
haeremai : int,잘 오셨소,어서오십시오(welcome)
haffir : n,(빗물을 일시 저장하는)연못
hafiz : n,코란을 전부 암기한 회교도의 칭호
hafnia : n,산화하프늄의 백색 결정
hafnium : n,하프늄(금속원소,기호Hf)
haft : n,vt,(칼)자루(를 달다)
hag : n,보기흉한(심술궂은)노파,버커리,마귀 할멈,마녀,소택지,
Hag, : x,Haggai
Hagar : n,여자이름,하갈(아브라함의 아들 이스마엘을 낳은여인)
hagberry : n,=HACKBERRY
hagborn : a,마녀에게서 태어난,마녀를 어머니로 하는
hagfish : n,먹장어
Haggada0h) : n,핫가다(탈무드중의 비율법적인 교훈적 이야기,유월절 축하연에 사용되는 전례서)
haggadist : n,Haggada의 작자(연구자)
Haggai : n,히브리의 예언자,학개서
haggard : a,여윈,바싹 마른,야생의
haggis : a,양의 내장과 오트밀을 섞어 끓인 요리
haggish : a,마귀할멈 같은,(나이가 들어)추악한
haggle : vi,,(끈덕지게)값을 깍다,입씨름하다,토막쳐 자르다
haggle : n,값을 깍기,말다툼
hagiarchy : n,성인(성직자)정치,성인 지배국(공동체),성인계급
hagio : x,(연결형)(성인의 신성한)의 뜻
hagiocracy : n,성직정치(지배)
Hagiographa : n,성문집,제서(구약성서 중의 제 3부)
hagiographer : n,Hagiographa의 저자의 한사람
hagiographic : a,성인전의
hagiographist : n,성인전 작가
hagiography : n,성인전,성인 연구,성인전기,주인공을 이상화한 전기
hagiolatry : n,성인 숭배
hagiology : n,성인(성도)전,성도록
hagioscope : n,본당 밖에서 제단을 볼 수 있는 창문(예배용)
hagridden : a,시달린,가위 눌린,(공포에)시달린
hagride : vt,(악몽,근심으로)괴롭히다,심한 고통을 주다,들러붙어서 괴로움을 주다
Hague : n,The 헤이그(네덜란드의 행정 수도,정식수도는 Amsterdam)
Hague Court : x,헤이그 재판소(Permanent Court of International Justice와 International Court of Justice의 통칭)
Hague Tribunal : x,국제 사법 재판소(공식명은 Parmanent Court of Arbitration)
hah : int,vi,=HA
haha : int,n,하하!,(웃음소리)
haha : n,(전망을 가리지 않는)나지막한 담,은장
hahnium : n,하늄(인공방사성 원소,번호 105)
Haig : n,헤이그 Alexander Meigs-,Jr(1924-)(미국의 군인,정치가)
HaightAshbury : n,헤이트애시베리(미국 샌프란시스코의 한 지구,60년대 히피 문화의 중심지)
haik : n,하이크(아라비아 사람이 전신에 들쓰는 정사각형의 천)=haick
hail : vt,n,싸락눈(우박)(이 오다),빗발치듯 쏟아지다,퍼붓다
hail : vt,n,큰소리로 부르다,(...을)...이라 부르며(환호로)맞이하다,인사하다 ,(아무가)...의 출신이다,환호,인사
Hail Columbia : x,미국 국가
hailer : n,환호하는 사람,휴대용 확성기
hailfellow : a,n,친한친구,친밀한
Hail Mary : x,=Ave Maria
hailstone : n,우박
hailstorm : n,마구 쏟아지는 우박
haily : a,우박 같은,우박 섞인
hain't : x,=AIN'T
hair : n,털,머리털,머리가 하얗다,털모양의것,극히 약간의 물건,by the turn of a ~ 위기 일발의 아슬아슬한 고비에서,간신히
hair'sbreadth : n,a,=HAIRBREADTH
hair ball : x,모구(소,양,고양이 등이 삼킨 털,섬유가 위에서 뭉쳐져 생긴 덩어리),식물,위석
hairbell : n,=HAREBELL
hairbreadth : n,a,좁은틈,위기 일발(의),아슬아슬한
hairbreadth : n,a,=HAIRBREADTH
hairbrush : n,머리솔
haircare : n,머리의 손질
hair cell : x,유모 세포(특히 코르티 기관 등에 있는 청각 세포)
hairclip : n,머리핀(bobbypin)
haircloth : n,마미단
hair color : x, 머리 염색약(대개 stick 형태이며,이것으로 머리털의 색깔을 손질함)
hair curler : x,오싹 소름이 끼치는 것(일),무시무시한 일(것)
haircurling : a,등골이 오싹하는,무시무시한
haircut : n,이발(의 형)
haircutter : n,이발사
haircutting : n,a,이발(조발)(업),조발의
hairdo : n,머리형
hairdresser : n,미용사,이발사
hairdressing : n,a,(특히 여성의)조발(이발)(업),미용(업),조발법,모발용 화장품,이발용의
hair drier(dryer) : x,헤어 드라이어(blower)
hairdye : n,(흰)머리 염색제,염모제
haired : a,머리털이 있는,(보통 복합어를 이루어)머리털이-인
hair grass : x,줄기나 잎이 털같이 가는 풀(특히)좀새풀
hairgrip : n,=BOBBY PIN
hair hygrometer : x,모발 습도계
hair implant : x, 인공 식모(술,법)(인공적으로 모발을 두피에 심는
hairlace : a,털(머리털)이 없는
hairless : a,털(머리칼)이 없는
hairlike : a,털같은,매우 가는
hairline : n,가는선,타락줄,(이마의)머리털 난 언저리,두발선
hairlness : n,털이 있음,털이 많음
hairnet : n,헤어네트
hairoil : n,머릿기름
hairologist : n,모발(전문)미용사,모발 전문가(치료가),모발 학자
hair pencil : x,모필,붓(수채화용)
hair pie : x,음문
hairpiece[h'35~rp`i:s)(여성용)헤어피스,(남성용)가발
hairpin : n,헤어핀,머리핀
hairpowder : n,머리 분
hairraiser : n,끔찍한 사건(이야기,경험(등))
hairraising : a,머리끝이 쭈뼛해지는
hairrestorer : n,양모제,발모제
hair ribbon : x,머리털을 묶는 장식용 리본
hair seal : x,강치,바다표범,그 가죽 또는 모피
hair shirt : x,(고행자가 알몸에 걸치는)거친 모직 셔츠
hair shirt : x,(고행자가 입는)마모직 셔츠
hairslide : n,헤어클립(barrette)
hair space : x,헤어 스페이스(어간의 최소 간격,최소 간격의 활자)
hairsplitter : n,사소한 일을 야단스럽게 따지는 사람
hairsplitting : a,n,사소한 일에 구애되는(됨)
hair spray : x,헤어 스프레이
hairspring : n,(시계의)실 태엽,유사
hairstreak : n,부전나비과의 일종
hair stroke : x,(글씨의)가는 선,(글씨의 장식에 쓰는)가는선(serif)
hairstyle : n,머리 형,헤어스타일
hairstyling : n,미용(이발)업
hair stylist : x,(여성의 새로운 머리 형을 연구하는)미용사(=hairdresser)
hairtician : n,이발사
hair transplant : x,모발 이식(술,법)(대머리 부분에 자기 모발을 이식하는)
hair trigger : n,(권총의)촉발 방아쇠
hair trigger : x,(총의)촉발 방아쇠,민감한 기구(반응
hairtrigger : a,촉발적인,반응이 빠른
hairtweezers : n,족집게
hairwash : n,머리염색액,세발액
hairweaving : n,(대머리를 가리기 위해)남아 있는 머리에 가발이나 다리 등을 덧넣기
hairworm : n,털처럼 가는 벌레
hairy : a,털(머리칼)의 (같은),털이 많은
hairyheeled : a,버릇 없이 자란,버릇 없는,막된
hairy vetch : x,헤어리 베치(잠두콩속의 일종,목초용)
Haiti : n,서인도 제도중의 한 공화국(수도 PortauPrince)
Haitian : a,n,아이티섬(사람의),아이티섬 사람,(=HAITIAN CREOLE)
Haitian Creole : x, 아이티프랑스말(프랑스말을 모체로 한 아이티말,현재는 대부분의 아이티 사람이 사용함
haj : n,(회교도의)메카 순례
hajji : n,하지,메카순례를 마친 회교도(종종 H-로 칭호로도 씀),예루살렘 순례를 마친 그리스(아르메니아)사람
hake : n,,(나무로 만든)건조대(치즈,타일,벽돌 등을 말리는),대구류,메를루사(대구 비슷한 생선)
Hakenkreuz : n,나치스 독일의 기장
hakim : n,(인도,회교국의)현자,학자,의사,(옛날,이슬람권의)지사,태수,재판관
Hakka : n,a,하카 말(의)(중국 동남부,특히 광둥의 방언),하카말을 하는 사람(의)
Hal : n,남자 이름(Henry,Harold의 애칭),halogen
Halafian : a,n,할라프 문화의,할라프 문화(북메소포타미아를 중심으로 하는 문화)
Halakah : n,할라카(유대교 관례 법규(집))
halala : n,할랄라(사우디아라비아의 화폐 단위)
Halaphone : n, 할라폰(전자 음향(효과) 장치(악기),오케스트라 연주 중에 갖가지 음향 효과를 더해 주는
halation : n,헐레이션(역광신 등에 의한 뿌연 흐림)
halberd : n,미늘창
halberdier : n,미늘창을 가진 무사
halbert : n,=HALBERD
halcyon : n,파도를 가라앉히는 새
halcyon : a,잔잔한,평온한,평화스러운
halcyon days : x,(물총새가 파도를 가라앉히고 집을 짓는다는)동지 무렵의 2주간,평온 무사한 날(시대)
hale : a,정정한,근력이 좋은 ~ and hearty 원기 왕성한 ,정정한
hale : vt,(우악스럽게)잡아당기다,잡아 끌다
haler : n,할레르(체코슬로바키아의 화폐 단위),할레르 알루미늄 주화,헬러(=heller)(중세 독일의 동전)
half : n,(절)반,중간,중도,and a ~ 특별한,아주 훌륭한,by ~ 반쯤,대단히
half : a,(절)반(의),불충분한,어지간히,거의,I ~ wish ...하고 싶은 듯한 생각도
halfacrown : n,(영국 구 화폐 단위의)반 크라운(2실링 6펜스의 금액),=HALF CROWN
halfadollar : n,반 크라운 백동화(=half crown,halfacrown이라고도 함)
half andhalf[h'4f5nh'4f반반씩의(것),이도저도 아닌,얼치기의,(백,흑인의)트기,반반으로
halfandhalf : a,ad,n,반반의,이도저도 아닌,얼치기의,반반으로,반분하여,등분하여,반반의 것,혼합 맥주,우유와 크림과의 혼합물,혼혈아,잡종,파이프 담배의 일종
halfassed : a,저능한,어리석은,엉터리의,제멋대로의,불충분한
halfback : n,중위
halfbaked : a,설구워진,불완전한,(경험이)미숙한
halfball storke : x,하프볼 스트로크(공의 중앙을 쳐서 표적공의 가장자리에 맞히기
half binding : x,(책의 등과 모서리만 가죽인 반가죽 장정
half blood : a,이복,배(다른)관계
half blood : a,n,배다른,씨다른
half blood : x,(형제,자매가)배(씨)가 다름,배(씨) 다른 형제(자매)
halfblooded : a,배다른(씨다른)(형제,자매)=HALFBREED
halfblue : n,예비(보결)선수,(대표급이 아닌) 2군 선수,이런 선수들에게 주어지는 반청장(full blue에 대한 것)
halfboard : n,(호텔,하숙 등에서의)부분적 식사 제공,1박 2식9제공)(demipension),하프보드(범주하는 조선법의 하나)
halfboiled : a,설익은,반숙의
half boot : x,반장화
half boot : x,반장화(정강이의 절반까지 오는)
halfbound : a,반가죽 장정의(half binding으로 된)
halfbreadth plan : x,반폭선도(선체의 좌우 한 쪽으로부터의 수평 단면도)
halfbred : a,혼혈의,잡종의
halfbreed : n,a,혼혈아(의),트기(의),잡종(의)
half brother : x,어머니(아버지)가 다른 형제,배(씨)가 다른 형제
half cadence : x,반마침,반종지,=half close
half calf : x,(책이)송아지 가죽으로 된 반가죽 장정
halfcaste : n,(특히,유럽인 아버지와 인도인 어머니와의) 트기,신분이 다른 양친에서 난 아이
halfclose : vt,반 정도를 닫다(감다)
half cock : x,(총의)안전 장치,마음가짐이 덜된 상태,go off (at) ~ 섣불리 발사하다
half cock : x,(총의)반안전장치
halfcock : vt,(총의 공이 치기를)안전 위치에 놓다
halfcocked : a,(반)안전장치된,조금히 서두른,당황한,준비 부족의,약간 취한
halfcooked : a,설익은(설구운),미숙한(inexperienced)
half crown : x,반 크라운 은화
half crown : x,(영국 구 화폐 단위의)반 크라운 경화(2실링 6펜스의 백동화,원래는 금화),=HALFACROWN
halfdead : a,초주검이 된,아주 지친
half deck : x,(상선,범선 등의)반 갑판(특히 견습생 등의 숙사용)
half dime : x,(미국의 옛날의)5센트 은화(1792,1794-1873년에 주조)
half dollar : x,50센트 은화
halfdollar : n,(미국,캐나다의)반 달러(50센트)은화
halfdone : a,불완전한,설구은,설익은
halfdozen : a,n,반다스(의)
half duplex : x,반이중(방식)
half eagle : x,5달러 금화
half eagle : x,(미국의)5달러 금화(1795-1916,1929년에 주조)
halfface : n,a,반면,앞얼굴,반우(좌)향,앞 얼굴을 그린,반면의
halffaced : a,앞모습의,불완전한,불충분한
halffinished goods : x,반제품
half frame : x,(35mm판의)반절 크기 사진
halfframe : a,반절 크기 사진의
half gainer : x,(다이빙)하프 게이너(앞을 향한 자세에서 점프해서 반대 방향으로 거꾸로 뛰어들기)
halfhardy : a,반내한성의
halfhearted : a,마음이 내키지 않은
half hitch : x,(밧줄의) 외가닥 매듭
half hitch : x,(밧줄의)반결삭,반매듭(가장 간단한 매듭 방식)
half holiday : x,반공일
halfholiday : n,반휴일
half hose : x,(집합적)(무릎까지 오는)남성용 양말(socks)
halfhour : n,반시간,30분(의)
halfhourly : a,ad,반시간(30분)의,반시간마다의,반시간(30분)마다
half hunter : x,하프 헌터(유리 보호용 케이스가 있는 회중시계
halfinch : vt,-을 훔치다,빼앗다(pinch)
halfinteger : n,반정수(홀수의 1/2)
half landing : x,(계단 중간의)층계참
half leather : x,=HALF BINDING
halflength : a,(n),반신의,반신상
half life : a,(n),(반사능)반감기
halflife period : x,(방사성 원소 등의)반감기
halflight : a,n,어슴푸레한,어슴푸레한 빛,(미술품 등의)어슴푸레한 부분
half line : x,반직선(한 점에서 한 방향으로만 무한히 뻗은 직선)
halflong : a,(음이)반장음의
halfmast : n,vt,반기의 위치(에 걸다)
half measure : x,미봉책,임시변통
half measure : x,미봉책,임시 변통
half moon : x,반달(형의 것)
halfmoon : n,반달,반월형,속손톱
half mourning : x,반상복,반상복을 입는 기간,반상기
half nelson : x,(레스링) 목덜미 죄기
half nelson : x,(레슬링)하프 넬슨,목누르기
halfness : n,반,얼치기,불완전
half note : x,2분 음표
half note : x,2분 음표
halfone : n,(골프)반수 감점
halforphan : n,편친 슬하의 자식
halfpace : n,(단이 있는)상좌,단,상단,층계참
half pay : x,봉급의 반,반봉,반급
halfpay : a,반봉의,반급의
halfpence : n,halfpenny의 복수
halfpenny : a,n,반페니,잔돈,하찮은,(신문이)선정적인
halfpennyworth : n,반 페니어치,극소량
half pint : x,반 파인트,좀팽이,보잘것 없는 사람
halfpint : n,반 파인트(1/4 quart),몸집이 작은 사람,하찮은 사람
half plane : x,반평면
halfplate : n,반절 크기의 건판(필름),반절 크기의 건판의 사진
halfprice : a,ad,반액의(으로)
halfquartern : n,(무게가)반 quartern(2파운드)인 빵덩이
halfrater : n,소형 경주용 요트
halfread : a,데아는,겉핥기로 배운
halfround : a,반원(형)의,반원통의
halfroyal : n,12x12인치 크기의 마분치(판지)
halfseas over : a,취한(drunk)
halfshift : n,(바이올린 연주 등의)제2의 위치 변경
halfshot : a,설취한
half sister : x,배(씨)다른 자매
half sister : x,배(씨)다른 자매,아버지(어머니)만 같은 자매
half size : x,하프 사이즈(키에 비해 몸통이 큰 체형에 알맞은 여성복의 사이즈),2분의 1 축척
halfslip : n,하프슬립(스커트 안에 받쳐 입는 짧은 페티코트),페티코트(petticoat)
half sole : n,(구두에)앞창
half sole : x,(구두의)앞창
halfsole : vt,(구두에)앞창을 대다
half sovereign : x,10실링 금화(1916년에 폐지)
halfstaff : n,=HALF MAST
half step : x,반음,반걸음
half step : x,반음(semitone),반보
half story : x,중 2층(1층과 2층 사이)
half term : x,학기 중의 중간 휴가(보통 2,3일에서 1주일)
half tide : x,반조(만조와 간조의 중간)
halftimbered : a,나무뼈대의
half time : x,반일 노동,반일급,중간 휴식
half time : x,반일 근무,반일급,(스포츠)하프 타임,중간 휴식
halftime : a,반일제의
halftimer : n,규정 시간의 절반만 일하는(공부하는) 사람(학생),반일제 학동(옛날에,한나절은 학교에 나가고 한나절은 공장에서 일하던)
half tint : x,간색,(수채화의)엷게 하는 칠
half tint : x,간색(demitint),(수채화의)명암 중간부,반바림
half title : x,안표지,(그 곳에 들어 있는)반표제,(간지에 있는)장의 제목
halftone : n,a,망판(화(의)),간색(의),반음
halftrack : n,후부무한 궤도(자동)차
halftruth : n,(사실의)한쪽만의 진실
halfvalue layer : x,반가층(방사선이 물질 통과시,그 힘이 반감하는 흡수 물질의 두께)
half volley : x,공이 튀어 오르는 순간에 치기
halfvolley : vt,vi,하프 발리(쇼트바운드)로 치다
halfway : a,ad,중도의(에),어중된(되게),반쯤,어느 정도,meet a person ~ 타협하다 
halfway house : x,두 마을 중간의 여인숙,타협점
halfway line : x,중앙선
halfwit : n,반편이,얼뜨기
halfwitly : ad,정신박약으로
halfwitness : n,정신박약
halfwitted : a,얼빠진(stupid),정신박약의
half wool : x,면모교직
halfworld : n,반구,화류계,암흑가(underword)
half year : x,반년(1년의)반기,(2학기제의)학기(semester)
halfyearly : ad,a,반년마다(의),연2회(의)
halibut : n,핼리벗(큰 넙치)
halide : x,할로겐화물(의),=halid
halidom : n,신성한 장소(것),=halidome
halieutic : a,고기잡이의,낚시질의
halieutics : n,(단수취급)고기잡는법,낚시 이론,어로법,어로(어업)에 관한 논문
Halifax : n,핼리팩스,영국West Yorkshire의 도시,캐나다의 항구 도시(Nova Scotia주의 도시)
halite : n,암염
halitosis : n,구취
hall : n,현관,복도,넓은방,홀,(공)회당,(대학의)교사,조합본부,사무소,(지주의)저택,(대학의)대 식당
hallah : n,(유대교)할라(안식일등에 먹는 영양가 높은 흰 빵),=challah
Hallel : n,(유대교)할렐(성가중에서 유월절,오순절 등에 부르는 시편의 일부)
hallelujah : n,할렐루야(하느님을 찬송하라)
Hallelujah lass : x,구세군 여자 사관
Halley's comet : n,핼리 혜성
halliard : n,=HALYARD
hallmark : n,vt,(금,은의)순분 인증 각인(을 찍다),보증 딱지(를 붙이다)
hallo : n,여보세요(여보,이봐,이런)(하는 소리)
hallow : int,vi,,vt,n,어이(이봐)(하고큰소리로말하다(기),부르다(부름))(사냥개를 추기거나 때)
hallow : vt,신성하게(깨끗하게)하다,하느님께 바치다,숭배하다,~ed fround 영역
hallowed : a,신성화한,신성한,존경받는
Halloween : n,제성절의 전야(10월31일 밤)
Hallowmas : n,All Saints'Day,제성첨(11월1일)
hall porter : x,(호텔의)짐 운반계
hallstand : n,홀스탠드(옷걸이,모자걸이,우산꽂이 등이 있는 경대형 가구)
Hallstatt : n,a,(오스트리아의 마을 이름에서)할슈타트 문화(기)(의)(기원전 9-5세기의 초기 철기시대)
hall tree : x,(현관 따위의)모자(외투)걸이
hall tree : x,(현관 등에서의)모자(외투)걸이(clothes tree)
hallucinant : n,a,환각 물질(의),환각을 일으키게 하는(것)
hallucinate : vt,환각(증상)을 일으키게하다
hallucination : n,환각,환시,환청,환상
hallucinatory : a,환각의,환각적인,환각을 일으키게 하는
hallucinogen : n,환각제
hallucinogenic : a,n,환각 유발(성)의,환각 유발제
hallucinosis : n,환각증
hallux : n,(사람의)엄지발가락,(새의)제1지,(척추동물의)뒷발의 엄지발가락
hallway : n,현관,복도
halm : n,=HAULM
Halma : n,장기의 일종(256개의 눈이 있는 판으로 두는 놀이,상표명)
halo : n,(해,달의)무리(를 씌우다),후광(으로 두르다)
HALO : x,high altitude low opening(parachute),(군)고공 강하(용 낙하산)
halobacteria : n,호염성 세균
halocarbon : n,할로겐화 탄소
halocline : n,염분 약층(통상,수심 55m 부근의 염분농도가 급변하는 불연속층)
halo effect : x, 후광의 효과
halogen : n,할로겐
halogenation : n,할로겐화,할로겐과의 화합
halo hat : x,헤일로 해트(1940년대에 유행한 여성 모자)
haloid : a,할로겐의(과 비슷한),할로겐염,할로겐 유도체
halomethane : n,할로메탄(할로겐과 탄소의 화합물)
halomorphic : a,중성염(알칼리염)이 있는 곳에서 생성된(토양)
haloperidol : n,할로페리돌(진정제의 하나,정신병 치료에 효과가 있음)
halophile : n,호염균
halothane : n,핼로세인(흡입 마취약)
halt : n,vi,vt,정지(휴식)(하다,시키다),정류소,call	a ~ 정지를 명하다,정지시키다
halt : vi,망설이다,다리를 절다
halter : n,고삐,교수(용 밧줄),(팔과 등이 드러나는) 여자용 운동 셔츠
halterbreak : vt,(망아지를)굴레에 길들게 하다
halterneck : a,홀터넥의(목 뒤에 매다는 형식의 등,소매없는 여성용 드레스 등)
halting : a,절뚝거리는,(시형,이론 등이)불완전한,앞뒤가 맞지 않는,말을 더듬는(stumbling),더듬거리는
halutz : n, 할루츠(농장 개척을 위해 이스라엘로 이주한 유대인(집단))
halva : n,할바(깨와 꿀로 만드는 터키의 과자)
halve : vt,등분하다,반감하다
halvers : n,반으로 나눈 것
halves : n,half의 복수
halvies : n,HALF의 복수
halyard : n,용층줄,마룻줄,이어줄,=halliard
ham : n,햄(소금에 절여 훈제한 돼지의 허벅다리 고기),오금(허벅다리와 궁둥이),(몸짓을 과장하는)서투른 배우,과장된 연기,햄(아마추어 무선 통신자)
Ham : n,Noah의 둘째 아들
hamadryad : n,나무의 요정
hamal : n,(중동의)짐꾼(porter),(인도)머슴
Haman : n,하만(페르시아왕 Ahasuerus의 재상으로 유대인의 적)
hamandeggs : a,일상의(routine)
Hamburg : n,함부르크(서독의 도시,항구),함부르크(작은 닭의 일종),독일산 검은 포도
hamburger : n,햄버거스테이크용의 다진 고기,햄버거,부랑(방랑)자,얼굴이 상처투성이의 프로 복서
hamburger heaven : x,간이 식당,햄버거 식당
Hamburger steak : x,햄버거 스테이크
hame : n,멍에(마차 말의 두꺼운 가슴걸이 위에 대는 두 개의 굽은 나무),불유쾌한(싫은)일,(재능을 살릴 수 없는)허드렛일,단조로운 일
hamfat : vt,vi, 배우가 졸렬하게 연기하다
hamfatter : n,엉터리 배우,하급 배우
hamfisted : a,솜씨 없는,뒤틈바리의
hamhanded : a,굉장히 큰 손을 가진,서투른,솜씨 없는
Hamilton : n,남자 이름
Hamite : n,(Noth의 차남)Ham의 자손,햄족
Hamitic : a,(Noah의 둘째 아들)Ham의 (자손의),햄(어)족의
HamitoSemitic : n,a,햄셈어족(의)(Afro-Asiatic의 옛이름
ham joint : x,값씬 식당,(느긋하게)쉴 수 있는 장소
Haml : n,=Hamlet
Hamlet : n,shakespeare작의 비극
hamlet : n,작은 마을
hammal : n,=HAMAL
hammam : n,터키식 목욕(탕)
Hammarskjold : n,스웨덴의 정치가,전 UN 사무총장(Nobel 평화상 수상(1961))
hammer : n,(쇠,나무)망치,해머,(투)해머,(경매장의)나무망치,(총의)공이치기 bring to the ~ 경매에 부치다,come under the ~ 경매 되다
hammer : vt,망치로 두드리다,두들겨(쳐박아,주입해)넣다,연달아 때리다,호되게 해치우다,두드려서 만들다,생각해 내다
hammer and sickle : x,(해머와 낫으로 된)소련 국기
hammerandtongs : a,맹렬한,정력적인
hammer beam : x,외팔들보
hammer blow : x,망치로 치기,맹타,강타
hammercloth : n,(의식용 마차 등의)마부석의 덮개
hammered : a,해머로 단조(성형)한
hammerhead : n,망치의 대가리,멍텅구리,귀상어
hammerheaded : a,머리가 망치 모양인,우둔한(stupid)
hammering : a,n,해머로 치는,탕탕치는,망치로 침(치는 소리),맹타,(은세공 등의)두드려 만든 무늬
hammerless : a,망치가 없는,(총의)공이치기가 보이지 않는
hammerlock : n,(레슬링)해머록(상대편의 한쪽 팔을 등뒤로 틀어 올리기
hammerman : n,해머를 쓰는 직공,단조공,대장장이,권투선수
hammersmith : n,해머를 사용하는 대장장이,해머 작업의 감독자
hammer throw : x,해머던지기
hammer thrower : n,해머던지기 선수
hammertoe : n,추상족지증(갈고리 모양으로 굽은 기형적인 발가락)
hammer welding : x,단접
hamming code : x, 해밍 부호(회로망 위나 기억 영역 내에서 오류를 검출하여 자동 수정하는 데 쓰는 코드)
hammock : n,해먹
hammock chair : x,해먹 의자(즈크로 만든 접의자)
Hammond organ : n,해먼드 오르간(전기 오르간)
Hammurabi : n,함무라비(기원전 18세기경의 바빌로니아 왕,법령 제정으로 유명)
hammy : a,(맛,외양이)햄같은,(연극,배우가)멜로드라마식의,과잉 연기의
hamper : vt,n,방해하다,손바구니
Hampshire : n,영국남해안의 주
Hampshire : n,햄프셔(영국)남해안의 주 이름,햄프셔(hampshire에서 나는 돼지,양 등)
Hampstead Heath : x,햄스테드 히스(London 북서부의 고지대에 있는 공개 유원지)
hampster : n,일종의 큰 쥐(동유럽,아시아산) 
Hampton Court : x,햄프턴 코트(London의 옛 왕궁)
hamshackle : vt,(말,소 등의)머리를 앞다리에 묶다,속박하다(fetter)
hamstring : n,(사람,말의)오금의 힘줄(을 잘라 절름발이로 만들다,...에 좌절 시키다)
hamulus : n,갈고리 모양의 작은 돌기
Han : n,(중국의)한조,한민족
hanap : n,(장식이 있는 중세의)뚜껑 달린 술잔
hanbow : n,(손으로 쏘는)활
hand : n,손,(동물의)앞발,(시계의)바늘,손 모양의 것(바나나 송이 따위)
hand'sbreadth : n,=handbreadth
hand's turn : x,(약간의)노력,조력,거들어 줌,도와 줌
handandfast : a,(규칙 등이)엄중한,변경을 허락치 않는,명확한(구별)
hand apple : x,(요리하지 않고 먹을 수 있는)생식용 사과
hand ax : n,손도끼
handbag : n,핸드백
hand baggage : x,(여행자의)수하물
handball : n,(벽에 던져 튀는 공을 상대가 받게 하는 공놀이)핸드볼
handbarrow : n,(들것식의)운반대
hand basket : x,손바구니,(경제등이)갑자기 악화하다
handbell : n,요령
handbill : n,삐라,광고지
handbird : n,둥지를 나뭇가지에 매다는 새
handbook : n,편람,안내서,교본
hand brake : x,수동식 브레이크(보조용)
handbreadth : n,한손폭(2,5,4인치)
H and C : x,헤로인(heroin)과 코카인(cocaine)을 섞은 것
handcanter : n,(마술)느린 구보(gallop과 trot의 중간 속도)
handcar : n,수동차
handcarry : vt,손수 갖고 가다(건네주다)(안전 등의 이유로)
handcart : n,손수레
handcarved : a,손으로 조각한(새긴)
handclap : n,박수갈채
handclasp : n,악수
handcraft : n,=HANDICRAFT
handcrafted : a,수제의
handcuff : n,vt,수갑,쇠고랑(을 채우다)
handcuff : n,손으로 치기,치고받기
handdown : n,=handmedown
handed : a,손(잡이)이 있는
Handel : n,(1685~1759)헨델(독일 태생의 영국 작곡가)
handfast : a,vt,n,꼭 쥔,인색한,(악수하여)약혼(결혼)시키다,손으로 쥐다,약속,맹약,계약,(특히)약혼,꽉쥐기
handfasting : n,약혼,(옛날,교회에서 인정치 않은)가결혼,시험결혼
handfeed : vt,(동물에게)개별적으로 먹이를 주다,손으로 먹이를 주다,(사람에게)손으로 먹을 것을 주다,(복사기 등에)손으로 종이를 넣다,(재료 등을)손으로 밀어 넣다
handfinished : a,손으로 마무리한
handflag : n,손기,수기
handfree : a,=handsfree
handfull : n,손에 그득,한 줌,소량,다루기 힘든 사람
hand gallop : x,느린 갤럽,단축 구보
hand glass : n,손거울,돋보기,확대경
hand glass : x,손거울,(모종을 보호하는)유리 덮개,모래 시계,손잡이가 달린 확대경,독서용 확대경
hand goods : n,내구재
handgrater : n,강판
hand grenade : n,수류탄,소화탄
hand grenade : x,수류탄,소화탄,소화병
hand grip : n,쥐기,악수,드잡이,백병전,손잡이,핸들
handgrip : n,악수,손잡기,손잡이,자루,드잡이,격투
handgun : n,권총(pistol)
handheld : n,a,손바닥 크기의(손으로 운반할 수 있는) 퍼스널 컴퓨터,손바닥 크기의,포켓용(크기)의 (컴퓨터),손에 들고 쓰는
handhold : n,파악,손잡을(붙잡을)데
handicap : n,핸디캡(강자에게 불리한,약자에게는 유리한 조건)(을 주다),핸디를 붙이다,핸디붙은 경주
handicapped : a,핸디캡이 붙은(있는),(사람이)심신 장애의
handicapper : n,핸디캡 계원
handicraft : n,수세공,수예,손끝의 숙련
handicraftsman : n,수공업자,수공예자,수예가,기공
handieTalkie : n,휴대용 소형 무선 송수신기
handily : ad,솜씨 있게,잘,편리하게,쉽게,수월하게,바로 가까이에
handiness : n,솜씨 좋음,알맞음,편리함
handinhand : a,손에 손을 잡은,손을 맞잡은,나란히 선,균형이 잡힌
handiwork : n,수세공(품),짓,소행
handjob : n,손에 의한 성기의 애무,수음
handkerchief : n,손수건
handkie : n,손수건
handkissing : n,여성의 손등에 하는 키스
handknit(ted) : a,손으로 짠(뜬)
hand language : n,(벙어리의)손짓말,수화
handle : n,자루,손잡이,핸들,구실,기회,fly off(at) the ~ 욱하다,up to the ~ 극단으로,철저히
handle : vt,손으로 다루다,조종하다,손대다,처리하다,논하다,대우하다,(군대를)지휘하다,장사하다
handlebar : n,(자전거의)핸들,팔자,수염
handlebar moustache : x,팔자 수염
handled : a,핸들이 있는,자루가 달린
handler : n,취급하는 사람,트레이너,매니저,세컨드
handless : a,손이 없는,손재주 없는
handline : n,(낚시대 없이)손으로 쓰는 낚싯줄
handling : n,손에 대기(잡기),취급,조종,운용,수법
handlist : n,(참조,점검용의)간단한 리스트,일람표
handloom : n,(손으로 짜는)베틀,수직기
hand luggage : x,(여행자의)수하물,기내 반입용 수하물
handmade : a,(기계가 아닌)손으로 만든
handmaid(en) : n,시녀,하녀
handmedown : a,만들어 놓은,기성의,기성복
hand mill : n,맷돌
handmill : n,맷돌,손절구
hand mirror : x,손거울(hand glass)
hand money : n,계약금,착수금
hand money : x,계약금,보증금(earnest)
hand mower : x,수동식의 풀 베는 기계
handoff : vi,vt,n,(럭비)(상대방을)손으로 떼밀어 젖히다,(공을)패스하다
hand organ : n,수동식 오르간
hand organ : x,손으로 돌리는 풍금
handout : n,거지에게 주는 음식(돈,의류),(신문사에 돌리는)공식 성명(서),유인물
handpick : vt,손으로 따다(pick by hand),주의해서 고르다,정선하다
handpicked : a,정선된,(과일 따위)손으로 딴
handplay : n,(서로)치고받기,주먹다짐
handpost : n,길표,도표
handprint : n,장문,(먹을 묻혀 누른)손바닥 자국
hand prop : x,(배우가 무대에 갖고 나가는)개인 소유의 소도구
handpump : n,수동 펌프
hand puppet : x,손을 집어넣어서 놀리는 꼭두각시
handrail : n,난간
handsaw : n,(한손으로 켜는)작은톱
handsel : n,vt,새해(축하) 선물(을 주다),(신부에게 대한)예물(을 주다),착수금(을 내다),첫 불입금
handset : n,(탁상 전화의)송수화기
handsewn : a,손으로 꿰맨
handshake : n,악수
handsoff : a,무간섭(주의)의
handsome : a,(남자가)단정하게 잘 생긴,(선물 따위)활수한,상당한
handson : a,실질 훈련(용)의,실제의,개인이 적극 참여하는,실천의
handspeak : n,(나무)지레,(감는 녹로의)심대
handspike : n,지레
handspring : n,공중제비
handstaff : n,도리깻장부
handstand : n,물구나무서기
handtector : n,소형 전자 금속 탐지기(특히 공항에서의 흉기 발견용)
handtight : a,힘껏 손으로 잡아당겨 팽팽하게 한
handtohand : a,주먹다짐(드잡이)의,접전의
handtomouth : a,그날 그날 살아가는,불안한,앞일을 생각
hand towel : x,(물을 축여)손을 닦는 작은 타월
hand truck : x,(두 바퀴)손수레,소형 운반차
handwave : n,vi,속임수,(주의력을 딴 곳으로 쏠리게 해서)속이다
handwheel : n,수동 핸들(수동 브레이크,밸브등이 붙어 있음)
handwork : n,손으로 하는 일,수세공
handworked : a,수세공의,손으로 만든
handwoven : a,손으로 짠,수직의
handwrite : vi,n,손으로 쓰다,=handwriting,서명
handwriting : n,육필,필적,필사본,the ~ on the sall 흉조
handwrittin : a,(펜,연필 등을 사용하여)손으로 쓴
handwrought : a,=handworked
handy : a,가까이 있는,알맞은,편리한,솜씨 좋은
handydandy : n,먹국(어느 손에 물건이 있는가를 알아맞히는 놀이)
handyman : n,허드렛 일꾼,잔재주 있는 사람,선원
Han ford : n,미국 Washington 주의 마을(플루토늄 생산 공장인 Hanford Enginner Wlrks의 소재지)
hang : vt,vi,걸(리)다,매달(리)다,늘어뜨리다,늘어지다,(벽지를)벽에 바르다,교살하다,~ in the balance ~ 결정하지 않다
hang : n,걸림새,늘어진 모양,사용법,방식,요령,취지,조금도
hangar : n,격납고,곳집
hangarage : n,격납고
hangbird : n,둥지를 나뭇가지에 매다는 새
hangdog : a,비굴(비열)한 (사내)
hanger : n,거는 사람,옷걸이,갈고리,매단 광고,단검
hangeron : n,식객,추종자,염관 운동자
hangfire : n,(폭약의)지발(뇌관에 불을 붙인 후의)
hang five : x,(파도타기에서)서프보드의 앞쪽 가장자리에 한쪽 발의 발가락 모두를 구부려 걸치기
hangglide : vi,행글라이더로 날다
hang glider : x,행글라이더
hang gliding : x,행글라이더 비행
hanging : n,교살,교수형,걸린 것,커튼,내리막,급경사
hanging : a,교수형에 처할,매달린,급경사의,임박한
hanging bridge : x,조교
hanging committee : n,(전람회의)심사 위원회
hanging curve : x,행거 커브(구부러지지 않은 커브로,때리기 좋은 공이 됨)
hanging gardens : x,가공원(낭떠러지에 공중에 걸려 있는 것 처럼 만든 정원)
hanging indention : x,행잉 인덴션(단락의 첫 행 이외는 모두 가지런히 물려 짜기)
hanging judge : n,교수형 내리기 좋아하는 판사
hangingloose : a,느긋한,긴장이 풀린,자유로운,홀가분한,속박 당하지 않은(uninhibited)
hangingonthewall : a,벽걸이식의
hanging paragraph : x,행잉 패러그래프(hanging indention에 의한 단락)
hanging valley : x,현곡
hanging wall : x,상반(경사진 광맥 등의 위쪽 암층
hang klider : n,행글라이더
hangman : n,교수형 집행리
hangnail : n,손거스러미
hangout : n,(주로 악한의)소굴
hangout road : x,진실의 완전한 폭로,속속들이 드러내기
hangover : n,잔존물,유물,남은 영향,유습,숙취,(약의)부작용
hangtag : n,(기구에 붙인)설명서(쪽지)
hang ten : x,(파도타기에서)서프보드의 앞쪽 가장자리에 양쪽 발가락 모두를 구부려 걸지치
hangtime : n,행타임(펀트(punt)한 공의 체공 시간)
Hangul : n,한글,=hankul
hangup : n,(심리적인)거리낌,구애,저항,콤플렉스,고민거리,장애(obstacle)
hank : n,한 다발,타래
hanker : vi,갈망(동경)하다
hankering : n,a,갈망,열망,갈망하는
hankey : n,=hanky
hanky : n,손수건,=hankie
hankypanky : n,협잡,사기,요술,객적인 이야기(짓)
Hannah : n,여자 이름
Hannibal : n,남자 이름,한니발(카르타고의 명장)
Hanoi : n,베트남의 수도
hanover : n,(책임,경영권등의)이양
Hanover : n,독일 북서부의 도시,(영국)하노버 왕가(GogergeI 부터 Victoria 여왕까지)
Hanoverian : a,n,(영국의)하노버 왕가의 (사람),하노버 왕가 지지자(의)
Hans : n,독일(네덜란드)사람의 별명
hansa : n,(중세 유럽의) 상인 조합
Hansard : n,영국 국회 의사록
Hansardize : vt,의사록을 인증하여(국회 의원을)논박ㅎ다
Hanse : n,=Hansa
Hanseatic : a,한자 동맹의
Hanseatice : a,한자 동맹(독일을 중축으로 하는 중세 여러 도시의 상업 동맹)
Hanseatic League : x,한자 동맹(독일을 중축으로 하는 중세 여러 도시의 상업 동맹)
hansel : n,v,=HANDSEL
Hansens disease : n,한센병,문둥병
hansom : n,(2인승의)말 한 필이 끄는 2륜 마차
Hants : x,Hampshire(영국의 주 이름)
Hanukkah : n,(유대)하누카(신전 정화기념 제전,성전 헌당 기념일),=hanukah
haole : n,하와이 토박이가 아닌 사람(특히 백인)
hap : n,vi,우연,행운,우연한 일,(우연히)일어나다
hapenny : n,HALFPENNY
haphazard : n,우연,우연(한일),at(by) ~ 우연히,아무렇게나
haphazard : a,ad,우연의(히),되는대로(의)
hapless : a,불행한
haplography : n,중자 탈락(비슷한 단어,행의 탈락에도 씀)
haploid : a,n,단일의,단순한,(염색체가)반수(성)의,반수체
haploidy : n,반수성
haplologic : a,반수성의
haply : ad,우연히
haply : ad,우연히,아마,어쩌면
happen : vi,일어나다,생기다,우연히(공교롭게도)...하다,~ on 우연히(뜻밖에)...을 만나다(발견하다)
happenchance : a,우연한,뜻밖의
happening : n,우발사,사건,해프닝(즉흥적인 행위나 행사)
happenso : n,우연한(생각잖은)일
happenstance : n,생각지도 않던 일,우연한 일
happenstantial : a,우발적인,뜻밖의,우연히 일어난,부수적인
happiness : n,행복,행운,유쾌,교묘,(용어의)적절
happy : a,행복한,행운의,즐거운,유쾌한,(용어가)적절한,교묘한
happy cabbage : x,(상당한)돈(옷,유흥등에 쓸 수 있는)
happy dispatch : x,(익살)할복
happy dust : x,분말 마약(코카인,헤로인 등)
happy event : x,경사,(특히)출산,탄생
happygolucky : a,낙천적인,태평스러운,되는 대로의
happy hour : x,(술집 등에서의)서비스 타임(할인 또는 무료 제공되는),(회사,대학에서의)비공식 집회 시간(가벼운 음식물이 제공됨)
happy hunting ground : x,(북미 인디언 무사의)천국,(무엇을 찾는 사람에게)안성맞춤인 곳,만물이 풍성한 곳,행동 자유 지역
happy land : x,천국(heaven)
happy medium : x,중도,중용
happy pill : x,정신 안정제,진정제(tranquilizer)
happy release : x,고통으로부터의 해방,죽음
happy ship : x,승무원이 모두 협력해서 일하는 배,구성원이 일치 단결해서 일하는 단체
happy talk : 가벼운 화제를 중심으로 한 부드러운 분위기의 뉴스 프로,
Hapsburg : n,합스부르크가(옛 오스트리아의 왕가)
hapten : n,합텐,부착소(생체에 면역 반을을 일으키는 물질),=hapten
haptic : a,촉각에 관한(의한),=haptical
haptic lens : x,공막 렌즈(백안부)까지 덮는 콘택트 렌즈)
harakiri : n,할복(자살),자살 행위
haram : n,=harem
harambee : n,협조,일치 협력
harangue : n,vi,vt,(장황한)열변(토하다),장광설(을 늘어 놓다)
haras : n,종마 사육장
harass : vt,괴롭히다
harassed : a,매우 지친(끊임없는 근심 등으로)몹시 시달린,(표정등이)초조한,성가신 듯한
harassing : a,괴롭히는,귀찮게 구는
harassment : n,괴롭힘,애먹음,고민(거리)
harbinger : vt,n,예고(하다),선구자
harbo(u)rage : n,정박,피난,정박(피난)소
harbor : n,항구,피난처,은신처
harbor : vt,피난처를 제공하다,숨기다,(원한,악의를)품다
harbor : vi,숨다,정박하다
hard : a,딱딱한,굳은,단단한,견고한,(...하기)어려운,(몸이)튼튼한,열심히 일하는,시세가 강세의,엄격한,격렬한,고된,괴로운,(음식이)조악한
hard : ad,열심히,격렬히,몹시,간신히,애써서,가까이,매우
hard : n,상륙(양육)장,징역,중노동
hardback : n,두꺼운 표지의 색
hardbake : n,아먼드(편도)를 넣은 사탕 과자
hardbaked : a,딱딱하게 구운
hardball : n,경식야구,(야구의)경구
hardbitten : a,만만치 않은,완고한,산전수전 겪은
hardboard : n,판지,하드보드(톱밥 등으로 만든 목재 대용품)
hardboil : vt,(달걀을)단단하게 삶다
hard boild school : n,비정파
hardboiled : a,(달걀 따위)단단하게 삶은,(소설 따위)비정한,감상적이 아닌,현실적인,완고한
hardbought : a,애써서 얻은
hardbound : a,두꺼운 표지를 씌운
hard bubble : x,하드버블(컴퓨터 회로에서 기억의 분열을 일으키는 자기 버블
hard case : x,난치병 환자,회복 불가능한 환자,개전의 정이 없는 죄인,상습범(자),불량배,처리하기 어려운 사건
hardcase : n,(회복 가망이 없는)환자,(개전의 가망이 없는)죄인,난국,형편이 딱한 사람
hard cash : n,경화,(수표,어음에 대하여)현금
hard cheese : x,불행,불운,(감탄ㅁ사적으로)그거 안됐군,(겉치레의 동정)
hard cider : x,,발효 사과술(알코올분이 10%이하)
hard coal : n,무연탄
hard copy : x,하드 카피(컴퓨터의 처리결과를 눈으로 읽을 수 있는 형태로 인쇄한 것
hard core : n,(단체,운동 등의)핵심,강경파
hardcore : a,핵심의,절대적인,무제한의,단호한,철저한,본격적인,(사회의)최하층의,만성 실업의,(포르노 영화,소설 등)극도로 노골적인
hardcore porn : x,노골적인 도색 영화(포르노)
hardcover : n,a,두꺼운 표지의 (책)
hard cured : x,하드 코트(아스팔트,콘크리트 등으로 닦은 옥외 테니스코트)
hardcured : a,(생선 등을)말린,건어로 한,=harddried
hard currency : x,경화(주조 화폐 또는 금 내지 달러와 쉽게 교환 가능한 통화)
hard detergent : x,경성 세제(미생물에 의해 분해되지 않음)
hard dock : x,(둘 이상의 우주선의)기계적 도킹(결합)
harddock : vi,(둘 이상의 우주선이)기계적 조작에 의해 도킹(결합)하다
hard drink : x,(위스키 등처럼)도수가 높은 술(hard liquor)
hard drinker : x,술이 센 사람,술고래,주호
harddriving : a,(사람이)정력적인(energetic),부하를 마구 부리는
hard drug : n,습관성 마약
hardearned : a,고생하여 얻은(번)
hardedge : n,a,하드에지(의)(기하학적 도형과 선명한 윤곽의 추상 회화
harden : vt,굳어지다,굳히다,단다하게 하다(되다),경화하다,단련(강화)하다,무정하게 하다(되다)
hardened : a,굳어진,경화한,단단해지,강해진,철면피한,무정(냉담)한,상습적인
hardener : n,굳게 하는 것,경화(촉진)제,(칼 등을)불리는 (담금질하는) 사람,경막제,모합금
hardening : n,(강철의)표면 경화,(쇠붙이의)불림,담금질,(시멘트,유지 등의)경화,경화제,경화(증)
hardface : vt,(금속의)표면에 내마모강을 용접하다,경질 금속을 입히다(씌우다)
hardfaced : a,뻔뻔스러운,철면피의
hardfavoured : a,사나운 얼굴을 한,험상궂게 생긴
hardfeatured : a,얼굴이 험상궂은,인상이 나쁜,=hardfavored
hard feelings : x,적의,악감정,(남에 대한)언짢은 생각,원한
hard fish : x,건어,어포
hardfisted : a,인색한,구두쇠의,매정한,강압적인
hard food : x,고형 사료,(말의)곡물 사료(걸쭉한 사료나 마초에 대하여)
hardfought : a,격전의(결과 획득한)
hard goods : x,내구 소비재(주택,가구,자동차 등)
hardgrained : a,(목재 등이)결이 단단한,(성격이) 모진,완고한
hardhack : n,조팝나무류의 관목(북미산)
hardhanded : a,(일해서)손이 거친,엄한,압제적인
hard hat : x,=derby,(공사 작업원의)안전모,헬멧,(안전모를 쓴)건설 노동자,극단적인 보수(반동)주의자,강경 탄압주의자
hardhat : a,안전모를 쓸 필요가 있는,초 보수(반동)주의의,완고한
hardhattism : n,보수(반동)주의,과격파 강경 탄압
hardhead : x,융통성 없는 사람,고지식한 사람,빈틈없는(실제적인)사람
hardheaded : a,(성질이)냉정한,실제적인,완고한
hardheaded sponge : x,탄성이 있는 경질 섬유의 해면(서인도 제도,중앙아메리카산)
hardhearted : a,무정한
hardhit : a,심각한 영향을 받은,큰 타격을 입은,불행으로 재기 불능케 된,강하게 끌린,깊은 사랑에 빠진
hardhitting : a,활기가 있는,적극적인,강력한
hardihood : n,대담,뻔뻔스럼
hardily : ad,대담하게,뻔뻔스럽게(도)
hardiness : n,강장,내구력,대담,철면피,뻔뻔스럼
Harding : n,하딩(미국 제29대 대통령)
hard labor : n,(형벌로서의) 중노동
hard landing : n,(우주선의)경착륙
hard legs : x,젊은이,남자,멋쟁이,메주,호박(여자)
hard line : x,(정치 등의)강경 노선,강경책
hardline : a,강경론(노선)의
hardliner : n,강경 노선의 사람,강경파
hard lines : n,강경 노선(방침)
hardlining : a,강경 노선을 취한는
hard liquor : n,독한 술(증류수)
hard luck : x,불행,불운
hardluck story : x,(동정을 끌기 위한)가련한 신세 이야기(타령)
hardly : ad,거의...않다,간신히,겨우,아마 ...아니다,애써서,고생하여,엄하게,가혹하게,~ ever 좀처럼 없다,~ when(before) ...하자마자,...하기가 무섭게
hard money : x,경화,태환 화폐,정화
hardmouthed : a,재갈이 듣지 않는(말 등),다루기 힘드는,고집 센,말투가 거친(사람)
hardness : n,단단함,견고,경도,물의 경연,곤란,난해,준엄,가혹,무정
hard news : n,정치,경제 관계의 뉴스
hardnose : n,고집이 센 사람,콧대가 센 사람
hardnosed : a,콧대 센,고집 센,=hardheaded
hard nut : x,다루기 어려운 것(사람,문제)
hardofhearing : a,난청의,잘 안 들리는
hardon : n,(남자 성기의)발기
hard pad : x,(개의)경척증
hard palate : x,경구개
hardpan : n,경질지층,암상,확고한 기반,현실의 바탕,최저선(가격)
hard paste : x,경질 자기
hard porn : x,성 묘사가 노골적인 도색 영화(소설)
hardpressed : a,(일,돈에)쫓기는,곤경에 처한
hard rock : x,하드 록(앰프를 사용하여 규칙적인 비트로 연주하는 록
hard roe : x,어란,(특히)연어 알
hard rubber : x,경질 고무
hards : n,삼부스러기
hard sauce : x,하드 소스(버터와 설탕을 섞고 크림,향료를 넣은 소스,파이,푸딩 등에 뿌림)
hard science : n,자연 과학
hard science : x,자연 과학(물리학,화학,생물학,지질학,천문학 등
hardscrabble : a,일한 만큼의 보답을 못 받는,열심히 일해야 겨우 먹고 살수 있는
hard sell : n,강압적인 판매(방법)
hardsell : a,vt,적극적인(끈질긴)판매의,적극적으로(끈질기게) 판매(광고)하다
hardset : a,곤경에 빠진,딱딱해진,굳어 버린,(알이)깰 때가 된,결심이 굳은,고집 센,완고한,굶주린
hardshell : a,껍질이 딱딱한,자기 주장을 굽히지 않는,비타협적인
hardship : n,고난,고생,학대
hardship index : x,하드십 지수,곤궁도 지수(경제적 곤궁도를 나타내는 지수)
hard shouldef : x,(도로의)대피선,단단한 노견
hardspun : a,단단하게 지은
hardstand : n,(비행장의) 포장 주기장
hard stuff : x,독한 술(맥주,과실주 등에 대해서),위스키
hardstuff : n,=hard drug
hardsurface : n,(도로를)포장하다
hard swearing : x,(완곡)태연한(천연덕스런)위증
hardtack : n,건빵
hard ticket : x,지정 좌석권
hard times : n,불경기
hardtop : n,덮개가 금속제이고 앞창에 중간 기둥이 없는 승용차
hardware : n,철물,철기류,무기류,하드웨어(컴퓨터의 기계 설비),(우주로켓,미사일 등의)본체
hardware industry : x,하드웨어 산업(컴퓨터의 기계,설비를 개발,생산하는 산업)
hardwareman : n,철물 제조인,철물 상인
hard water : n,센물,경수
hard way : x,고생하여 (공부(출세)하다 등),엄격히 (키우다 등)
hardwearing : a,(옷 등이)오래가는,질긴,(천 등이)질긴
hard wheat : x,경질 소맥(마카로니,스파게티,빵 제조용)
hardwired : a,(입출력 회로 등이 프로그램에 의하지 않고)배선(결선)에 의한,영구 전자회로의
hardwood : n,단단한 나무(떡갈나무,마호가니 등)
hard word : x,의뢰,부탁
hard words : x,어려운 말,역,성난 말투
hardworked : a,혹사 당하는,지친,낡아 빠진(농담 등)
hardworking : a,근면한
hardy : a,내구력이 있는,고난(학대)에 견디는,대담(용감)한,무모한,(식물 따위)내한성의
Hardy : n,Thomas (1840~1928) 영국의 소설가,시인
Hardy annual : n,일년생 내한 식물,해마다 되풀이되는 문제
hare : n,산토끼(ravvit보다 큼) an mad as a March ~ (교미기의 산토끼처럼)이쳐 날뛰는
hare'sfoot : n,클로버(토끼풀의 일종)
harebell : n,초롱꽃
harebrained : a,경솔한
harefoot : n,(특히 아메리칸 폭스하운드의)토끼 같은 발,잉글랜드왕 Haroid 1세의 별명
harefooted : a,발이 빠른,토끼 같은 발을 가진
harehearted : a,소심한,겁 많은
Hare krishna : n,하헤크리슈나(힌두교의 Krishna 신에게 바친 성가의 제목,(하레)크리슈나교(도)
harelip : n,언청이
harelipped : a,언청이의
harem : n,(회교국의)도장방,후궁(의 처첩들)
harem pants : x,하렘 바지(발목 부분을 끈으로 묶게 된 통이 넓은 영성용 바지
haricot : n,강낭콩이든 양고기 스프
hark : vi,듣다,경청하다 Hstk! 들어 보아라! ? ~ back 되돌아 오다
harken : vi,=hearken
harl : n,할(아마,대마 줄기의 섬유),제물낚시(herl)
Harlem : n,(New York시의)흑인구역
harlequin : n ,(가면)어릿광대역,어릿광대
harlequinade : n,Harlequin이 나오는 막,어릿광대짓
harlequin bug : x,날개에 흑적색 얼룩무늬가 있는 방귀벌레의 일종(양배추의 해중)
HarleyDavidson : n,할리데이비드슨(미국제 대형 오토바이의 상표)
Harley Street : n,할리가(런던의 일류 의사들이 많이 사는 거리)
harlot : n,매춘부,매춘
harlotry : x,매춘,매춘부
harm : n,vt,해(치다),손해(손상)(을 주다),to ~ 괴로움을 당하다,된서리 맞다,do ~ to ...을 해치다,out of ~'s way 안전(무사)하게
harmattan : n,하르마탄(12월부터 2월에 걸쳐 아프리카 내지에서 서해안으로 부는 건조한 열풍)
harmful : a,해로운
harmless : n,해없는,악의 없는
harmonic : n,조화적인,화성의,조화의,배음,고조파
harmonica : n,하모니카
harmonic analysis : x,조화 분석,조화 해석,조파 분석
harmonic distortion : x,고조파 왜곡
harmonic motion : x,조화 진동
harmonicon : n,하모니카,오케스트리온(오르간의 일종)
harmonic progression : x,조화 수열,화음 연결
harmonic proportion : x,조화 비례
harmonic quantities : x,조화수
harmonics : n,(단수취급)화성학
harmonic series : x,조화 급수
harmonic tones : x,배음
harmonious : a,가락이 맞는,조화된,균형잡힌,화목한,의좋은
harmonist : n,화성학자,4복음서의 공관적 연구자
harmonistic : a,화성학적인,화성가의,(복음서의)공관적 연구(자)의
harmonium : n,소형 오르간
harmonization : n,조화,일치,화합
harmonize : vi,vt,조화(화합)시키다(되다),(선율에)화음을 가하다
harmony : n,조화,화합,일치,화성
harness : n,(마차말,짐말의)마구,갑옷,(작업용의)설비,in ~ 나날의 일에 종사하여,집무중에,work in double ~ 맞벌이하다
harness : vt,마구를 채우다,(폭포 등 자연력을) 이용하다
harness bull : x,정복 경찰관,순경,=harness cop,harness dick
harness race : x,하니스 레이스(마구를 달고 1인승 2륜마차를 끄느 경마)
harnessry : n,마구류,마구상
Harold : n,남자이름
haroosh : n,큰소란,싸움
harp : n,하프,수금,거문고자리
harp : vi,하프를 타다,(같은 이야기를)몇번이고 되뇌다
harper : n,하프 연주자
Harper's Magazine : x,하퍼즈지(미국 대표적인 문예 평론지,1850년 창간)
harp guitar : x,대형 기타
harpin : n,뱃머리의 두꺼운 외판,(조선시의)지지 틀판,=harping
harpist : n,하프 연주자
harpoon : n,vt,작살(을 쳐(쏴)박다)
harpoon gun : x,포경포(작살을 발사하는)
harpsichord : n,하프시코드(16,18세기의 피아노 비슷한 악기)
Harpy : n,여자 얼굴에 새의 몸을 가진 괴물,탐욕스러운 사람
harpy eagle : x,두 개의 관모를 가진 큰 독수리(남미산)
harquebus : n,화승충
harridan : n,추악한 노파,마귀 할멈
harrier : n,해리어 개(토끼 사냥용)매의 일종,약탈자
Harriet : n,여자 이름
Harris : n,남자이름
Harrison : n,남자 이름,해리슨(미국의 제23대 대통령)
Harris poll : x,해리스 여론 조사(미국의 대표적 여론 조사 기관의 하나)
Harris Tweed : n,스코틀랜드산의 손으로 짠 모직
Harrovian : a,n,영국 Harrow 학교의(학생,출신자)
Harrow : n,Harrow 학교(영국 London 근교에 있는 public school,1571년 창립),영국 London근교의 HarrowontheHill지구(Harrow 학교의 소재지)
Harrow : n,써레,under the ~ 괴로움(어려운)을 당하여
Harrow : vt,써레질하다,상하다,괴롭히다
Harrowing : a,마음 아픈,비참한
harry : vt,침략(유린)하다,약탈(노략)하다,괴롭히다
Harry : n,남자 이름,악마,악귀(devil),야한 젊은이,런던 토박이
harsh : a,거친,껄껄한,귀에 거슬리는,(빛깔이)야한,엄한,호된,가혹한
harshen : vt.vi,거칠게 만들다,거칠어지다,엄하게 하다,엄해지다
harslet : n,=haslet
hart : n,(다섯 살 이상의)고라니의 수컷
hartal : n,(인도)(영국상품)불매 동맹,동맹 휴업
hartebeest : n,(남아프리카 산의)큰영양
hartshorn : n,수사슴뿔,녹각정(옛날에,각성제로 쓰던 탄산 암모늄)
hartstongue : n,나도파초 일엽(꼬리고사리과)
harumscarum : a,덤벙대는,경솔한,무모한
harumscarum : n,경솔,덤벙(대는 사람),무모한 짓
haruspex : n,창자 점쟁이(고대 로마 때,제물로 바친 짐승의 창자로 점을 침)
Harvard : n,미국에서 가장 오래된 대학(1636년 Massachusetts주에 설립)
Harvarditis : n,하버드 병(자식을 하버드 대ㅏ에 넣고 싶어하는 부모들의 병)
Harvardman : n,하버드 대학 출신
Harvard system : x,하버드 시스템(학술서,잡지의 참고 문헌 표시법의 하나)
harvest : n,수확,추수,수확기,결과,보수,소득
harvest : vi,vt,거두어 들임,수확(추수)하다
harvest bug : x,=harvest mite
harvester : n,수화자,거두어 들이는 일꾼(reaper)수확기,=harvest mite
harvest festival : x,추수 감사제(교회에서 울리는)
harvest fly : x,매미(cicada)
harvest home : x,수확 축제,수확 완료
harvest index : x,수확 지수(곡초의 전중량에 대한 수확물 중량의 비)
harvestman : n,거두어 들이는 일꾼,소경거미
harvest mite : x,가을 진드기
harvest month : x,추수하는 달(9월)
harvest moon : x,추분경의 만월
harvest mouse : x,들쥐(곡물의 줄기에 집을 만듦)
harvesttime : n,수확기
Harvey : n,남자이름
has : v,have의 3인칭,단수,직설법 현재
hasbeen : n,(인기,영향력이 없어진)과거의 사람,시대에 뒤진 사람(것)
hash : n,해시 (잘게 썬)고기 요리,식사,주워 모은 것,고쳐 만듦
hash : vt,잘게 썰다,엉망으로 만들다
hasher : n,급사
hashhead : x,대마초(마리화나)중독자
hashheesh : x,=hashish
hash house : n,간이 식당
Hashimoto's disease : x,하시모도병,만성 갑상선염(갑상선 기능이 저하되는 질환)
hashish : n,인도 대마의 말린 잎(마취약용)
hashish oil : x,마리화나,인도 대마의 유효성분,=hash oil
hash mark : x,연공 수장(육,공군은 3년,해군,해병대는 4년)
hashslinger : n,(식당의)웨이터(웨이트리스),요리사
hashup : n,(신품으로 보이려는)개조품,개작,재탕,범벅,혼란
Hasid : n,하시드교(유대교의 일파)
Hasidism : n,하시디즘(1750년경 폴란드에서 일어난 유대 신비주의의 한 파)
haslet : x,(돼지,양의)내장
hasn't : v,has not의 단축형
hasp : n,걸쇠,고리(쇠),실타래,방추
hassle : n,난투,싸움
hassock : n,(무릎꿇고 예배하기 위한)무릎방석,풀숲
hast : v,have의2인칭,단수,직설법 현재
hastate : a,(잎이)창끝 모양의
haste : n,서두름,급속,성급
haste : vi,서두르다
haste : vt,재촉하다,서두르게 하다
hasten : vt,vi,,서두르다(게하다),재촉하다
hastily : ad,급히,서둘러서,허둥지둥,성급하게,경솔하게
hastiness : n,조급함,성급함
Hastings : n,헤이스팅즈(초대 인도 총독),영국 Sussex주 동남해안의 도시
hasty : a,급한,성급한,경솔한 ~ conclusion 속단,지레짐작
hat : n,(테가 있는)모자(를 씌우다) hang up one's ~ 오래 머무르다,푹쉬다,~ in hand 공손히
hatable : a,=hateable
hatband : n,모자(에 두른)리본
hatblock : n,모자 골
hatbox : n,모자 상자
hatbrush : n,모자 솔(실크 해트용)
hatcase : n,=hatbox
hatch : vt,(알을)까다,(음모를)꾸미다
hatch : vi,(알이)깨다,(음모가)꾸며지다
hatch : n,부화,한 배(의 병아리),한배 새끼 matches and dispatches 출생,약혼,결혼,사망란
hatch : n,(배의)승강구,창구,해치,(내리닫이의)아래짝 문,수문
hatch : n,vt,(사선 따위의)음영(을 긋다)
hatchability : n,부화할 수 있음
hatchable : a,부화할(될) 수 있는
hatchback : n,트렁크 문이 위로 열리는 자동차(의 뒷부분)
hatch boat : x,갑판 전체가 창구로 된 짐배의 일종,반갑판의 어선
hatcheck : a,(모자 등)휴대품을 보관하는(보관하기 위한)
hatched : vt,(삼,아마를) 흙다,빗기다
hatched moulding : x,마름모 장식
hatchel : n,(삼,아마를 흙는)쇠빗
hatcher : n,알을 까는 새(동물),알 품은 닭,부란기(incubator),음모가
hatchery : n,(물고기의)부화장
hatchet : n,자귀,bury the ~ 휴전하다,화해하다,dig(take) the ~ 싸움을 시작하다
hatchetfaced : a,얼굴이 여위고 모난
hatchetry : n,손도끼 사용법,(예산 등의)삭감(공작)
hatch face : n,뽀족한 얼굴
hatching : n,해칭,선영(그려넣기)
hatch job : n,중상
hatch man : n,살인 청부업자,두목의 심복,독설가,독설 기자
hatchment : n,(묘앞,문앞 따위에 거는)죽은이의 문표
hatchway : n,창구
hate : vt,미워하다,몹시 싫어하다,(가벼운 뜻으로)좋아하지 않다,유감으로 생각하다 ~ out (미워서)내쫓다,따돌리다
hate : n,증오(의 대상)
hateable : a,미워할 만한,싫은,가증스러운
hateful : a,미운,가증스러운,싫은,지긋지긋한,증오(악의)에 찬
hateless : a,미워하지 않는
hate mail : x,짓궂은(달갑지 않은)편지
hatemonger : x,선동을 일삼는 사람,남에게 증오,편견을 갖게 하는 사람,반목,적대하는 사람
hate sheet : x,(인종,국가,종교 등에)편파적 증오심을 나타내는 신문(간행물)
hatful : n,모자 하나 가득
hath : v,have의 제 3인칭 단수,현재,직설법
Hathor : n,하토르(고대 이집트에서 신앙되던 사랑,번식,육아의 여신)
hatless : a,모자 없는(안 쓴)
hatpeg : n,모자걸이(못)
hatpin : n,여자 모자의 핀
hat rack : x,모자걸이
hatrail : n,(벽에 박은)모자걸이
hatred : n,증오,혐오
hat size : x,모자의 사이즈
hatstand : n,모자걸이대
hatted : a,모자 쓴
hatter : n,모자상
hatters shakes : n,수은 중독 
hatth : n,=HAS
hatting : n,모자제조업,제모 재료
hat tree : x,(가지가 있는)모자걸이
hat trick : x,(모자를 상으로 준 데서)(크리켓)투수가 연속 3명의 타자를 아웃시킴,혼자서 3점을 땀
Hatty : n,여자 이름(Harriet의 통칭)
haubergeon : n,=habergeon
hauberk : n,사슬 미늘 갑옷 
haugh : n,(스코)강변 저지의 (목)초지,평탄한 충적지
haughty : a,오만한,거만한
haul : vt,잡아끌다,잡아(끌어)당기다,운반하다
haul : vi,잡아당기다,(배가 바람 불어오는 쪽으로)침로를 바꾸다 ~ down one's flay 항복하다
haul : n,세게 당기기,운반(물,거리),(물고기의)한 그물,잡은(번) 것
haulabout : n,급탄선
haulage : n,잡아당김,운반(장치),견인력,견인량,화차 사용료,운임
hauler : n,잡아당기는 것(사람),(특히)운송업자(회사),굉장한 속력을 내는 자동차
haulier : n,당기는 사람,짐마차꾼,(옛날 탄광의)갱내 운반인,(트럭)운송 회사(업자)
haulm : n,(수확이 끝난)콩이나 감자 줄기
haunch : n,엉덩이,(사슴,양따위의) 다리와 허리의 고기
haunch bone : x,요골,무명골(hipbone)
haunt : vt,vi,n,자주가다(다니다),(유령이)나오다,출몰하다,마음에 붙어 다니다,자주가는(모이는) 장소,소굴
haunted : a,(귀신 등이)붙은,도깨비(유령)가 나오는,고뇌에 시달린
haunting : a,n,마음에서 떠나지 않는,잊혀지지 않는,자주 다님,(유령 등의)출몰
Hausa : n,하우서족(의 사람)(아프리카의 Niger,Nigeria등의 주요 흑인종),하우서 말(서부 아프리카의 상됴어),=Haussa
hautboy : n,=OBOE
haute : a,고급의(high-class),상류(사회)의,=haut
haute couture : n,고급 복식(점),최신 유행복(점)
haute cuisine : n,(=high kitchen)고급(프랑스) 요리
haute ecole : n, (=high school)고등 마술
hauteur : n,오만
haut monde : n,아바나(Cuba의 수도),아바나산 엽궐련
Havana : n,아바나(쿠바의 수도),아바나 여송연
have : vt,가지다,소유하다,취하다,얻다,받다,마음속에 먹다,품다,먹다,마시다
have : n,유산자,(부,자원,핵무기를)가진 나라
havelock : n,(군모 뒤에 늘어 뜨린)차양
haven : n,항구,피난처
haven't : v,have not의단축
havenot : n,무산자,(자원,핵병기 등)가진 것 없는(가난한)나라
havenot : n,무산자,(부,자원,핵무기를)갖지 못한 나라
haver : v,vi,객담(을 늘어놓다),쓸데없는 소리(를 지껄이다)
haver : n,(집합적)야생의 귀리
haversack : n,잡낭
haversian canal : x,골내관,하버스관
haversian system : x,하버스계(하버스관과 이를 둘러 싼 골조직 내의 구성 단위)
haves and havenots : x,핵 보유국과 비보유국,(일반적으로)가진 자(나라)와 갖지 못한 자(나라)
havildar : n,(인도군)하사관
having : n,소유,소유물품,재산
havoc : n,파괴,황폐 make ~ of ...을 망쳐놓다(파괴 시키다)
Havre : n,=Le Havre
havurah : n,하브라(교회 밖의 유대교 신도 단체)
haw : n,산사나무
haw : in,에에,저어(하다)(더듬을 때),저라(하다),(말,소를 왼쪽으로 돌릴때)
Hawaii : n,하와이
Hawaiian : a,n,하와이의,하와이 사람(말)의,하와이 사람,하와이 말
Hawaiian guitar : x,하와이안 기타
Hawaiian Islands : x,하와이 제도
Hawaiian shirt : x,화려한 색깔의 반소매 셔츠
Hawaii time : x,=Hawaiian Standard Time하와이 표준시(GME보다 10시간 늦고 시간대는 Alaska Time와 같음
hawfinch : n,콩새
hawhaw : int,n,HAHA
hawk : n,매,탐욕한사람,매파,강경론자(국제 관계에 대하여)
hawk : vi,vt,매를 부르다,매사냥을 하다
hawk : n,vt,vt,기침(하다)
hawk : vt,vt,돌아다니며(외치며)팔다,(뉴스를)알리며 다니다
hawker : n,행상인
hawkeye : n,,Iowa주 사람
hawkeyed : a,눈이 날카로운
Hawkeyed State : n,Iowa주의 딴 이름
hawking : n,매사냥(falconry)
hawkish : a,매파적인
hawkism : n,매파적 경향(태도)
hawk moth : n,박각시나방 종류
hawkmoth : n,박각시나방과의 나방
hawknosed : a,매부리코의
hawksbill : n,대모
hawkshaw : n,형사,탐정
hawkweed : n,조밥나물
hawse : n,(이물의) 닻줄 구멍이 있는 부근
hawsehole : n,닻줄 구멍
hawser : n,굵은 밧줄,배 끄는(매는) 밧줄
hawserlaid : a,(굵은 밧줄이)세가닥으로 꼬인
hawthorn : n,산사나무속,특히 서양 산사나무
Hawthorne : n,Nathaniel (1804~1864)미국의 소설가
hay : n,vi,vt,건초,마초 Make ~ while the wun shines 좋은 기회를 놓지치 말라 ,건초를 만들다(주다)
haybox : n,건초 보온 상자(요리를 뜸들이기 위해넣어두는)
haycock : n,건초 더미(가리)
Haydn : n,하이든(오스트리아의 작곡가)
hay fever : n,건초열(꽃가루에 의한 코,목 따위의 알레르기성 질환)
hayfield : n,건초(용 풀)밭
Hayfield limit : x,헤이플릭 한계(배양기 속에서 세포가 생존하는 한계)
hayfork : n,건초용 쇠스랑
hay knife : x,건초 베는 칼
haylage : n,생목초(습기를 35-50%로 하여 저장된)
haylift : n,건초 공수(폭설로 고립된 소,말 등에게 비행기로 하는 식량 투하)
hayloft : n,(헛간 윗 부분의)건초간
haymaker : n,건초 만드는 사람,건초기
haymaking : n,건초 만들기
Haymarket : n,헤이마켓(런던의 West End의 번화가)
haymow : n,(곳간에 쌓인)건초 더미,(곳간의)건초 두는 곳(시렁)
hayrack : n,건초 얹는 선반(시렁),(건초 운반차의)짐받이 틀,=hayrig
hayrick : n,=HAYSTACK
hayseed : n,건초에서 떨어진 풀 씨,촌뜨기,농사꾼
hayshaker : n,시골뜨기(hayseed)
haystack : n,(커다란)건초더미
hayward : n,a,건초를 묶는 철사,뒤섞인,얽힌,미친,흥분한
haywire : n,건초 다발을 동여매는 철사,뒤엉킨,난장판의,혼란된,미친
hazard : n,위험,모험,우연(한 일),운,주사위 놀이의 일종,at all ~s 만난을 무릅쓰고 무슨 일이 있어도 꼭,at ~ 운에 맡기고 아무렇게나
hazard : vt,위태롭게 하다,걸다,(운을 하늘에 맡기고)해보다
hazard label : x,위험 표지 라벨
hazardous : a,ad,위험한,모험적인,운에 맡기는
hazard warning device : x,(차의)고장 경고 장치(방향 지시등을 모두 점멸시켜 고장임을 알리는 장치)
Hazchem : n,화학 약품 등의 위험물 표시법
haze : n,아지랑이,이내,안개,(정신의)몽롱(상태)
haze : vi,(선원을)혹사하다,(신입생을)못살게 굴다,곯리다
hazel : n,개암(나무),담갈색(의)
hazelnut : n,개암
hazily : ad,흐릿하게(아지랑이가 끼어),몽롱하게,어렴풋이
hazing : n,(신참자를)곯리기,못살게 굴기
Hazlitt : n,해즐릿(영국의 비평가,수필가)
hazy : a,이내(haze)낀,안개 짙은,흐릿한,몽롱한
HB : x,hardback
Hb : x,hemoglobin
H beam : x,H형 빔
HBM : x,His Britannic Majesty
Hbomb : n,수소폭탄
HC : x,hard copy
hcf : x,최대공약수,highest common factor
HCL : x,high cost of living,물가고,생활난
HCM : x,His Catholic Majesty
hcp : x,handicap
HDTV : n,고화질 TV
he : pron,그(는,가)
he'd : v,he had의단축
he'd : x,he had(would)의 단축형
he/she : pron,그 또는 그녀,그사람
head : n,머리,대가리,두뇌,지력,우두머리,장,주인,장관,교장,한 사람,한 마리,정상
head : vt,...을 거느리다,...의 선두에 서다,방해하다,...에 머리를 붙이다(향하다)
head : vi,향하다,진행하다,발생하다,(양배추가)결구하다,(여드름이) 툭툭 비어지다 ~ BACK ...의 앞으로 돌다,가로막다
headache : n,두통,두통(골칫)거리
headache band : x,(여자의 장식용)헤어밴드
headachy : a,골치 아픈,두통이 나는,(술 등이)두통을 일으키는
headband : n,머리띠
headbanger : n,정신 이상자,충동적으로 폭력을 휘두르는 사람,록음악의 열광적인 팬
headboard : n,(침대 등의)머리쪽 판자,울의 머리쪽 판자9소 등을 고삐로 매는)
headboom : n,=JIBBOOM
head boy : x,수석 학생(top boy)
headbuster : n,폭력으로 밍돈을 받아내거나 제재를 가하는 깡패
head butt : n,(레슬링)박치기
headcheese : n,돼지 머리나 족을 잘게 썰어 삶은 치즈 모양의 식품,돼지족편
headcloth : n,두건,터번
head cold : n,코감기
head count : n,여론(국세)조사
head counter : x,여론 조사원,인구 조사원
head dip : x,(파도타기에서)앞으로 구부린 자세로 파도 속으로 돌입하기
headdles : n,잉아(베틀의)
head doctor : n,정신과 의사
headdress : n,머리장식anf,머리(헤어) 스타일
headed : a,(복합어를 이루어)머리가-인,-머리의
head end : x,(유선 텔레비젼의)전파 중계소
header : n,머리(끝)잘라내는 사람(기계),이삭베는 기계,(수영의)거꾸로 뛰어들기,다이빙
header label : x,헤더(표제)라벨
headfalsie : n,가발
head fast : x,이물의 밧줄(배를 매는)
headfirst : ad,거꾸로,곤두박이로,황급히
head gate : x,수문,취수문
headgear : n,모자,머리장식
headhunt : n,간부 스카우트(를 하다)
headhunter : n,사람 사냥하는 야만인,인재(간부) 스카우트 담당자
headhunting : n,(야만인의)사람 사냥,인재 스카우트
headily : ad,고집세게,무모하게,현기증나도록,어질어질할 만큼
headinair : a,멍한,꿈결 같은,젠체하는,신사연하는(snobish)
headin bay : x,(주차장의)전진 진입식 주차 구획
headiness : n,고집셈,무모함,(술이)오름
heading : n,제목,표제,연재,수평갱,헤딩,(초목의)순치기,비행(향해)방향
head lamp : x,=headlight
headland : n,곶,갑
headless : a,머리 없는,지도자 없는,어리석은
headlight : n,헤드라이트
headline : n,vt,(신문의)표제(를 붙이다),(뉴스의) 주요한 제목
headliner : n,주연자,스타
head linesman : x,선심
headload : n,머리에 이는 짐
headlock : n,(레스링)헤드록(머리조이기)
headlong : ad,a,거꾸로(의),곧바로,성급한,무모하게(한)
headman : n,수령
headmaster : n,교장
headmistress : n,여교장
head money : x,인두세,(포로,범인의 체포한 수에 따른)상금
headmost : a,맨앞의
head note : x,=head tone
headnote : n,두주,두서(판례집에서 판결 전에 기재되는 판결의 요점)
head office : n,본사,본점
headon : a,정면의
headphone : n,머리에 거는 수화기
headpiece : n,투구,머리 쓰개,모자,두뇌,지능
headpin : n,(볼링)선두(1번)핀
headquarter : 본
headquarters : n,본부,사령부
headrace : n,(물방아의)도수기,도수로
headreach : vi,n,(범선이)바람 부는 쪽으로 머리를 돌려 나아가다(가는 거리)
head register : x,두성 성역
head resistance : x,전면 저항
headrest : n,머리 받침(치과 의자,자동차 좌석 등의)
head restaint : x,(충돌시 목뼈 보호를 위한)좌석 베개,머리 받침,헤드레스트(headrest)
headroom : n,(문 입구,터널등의)머리 위의 공간(머리와 천장 사이의 공간)
headsail : n,전면돛(이물의 세로돛)
head scarf : x,머리 스카프
head sea : x,역랑,마주치는 물결
headset : n,=HEADPHONE
headshake : n,우두머리임,우두머리의 지위(권위),지도적인 지위(leadership)
headship : n,수령(지도자)의 지위(권위)
head shop : x,마약 복용에 관계 있는 물건을 파는 가게
head shot : x,얼굴 사진
headshrinker : n,정신병 의사(학자)(psychiatrist)
headsman : n,목베는 사람,망나니
headspring : n,원천,수원,근거
head square : x,=head scarf
headstall : n,굴레 장식 띠(마구)
headstand : n,물구나무서기
head start : x,시발점에서 주어진(얻은) 우위(경주 등의),유리한 스타드,선수
headstock : n,주축대
headstone : n,(무덤의)주석,묘석,초석,(토대의)귀돌
headstream : n,원류
headstrong : a,완고한
headsup : a,날쌘,민첩한,빈틈없는
head table : x,연설자(의장(등))의 테이블
head tax : x,POLL TAX
headteacher : n,교장
headtohead : n,a,접근전,접9근)전의
head tone : x,두성조(높은 성역의 음조)
headtrip : n,마음에 영향을 주는 체험,정신을 자극하는 일,자유로운 연상
headup : a,(비행기,자동차 등의 계기를)전면을 향한 채 읽을 수 있는
head voice : x,두성 (가장 높은 음역)
headwaiter : n,급사장
headward : ad,a,수원(보다 안)으로(의)
headwards : ad,=headward
headwaters : n,원류,상류
headway : n,전진,진척,배의 속도,(아치,터널 따위의)천정 높이
headwind : n,맞바람
headword : n,머리 쓰는 일,정신 노동
headwork : n,정신 노동,사색
heady : a,무모한,성급한,머리에 오르는(술) ,분별 있는,기민한
heal : vt,(병,상처를)낫게하다,고치다
heal : vi,낫다,회복되다,~ over (up) (상처가) 아물다
healall : n,만병 통치약
healee : n,치료를 받는 사람
healer : n,치료하는 사람,약
healing : a,치료의,치유(법)
heally : ad,낫도록
health : n,건강,(정신의)건전,건강 상태,건강을 축복하는 축배
health aid : x,가정 보건사(정식으로는 homehealth aid)
health camp : x,보건 캠프(허약아를 위한 옥외 훈련 시설)
health center : n,보건소
health certificate : x,건강 증명서
health club : n,헬스 클럽
healthconscious : a,(자기의)건강을 의식하는(조심하는)
health food : n,건겅 식품
healthful : a,건강에 좋은,위생적인,유익한,건강한,건전한
healthgiving : a,건강증진의
healthily : ad,건강하여,건강에 좋게
healthiness : n,건강,건전
health insurance : n,건강 보험
health management : x,건강 관리(종업원등의)
health office : x,보건소,위생과
health officer : x,위생관,검역관
health physics : n,보건 물리학
health resort : x,보양지
health salts : x,건강염(광천수에 타서 완하제로 씀)
health service : n,건강 보험
health spa : x,체중 감량 도장(fat farm)
health visitor : n,(노인,환자를 정기적으로 회진하는)보건관(부)
healthwise : ad,건강(유지)를 위해
healthy : a,건강한,건전한,건강에 좋은
HEAO : n,high-energy astronomy observatory,고에너지 천문대(x선 관측 장치를 탑재한 인공 위성)
heap : n,더미,쌩a 올린 것,많이,퍽,at of a ~ 깜짝 놀라,느닷없이,all of a ~ 압도되다,기가 푹 꺽이다
heap : vt,쌓다,쌓아 올리다
hear : vt,듣다,...이 들리다,...을 듣다,들어 알다,방청하다,청취하다,들어주다,재판(심문)하다
hear : vi,들리다,소문으로 듣다,...에 관해 들어 알고 있다,승낙하다
hearcan : n,(미)제트기
heard : v,hear의과거(분사)
hearer : n,듣는 사람,청취자,방청자
hearing : n,청위,청력,가청거리
hearing aid : n,보청기
hearingimpaired : a,청각 장애를 가진
hearint : vi,청취,청력,가청거리,심문,공청회,들어줌
hearken : vi,귀를 기울이다
hearsay : n,소문
hearsay evidence : x,전문 증거
hearsay evidence : x,전문 증거
hearse : n,영구차,관가,무덤,대형 촉대
hearsecloth : n,관포,관의(pall)
Hearst : n,허스트(미국의 신문,잡지 발행자)
heart : n,심장,가슴(속),마음,마음속,본심,애정,용기,기력,원기,중심,중앙,핵심
heart's blood : x,심장내의 혈액,심혈,생명;진심;생명력;소중한 것
heartache : n,마음 아픔,비탄
heart attack : x,=HEART FAILURE
heartbeat : n,고독,정서
heartbreak : n,애끊는 마음
heartbreaker : n,애끓게 하는 것(사람),무정한 미인,여성의 애교머리(lovelock)
heartbreaking : a,애끓느 마음을 자아내는,(지루하여)싫증나는(tedious)
heartbroken : a,비탄에 젖은
heartburn : n,가슴앓이
heartburning : n,질투,울화,불만,불평,시기,앙심
heart cherry : x,앵두의 일종(심장 모양의)
heart disease : n,심장병
heart disease : x,심장병
hearted : a,(보통 복합어를 이루어)~한마음씨의,마음이~한
hearten : vt,용기를 북돋우다,격려하다
heart failure : 심장마비,심장발작
heartfelt : a,마음으로 부터의
heartfree : a,사랑을 앓는,미련이 없는
heartful : a,진심에서 우러난
hearth : n,노,노변,화상,가정
hearthrug : n,벽난로 전면의 깔개
hearthside : n,노변,가정
hearthstone : n,(벽난로 바닥의)재받이 돌,노변,가정
heartily : a,마음으로부터,정중히,열의를 갖고,매우,배불리
hearting : n,심벽,심벽재료
heartland : n,심장지대(경제적,군사적으로 자급 자족하며 공격에 대해 안전한 중핵 지구)
heartless : a,무정한
heartlung machine : n,인공심폐(심장수술시 심장기능을 대행시키는)
heart murmur : x,심장 잡음
heartrending : a,가슴이 터질 듯한,비통한
heartrot : n,심부병(고갱이가 썩는 병)
heartsearching : n,사상(욕망 동기)의 내성,자성,자기비판-자신의 마음속을 살펴보는,내성(자성)하는
heartsease,heart'sease : n,마음의 평화,안심,삼색제비꽃
heartshaped : a,심장(하트)형의
heartsick : a,심뇌하는,비탄에 젖은,불행한
heartsore : a,근심(시름)에 잠긴
heartstirring : a,고무하는,기운나게하는
heartstricken : a,비탄에 잠긴
heartstrings : n,심금,깊은 감정
heartstruck : a,=heartstricken
heartthrob : n,(심장의)고동,정열,감상,애인
hearttoheart : a,숨김없는,솔직한
hearttoheart : a,솔직한,숨김없는,진심어린
heart transplant : x,심장이식
heart transplat : n,심장이식
heartwarming : a,마음을 따뜻하게 하는,흐뭇하게 하는,기분좋은
heartwhole : a,(아직)연정을 모르는,진심으로의
heartwood : n,심재,적목질
hearty : a,n,마음으로부터의,친절한,열심인,튼튼(건강)한,배부른,풍부한,충분한,원기왕성한 사람,친구
heat : n,열,더위,달아오름,상기,열심,가열,한창 ...하는 중,클라이맥스,격력,격노,흥분,,노력,단숨,단번,(짐승의)발정(기)
heat : vi,vt,뜨겁게 하다,뜨거워지다,따뜻이 하다,따뜻해지다,격하게 하다,격해지다
heat apoplexy : x,=SUNSTROKE
heat artist : x,연료용 알코올을 마시는 사람
heat balance : x,열평형
heat barrier : n,(항공기의)속도 한계점(공기와 마찰열 한도)
heat capacity : x,열용량
heat consumption : x,열 소비량
heat cramps : x,열 경련(고온하의 중노동으로 인한)
heated : a,뜨거워진,격한,흥분한;성난
heat engine : x,열기관
heater : n,가열기;난방 장치,굽는 사람(기계),권총
heat exchange : x,열교환
heat exchanger : x, 열교환기
heat exhaustion : n,열사병
heat flash : x,(핵 폭발 때의)강력한 열 방사
heatful : a,열이 많은,열을 내는
heath : n,히스(황야에 저절로 나느 소관목),히스가 무성한 돌
heath bell : x,히스 꽃
heathberry : n,시로미,들쭉나무
heath cock : x,=blackcock
heathen : n,이교도(기독교,유대교,회교도 이외),불신자,미개인
heathen : a,이교(도)의,미개한
heathenish : a,이교도의;비기독교적인,야만스런
heathenism : n,이교,이단,우상숭배,야만,만풍
heathenry : n,이교,이단(집단적)이교세계,이교도
heathenze : vt,이교도로 만들다(되다)
heather : n,히스속의 식물
heather ale : x,헤더에일(옛날 히스 꽃을 향료로 쓴 스코틀랜드의 양조 맥주)
heather mixture : x,영 혼색 모직물 
heather tweed : x,혼색 트위드
heathery : a,히스가 무성한
heath hen : x,검은 멧닭의 암컷,히스헨(지금은 멸종한 북미산 멧닭의 일종
heath rovinson : x,(기계 등이)너무 정교하여 비실용적인
heathrow : x,히스로 공항(통칭london airport;런던 국제 공항)
heathy : a,가열하는,덥게하는,가열(난방)용의
heating cabinet : n,온장고
heating element : x,발열체,전열선(전열기의 코일 등)
heating pad : n,전기 담요
heating pad : x,전기 패드(깔개,방석(등))
heat island : x,열섬(주변보다 온도가 높은 도시(공업 지대)
heat lamp : x,적외선등,태양등
heat lightning : n,(천둥이 없는)먼 곳의 번개
heat pollution : n,열공해
heatproof : a,내열의
heat prostration : x,=heat exhaustion
heat pump : n,열이동 펌프
heat rash : x,=prickly heat
heat rays : n,열선,적외선
heatreasing : a,마음을 가라앉게 하는,마음 놓이게 하는
heat seeker : x,열(적외선)추적 미사일(의 적외선 탐지 장치)
heatseeking missile : x,열 (적외선)추적 미사일
heat shield : x,(우주선)의 열차폐
heat sink : n,불 요열 제거 장치(열을 흡수하고 산일 시킴)
heatstroke : n,일사병
heattreat : vt,열처리하다
heat treatment : x,열처리
heat unit : x,열단의;칼로리(calorie)
heat wave : n,열파
heave : vt,(무거운 것을)들어 올리다,(닻 따위를)들어서 던져 넣다,(가슴을)펴다,부풀리다,(바람이 파도를)높이다,(한숨을)쉬다
heave : vi,오르다,들리다,높아지다,부풀다,기복하다,굽이치다,허덕이다,토하다,끌다,감다,(배가)움직이다,나아가다 ~ in sight (배가)보이기 시작하다,~ to(배를 멈추다,정선하다)
heave : n,(들어) 올림,융기,(파도의)기복,굽이침,수평 전위,(말의)천식
heaveho : int,n,vi,vt,영차(닻줄을 감을 때의 소리,퇴자놓기,퇴자놓다
heaven : n,천국,하느님,상공,하늘
heavenborn : a,하늘에서 태어난,하늘에서 내려온,천부의
heavendust : n, (가루로된)마약,코카인
heavenliness : n,거룩함,근사함
heavenly : a,하늘의,천국 같은,거룩한,천부의,타고난,근사한,훌륭한
heavenly body : n,천체
Heavenly City : n,거룩한 성
heavenlyminded : a,믿음이 깊은,경건한
heavensent : a,천래의,하늘이 주신,절호의
heavenward : ad,a,천국(하늘)을 향해서(의)
heavenwards : a,ad,하늘(천국)을 향하는(향하여)
heaver : n,올리는 사람;하역인부
heavierthanair : a,(항공기가) 공기보다 무거운
heavily : ad,무겁게 육중하게,힘에겨운듯이,느릿느릿
heaviness : n,무거움,무게,나른함 무기력,맥없음
heaving : n,올림,들어올림,끌어올림
heaving line : x,가는 밧줄(큰 밧줄에 던지기전에 먼저 던지는)
Heaviside layer : n,헤비사이드층(단파 통신을 가능케 하는 지상 약100킬로미터 높이의 대기층)
heavy : a,무거운,묵직한,대량의,다액의,격렬한,도가 강한,심한,고된,모진,질척거리 time hangs ~ 시간이 남아 주체 못하다
heavy : n,무거운 사람(물건),악인역
heavy armed : a,(군대 등)중장비의
heavyarmed : a,중장비의
heavy artillery : n,중포(병)
heavy bomber : n,중폭격기
heavybrowed : a,찌프린 얼굴을한
heavybuying : a,대량 구입하는
heavy chain : x,(면역 글로불린의)중연쇄
heavy chemical : x,공업 약품
heavy crop : n,풍작
heavy date : x,(애인.약혼자와의)중요한 데이트(상대)
heavyduty : a,격무에 견디어 내는,아주 튼튼한,관세가 고율인
heavy earth : x,중토
heavy element : x,중원소
heavy foot : x,가속 페달을 세게 밟는 사람,질수하는 사람
heavyfooted : a, 발걸음이 무거운,둔중한;임신한,ㅈ(자동차를)맹렬한 속도로 모는,질주하는
heavyfooted : a,동작이 둔하고 느린,임신한
heavy gun : n,중포
heavyhanded : a,서투른,압제적인
heavyheaded : a,머리가 무거운(둔한)
heavyhearted : a,우울한,슬픈
heavyhitter : x,유력자,중진,거물
heavy hydrogen : n,중수소
heavy industries : n,중공업
heavyladen : a,무거운 짐을 진(실은),압박된,짓눌린
heavy metal : n,중금속,훌륭(유력)한 사람,강적
heavy oil : n,중유
heavy oxygen : n,중산소
heavy part : n,악인역
heavy petting : x,(성교는 하지 않는)농후한 애무
heavy rock : x,=progressive rock
heavy sea : n,격랑
heavyset : a,몸집이 큰,튼튼한,땅딸막한
heavy sky : n,흐린 하늘
heavy spar : x,중정석(barite)
heavysticker : n,강타자
heavy swell : x,바다의 심한 놀,풍채(태도)가 당당한 명사
heavy traffic : x,대형자동차,자동차의 홍수
heavy water : n,중수
heavyweight : n,보통보다 체중이 무거운 사람,헤비급 선수,유력자,중진
heavy wet : x,맥아 양조주
Heb. : n,Hebrew
Hebdomad : n,일곱으로 된 것,일곱 사람,7일간,1주일
Hebdomadal : a,=WEEKLY
Hebdomadal Council : x,(Oxford대학의 매주 1회의)평의원 주례회
Hebe : n,청춘의 여신(제신에게 술을 따르는 여신)
hebetate : vt,vi,둔하게 하다(되다)
hebetation : n,둔화
hebetic : a,(Gk 젊은의 뜻에서,사춘기의,사춘기에 일어나는
hebetude : n,우둔,멍청함
Hebraic : a,히브리 사람(말)의
Hebraism : n,히브리어풍,히브리주의(사상,기질)
Hebraist : n,히부리어 학자
Hebraistic : a,헤브루식의,헤브루 학자의
Hebraize : vt,vi,헤브루말로 번역하다,헤브루 사람식으로 하다,헤브루어풍의 표현을 하다,헤브루 사람식으로 되다(생각하다)
Hebrew : n,히브리(유대) 사람(의),(고대의)히브리말(구약 성서는 이것으로 기록되었음),(현대의)이스라엘 말
Hebrew calendar : x,=Jewish calendar
Hebrewwise : ad,헤브루식으로,(쓰는 법이)오른편에서 왼편으로
Hebridean : a,헤브루식의,=hebridian
Hebrides : n,스코틀랜드 북서부의 열도
Hecate : n,달,대지,하계를 주관하는 여신,마녀
hecatomb : n,큰희생(소 백마리의 제물),대학살
heck : n,(베틀의)바디집,방적기의 실타래에 방적사를 거는 장치
heck : n,int,지옥(hell의 완곡한 말),염병할,빌어 먹을
heckle : vt,괴롭히다,질문 공세를 취하다
hectare : n,헥타르(=100아르=1만 평방미터)
hectic : a,소모열의,(열이)소모성인,(병적으로)얼굴이 불그레한,몹시 흥분한,열광적인
hectic : n,결핵환자,소모열(홍조)
hectically : ad,소모열로
hecto : n,백의 뜻의 결합사
hectog : n,=hectogram
hectogram : n,=100g
hectograph : n,젤라틴판
hectoliter : n,=100 liter
hectometer : n,헤토미터(100m)
hectopascal : n,헥토파스칼(100pascal-1밀리바에 해당)
hector : n,=100M(미터)
hector : vt,n,허세를 부리다(부리는 사람),약한 자를 괴롭히다
Hecuba : n,헤쿠바(Troy왕 Priam의 아내)
Hedda : n,여자 이름
hedge : n,(산)울타리,장벽,양다리 걸치기,기회보기 be on the ~ 두길마 보다,dead ~ 마른 나무 울타리,바자울
hedge : v,(산)울타리로 두르다,...에 장벽을 만들다,막다,방해하다
hedge : vi,(산)울타리를 만들다,(내기에서)양쪽에 걸다,확언을 피하다 ~ in 둘러싸다,속박하다,~ off 가로막다,방해하다
hedge bill : x,긴자루 낫(산울타리의 손질용)
hedge fund : x,투자 신탁의 일종
hedgehog : n,고슴도치,호저,빙퉁그러진 사람,견고한 요새
hedgehop : vt,초저공 비행을 하다
hedge parsley : x,진득개미나리,사상자
hedgepriest : n,무식한 성직자
hedger : n,산울타리를 만드는(손질하는)사람,울타리 일꾼,양쪽에 거는 사람
hedgerow : n,(산울타리의)관목의 줄
hedge school : x,야외(노천)학교
hedge sparrow : n,바위종다리의 일종
hedge sparrow : x,바위종다리 무리
hedging : n,연계 매매
hedgy : a,산울타리 같이 생긴,산울타리(울타리)가 많은
hedonic : a,쾌락의,향락적인,쾌락설의
hedonics : n,(단수 취급)쾌락설,쾌락론
hedonism : n,쾌락주의,향락주의
hedonist : n,쾌락주의자
hedonistic : a,쾌락주의(자)의
hedonistically : ad,쾌락주의(장)로
hedral : x,(연결형)~(개)의 변(면)으로 된의 뜻
hedron : x,(연결형)~면체의 뜻
heebiejeebies : n,안절부절 못함,극도의 신경 과민,심한 혐오감
heed : n,조심,주의,~ to ...에 주의하다,take ~ to ...에 조심하다
heed : vi,vt,조심(주의)하다
heedful : a,주의 깊은,조심하는
heedless : a,부주의한,경솔한
heehaw : n,나귀의 울음 소리,바보 웃음
heel : n,뒤꿈치,(말 따위의)뒷발,(뒷)굽,비열한놈 at a person's ~s 아무의 바로 뒤에 바싹 따라
heel : vt,(신발에)뒤축을 대다,...의 바로 뒤를 따르다
heel : vi,(개가)바로 뒤따르다,뒤꿈치로 춤추다
heel : n,vi,vt,(배의) 경사,기울어지다,기울이다
heelandtoe : a,경보식으로 걷는
heelandtoe : vi,(자동차 경주 등에서)힐 앤드 토로 운전하다(브레이크를 발끝으로 밟고 같은 발뒤꿈치로 가속 페달을 동시에 조작하다)
heelball : n,뒤꿈치의 아래 부분,검은 구두약의 일종
heel bar : x,(백화점의)구두 수선 코너
heeled : a,부자인,유복한,권총을 갖고 있는,be well ~ 담뿍 갖고 있다
heeler : n,굽갈이하는 사람,동물을 추적하는 개,추종자,(정당 보스의)부하
heeless : a,뒷굽이 없는
heeling : n,(배의 전면으로의)경사
heelpiece : n,(신발의)굽 가죽,굽 창,말단에 붙어 있는 것,마지막 한 조각
heelplate : n,구두 뒤축쇠
heelpost : n,경첩이 달린 기둥,마구간의 칸막이 문,말을 매어두는 기둥
heeltap : n,구두의 뒤축 가죽,잔에 남은 술
heft : n,무게 ,중량,영향,대부분
heft : vt,들(어서 무게를 달)다
heftily : ad,억세게,강하게
heftiness : n,억셈,강함
hefty : a,n,무거운(heavy),억센(powerful),강한,상당한,많은,무거운 사람,억센 사람
Hegel : n,Friedirich(1770~1831) 독일의 철학자
Hegelian : a,n,헤겔 철학의(신봉자)
Hegelian dialectic : x,헤겔 변증법
Hegelism : n,헤겔 철학
hegemonic : a,지배하는,패권을 장악한
hegemonism : n,패권주의
hegemony : n,패권,지배권
Hegira : n,Mohammed의 도주(622),회교 기원,도피(flight)
hegoat : n,숫염소
heh : int,쳇!,허허!,엣!(경멸,가소로움,놀람,반문 등의 소리
HEH : x,His Exalted Highness
hehe : int,=he,히히
HEIB : x,home economist in business(기업 내의 가정과 출신의 전문진,대개는 소비자 문제 담당의 여성)
Heidelberg : n,독일 서남부의 도시,Heidelberg 대학 소재지
Heidelberg man : x,하이델베르크인(하이델베르크 근교에서 하악골이 1907년에 발견됨)
heifer : n,(아직 새끼를 낳지 않은 3살 미만의)암소
Heifetz : n,Jascha(1901~)러시아 태생의 미국 바이올리니스트
heigh : int,여보,어어,야아(주의,격려,기쁨 따위의 외침)
heighho : int,음,아아(기쁨,지루함,낙담 따위의 외침)
height : n,높이,고도,고지,둔덕,절정,극치,한창,하늘 at its ~ ...의 절정에,...이 한창이어서,in the ~ 한에
heighten : vt,vi,높게 하다,높이다,고상하게 하다,증가시키다,강화하다,과장하다,높아지다,증가하다,강화되다
heightism : n,키 작은 사람에 대한 멸시(차별)
heil : int,만세!,안녕!(인사말),~에게 Heil!하고 인사하다
Heilungkiang : n,헤이룽강,헤이룽장성,=Heilong Jiang
heimish : a,아늑한,마음편한,무간한,가정적인
Heine : x,Heinrich(1797~1856) 독일의 시인
heinous : a,가증한,극악무도한
heir : n,상속인,사자,(특질,전통 등의)계승자,후계자
heir apparency : n,그 지위(권리)
heir apparent : x,법정 추정 상속인
heiratlaw : n,법정 상속인
heirdom : n,=heirship
heiress : n,여자 상속인
heirless : a,상속인이 없는
heirloom : n,조상 전래의 가보,법정 상속 동산
heir male : x,남계 상속인
heir presumprive : x,추정 상속인
heir presumptive : x,추정 상속인
heirship : n,상속인임,상속(권)
heist : n,vt,강도,노상 강도,도욱,도둑질한 물건,장물,강도질하다,훔치다
heister : n,강도,노상 강도
Hejira : n,=hegira
Hekate : n,=Hecate
Hel : n,헬(죽음의 나라의 여신),저승,사후의 세계,=Hela
Hel's Angels : n,오토바이 폭주족
HeLa cell : x, 힐러 세포(연구용으로 배양되고 있는 암세포의 일종)
held : v,hold의 과거분사
heldentenor : n,헬덴테노르(화려함과 양감을 지닌 오페라,특히 바그너 가극의 영웅에 어울리는 테너(가수))
Helen : n,여자 이름,Sparta의 왕 Menelaus의 미비(Paris의 유괴로 트로이 전쟁이 일어 났음)
Helena : n,여자 이름
heli : x,(연결형)태양의 뜻,=helio
heliacal : a,태양의(solar),태양에 가까운,태양가 같은 때에 뜨는(지는)
heliacal cycle : x,태양 순환기
heliambulance : n,구급 헬리콥터
helianthus : n,해바라기속 식물
heliborne : a,헬리콥터로 운반되는
helibus : n,=helicab
helic : x,(연결형)나선의 뜻,=helico
helicab : n,헬리캡,헬리콥터 택시
helical : a,나선모양의
helices : n,helix의 복수
helicity : n,헬리시티(소립자의 운동 방향의 스핀 성분의 값)
helicline : n,(완만한 경사의)나선상 도로
helico : x,(연결형)=helic
helicoid : a,나선모양의
helicoid : n,나선체,나선체면,헬리코이드식(카메라의 경동 따위)
helicon : n,헬리콘산(Muses가 살던곳),시상의 원천,저음 튜바(취주악기의 일종)
Heliconian : a,헬리콘산의
helicopter : n,vt,vi,헬리콥터,헬리콥터로 나르다
helicopter gunship : x,중무장 헬리콥터(지상공격용)
helidrome : n,헬리콥터용 공항
helihome : n,헬리홈(헬리콥터와 모터홈을 결합시킨 것
helihop : vi,(단거리를)헬리콥터로 가다(날다)
helilift : vt,n,(긴급시에)헬리콥터로 수송하다,헬리콥터 수송
helily : ad,나선형으로
helio : n,태양의 뜻의 결합사
heliocentric : a,태양중심의,~ theory 태양 중심설
heliocentricism : n,태양 중심설
heliochrome : n,천연색 사진,상표명
heliochromic : a,천연색 사진의
heliochromy : n,천연색 사진술
heliogram : n,일광 반사 신호
heliograph : n,vt,사진제판,회광 신호기,신호기로 통신하다
heliographic : a,회광 통신기(신호법)의,태양의(solar)
heliography : n,태양 촬영(술),사진 제판법,회광 신호법
heliogravure : n,그라비어 인쇄,사진 요판(술)
heliolatry : n,태양 숭배
heliolithic : a,(문명이)태양 숭배와 거석을 특징으로 하는
heliology : n,태양학,태양 연구
heliometer : n,태양의
heliometry : n,태양의에 의한 측정
Helios : n,헬리오스(태양신,종종 Apollo와 혼동됨)
helioscope : n,태양 관측 망원경
heliosis : n,일사병
heliosphere : n,태양권
heliostat : n,일광 반사 장치
helio trope : n,헬리오트로프,쥐오줌풀,엷은 자줏빛,혈석
heliotrope : n,헬리오트로프,엷은 자주빛,헬리오트로프의 향기,그 향수,회광기,일광 반사기(신호장치),혈석(석영의 일종)
heliotropic : a,해굽성의,굴일성의
heliotropism : n,해굽성
heliotype : n,vt,헬리오타이프 판(사진 제판의 일종),~을 헬리오타이프 판으로 하다
heliox : n,(잠수용의) 헬륨과 산소의 혼합 기체
helipad : n,헬리콥터 발착장
heliport : n,헬리포트,헬리콥터 발착소
helispot : n,(임시)헬리콥터 착륙장
helistop : n,헬리콥터 착륙장(지점)
helium : n,헬륨(희가스 원소의 하나)
helium shakes : x,고압성 신경 장애(증후군)
helix : n,나선,소용돌이,소용돌이 장식,귓바퀴
hell : n,지옥,지옥과 같은 장소(상태),마굴,a ~ of a ...대단한,be ~ on ...해롭다
hell : n,he will(shall)의 단축
hell's angel : x,오토바이 폭주족
hell's bells : x,이게 어찌된 일인가(화가 나거나 초조할 때의 말)
hellas : n,그리스의 옛이름
hellbender : n,미국 도롱뇽(미국 동부산)
hellbent : a,필사의,꼭 하고야 말 기세의
hell bomb : n,수소 폭탄
hell bomb : x,수소 폭탄
hellbox : n,못 쓰는 활자를 넣는 상자
hellbroth : n,마술용 마약
hellcat : n,못된 계집,마녀
helldiver : n,농병아리
hellebore : n,크리스마스 로즈,박새
hellene : n,그리스 사람
hellenic : a,그리스(사람,말)의
hellenism : n,그리스어 풍,그리스주의(문화,국민성)
Hellenist : n,그리스어 학자
Hellenistic : a,Hellenism(Hellenist)에 관한
Hellenization : n,그리스화
Hellenize : vt,vi,,그리스화하다,그리스 말을 사용하다
heller : n,난폭자
Hellespont : n,헬레스폰트(Dardanelles 해협의 옛 그리스 이름)
hellfire : n,지옥의 불,지옥의 형벌
hellforleather : a,ad,맹렬한 속력의(으로)
hellgrammite : n,뱀잠자리의 애벌레
hellhole : n,지옥,지옥 같은 곳,불쾌한(불결한,악명 높은)장소
hellhound : n,지옥의 개,악귀
hellion : n,난폭자,무법자
hellish : a,지옥같은,가증한,소름끼치는
hellkite : n,잔인무도한 자,냉혈한
hello : int,n,어이,여보,어머,(전화로)여보세요
hello girl : x,전화 교환양
hellraiser : n,(상습적으로)소란을 피우는 사람
hells kitchen : x,우범지역
helluva : a,ad,대한한,지독한,형편없이 나쁜,굉장히 좋은,매우,극단적으로
helm : n,vt,키,자루,지도,키를 잡다,지도하다
helm : n,=HELMET
helm cloud : x,투구 구름(폭풍우 전 또는 도중에 산꼭대기에 끼는 구름)
helmet : a,투구,헬멧
helmet liner : x,철모 안에 쓰는 플라스틱 모자,파이버
helminth : n,(장내)기생충
helminthiasis : n,기생충병
helminthic : a,n,(장내)기생충의,구충하는,(기생충)구충제
helmsman : n,키잡이,타수
helmsship : n,조타술
helot : n,농노,노예
helotism : n,옛 스파르타의 노예 제도,노예의(같은) 신분
helotry : n,노예의 신분,노예(농노) 제도,(집합적)노예,농노
help : vt,돕다,거들다,(음식을)담다,권하다,구하다,고치다,(can,cannot와 더불어) 피하다,억누르다,...을 안하다
help : vi,돕다,도움이 되다,유용하다,(식사)시중을 들다
help : n,도움,구조,거드는 사람,고용,하인,구제책,피할 길,(음식물의) 한그릇 ~ forward 조성하다,~ off 거들어서 벗겨주다
helpable : a,도울 수 있는
helper : n,돕는(도움이 되는)사람(것),거드는 사람,조수(assistant),협력자,원조자,지지자,구조자,위안자
helpful : a,도움이 되는,유용한
helping : a,n,돕는 도움이 되는,거들어줌,조력,(음식의)한번담는 분량
helping hand : x,원조,도움
helpless : a,어찌할 도리 없는,무력한,의지할 데 없는
helplessly : ad,의지할 데 없이,어찌할 수 없이
helply : ad,도움이 되는,유용한
helpmate : n,협력자,동료,내조자,배우자,=helpmeet
helpness : n,무력,무능
helpwanted ad : x,구인 광고
helpyourself : n,a,(식당 등)셀프 서비스(의)
Helsinki : n,필란드의 수도
Helsinki Conference : x,헬싱키 협정(1975년 동서간의 긴장 완화를 위해 미국,소련 등 35개국이 조인)
helterskelter : n,a,ad,당황,당황하여,당황한
helve : n,(도끼 따위의) 자루
helvetia : n,스위스의 라틴어 이름
helvetian : a,n,(스위스에 살았던) 고대 헬베티아족의(사람),스위스의,스위스 사람(의)
Helvetic : a,=helvetian
hem : n,int,(옷,손수건 따위의)가선,감침질,경계
hem : vt,(...을)감치다,두르다,에워싸다
hem : int,에헴(헛기침 소리)
hema : x,(연결형)피의 뜻
hemal : a,혈액의,혈관의
heman : n,남자다운 남자
hematal : a,혈액의,혈관의
hematic : a,n,혈액의,혈액안에 포함되는,혈액에 작용하는,피색의 ,정혈제,보혈제
hematite : n,적철광
hematitic : a,적철광의
hematocryal : a,냉혈의(coldblooded)
hematologist : n,혈액학자
hematology : n,혈액학
hematoma : n,혈종
hematothermal : a,온혈의(warmblooded)
hematuria : n,혈뇨(증)
hembar : n,헴바(보리,1969년 미국 농무부에 의한 만들어진 품종)
heme : n,환원 헤마틴(헤모글로빈의 색소 성분)
hemi : n,반의 뜻
hemianopsia : n,반맹(증)
hemicycle : n,반원형,반원형의 건물(경기장,투기장,방)
hemicyclic : a,반원형의
hemidemisemiquaver : n,64분음표
hemihedral : a,반면상의,반광면의
hemimorphite : n,이극광
Hemingway : n,헤밍웨이(미국의 소설가,1899-1961)
Hemingwayesque : a,헤밍웨이(작품)의
hemiparasite : n,반 기생 생물(식물)
hemiparasitic : a,반 기생 생물(식물)의
hemiparasitism : n,반 기생
hemiplegia : n,편마비,반측마비
hemiplegic : a,n,반신불수의(사람)
hemiptera : n,반시류
hemipterous : a,반시류의(진디,매미,이 따위)
hemipterous : a,반시류의
hemisphere : n,반구
hemispheric : a,반구의
hemistich : n,(시의)반행,미완구
hemlock : n,독당근,독당근에서 뽑은 독약,(북미산의)솔송나무
hemlock fir : x,아메리카솔송 나무
hemmer : n,가두리를 대는 사람(것),(재봉틀의)휘감치는 장치
hemo : x,피의 뜻의 결합사
hemoconcentration : n,혈액 농축
hemocyte : n,혈액 세포,혈구
hemodialysis : n,혈액 투석
hemodilution : n,혈액 희석
hemoglobin : n,헤모글로빈,혈색소
hemogram : n,혈액상
hemolysis : n,용혈(현상(반응))
hemolytic : a,용혈(성)의
hemophile : n,호혈액성 세균,=hemophiliac
hemophilia : n,혈우병
hemophiliac : n,a,혈우병 환자,혈우병의
hemoptysis : n,객혈
hemorrhage : n,출혈
hemorrhagic : a,출혈의
hemorrhoidal : a,치질의
hemorrhoids : n,치질,치핵
hemostat : n,지혈기
hemostatic : a,n,지혈의,지혈제
hemp : n,삼,대마,교수형용의 밧줄
hempen : n,대마의,대마로 만든
hemp nettle : x,털향유(꿀풀과)
hemp palm : x,왜성 종려
hempseed : n,삼씨(새의 모이),악당
hemstitch : n,vt,헴스티치(하다),가장자리 올을 뽑아 몇가닥씩 묶다
hemtin : n,헤마틴(헤모글로빈의 색소 성분),=hematine
hen : n,암닭,암컷,like a ~ with 작은 일에 마음 졸여
Hen : x,Henry
hen and chickens : x,긴병꽃(꿀풀과),덩굴고아대수염(광대나물과)
henbane : n,사리풀(에서 뽑은 독약)
henbattery : n,사리풀(가지과의 유독 식물),그것에서 뽑은 독
henbit : n,광대나물
hence : ad,그러므로,그 결과,이제부터,여기서 부터,사라져
henceforth : ad,이후,차후
henceforward : ad,이후,차후
henchman : n,졸개,믿을 수 있는 부하
hencoop : n,닭장,닭 둥우리
hendeca : x,(연결형)(11)의 뜻(모음 앞에서는 hendec)
hendecagon : n,11각형
hendecasyllabic : a,n,11음절의 (시행)
hendecasyllable : n,11음절
hendiadys : n,중언법,두 말 한 뜻(보기: death and honor=honorable)
HeNe laser : x,헬륨네온(가스)레이저
henequen : n,용설란의 일종,그 잎에서 채취한 섬유
hen harrier : x,잿빛개구리매
henhearted : a,겁많은,소심한
henhouse : n,닭장,계사
Henley : n,Thames 강변의 지명,이곳에서 매년 열리는 보트 레이스
henna : n,헤너(관목),헤너 머리 염색제(적갈색)
hennery : n,양계장
henny : a,n,암탉 같은,겁많은,소심한(henhearted),암탉 같은 수탉
henotheism : n,(많은 신 중에서 한 신을 선택하는)단일신교,단신교
hen party : x,여자들만의 모임
hen party : x,여자끼리의 모임
henpeck : n,vt,공처가,(남편을) 깔고 뭉개다
henpecked : a,여편네 손에 쥐인
Henrietta : n,여자 이름
henroost : n,닭장,계사
henrun : n,닭장,(마당 있는)닭우리,닭 운동장
Henry : a,남자 이름,O.Henry(1862~1910)미국의 단편 작가,미국의 물리학자 J.Henry,자기유도계수의 단위
hensforward : ad,차후,이후
henversusegg argument : x,닭이 먼저냐 달걀이 먼저냐의 논쟁
henwife : n,닭 치는 여자
hep : a,...에 자세한(밝은),(최근 유행,사정에) 환한,재즈에 미친
hep : int,으윽(열연중에 장단 맞추는 소리),하나 둘(행진의 보조를 맞추는 구령)
heparin : n,헤파린,(간장이나 폐의 혈액 응고를 막는 물질)
hepat : x,(연결형)간(장)의 뜻,=hepato
hepatic : a,n,간의,간장약
hepatica : n,노루귀
hepatitis : n,간염
hepatitis A : x,A형 간염,전염성(혈청)간염
hepatocyte : n,간세포
hepatoma : n,간종양,간암
hepatotoxin : n,간세포 독소
Hepburn : n,헵번(미국의 선교사,의사,어학자,헵번식 로마자 철자법의 창시자)
hepcat : n,스윙연주가,스윙통
Hepplewhite : a,n,(영국의 가구제작가 이름에서)헤플화이트 양식의 (가구)(18세기 말 유행)
hepster : n,재즈광=HIPSTER
hept : x,(연결형)7의 뜻
heptachord : n,7현 악기,7음 음계
heptad : n,7개군,일곱개 한벌,7가 원자(원소)
heptagon : n,7각형
heptagonal : a,7각형의
heptahedral : a,7면체의
heptahedron : n,7면체
heptameter : n,칠보격
heptametrical : a,칠음각의
heptarch : n,7왕국(heptarchy)의 각 국왕
heptarchic : a,칠두정치의
heptarchy : n,칠두정치,(5~9세기의 앵글로 색슨 민족의) 7왕국
heptastich : n,7행시
heptasyllabic : a,7음절(시행)의
Heptateuch : n,구약 성서의 처음 7서
heptode : n,7극 진공관
her : pron,여자의,여자의(에게,를)
her. : x,heir,heraldic,heraldry
Hera : n,Zeus신의 아내(로마 신화에서는 Juno)
Heraclean : a,=Herculean
Heracles : n,=Hercules
herald : n,전령관,사자,문장관,의전관,고지자,보도자,신문의 이름
herald : v,전달하다
heraldic : a,전령관의,문장학의
heraldically : ad,전령관으로,문장학으로
heraldry : n,문장학,으리으리함
Heralds' College : x,문장원
heraldship : n,Herald의 직(지위,임무)
herb : n,풀,초본,(작약,상추,양배추 따위를 포함하며,식용,약용이 많음)
herbaceous : x,초본의,줄기가 연한,잎 모양의,초록색의
herbage : n,초본류,목초,방목권
herbal : a,n,초본의,본초서,식물지
herbalist : n,본초학자,약초상
herbarium : n,식물표본집(실,관)
herbary : n,약초원
herb beer : x,약용 맥주
herb bennet : x,뱀무우
herb doctor : x,한의사
Herbert : n,남자 이름
herbicide : n,제초제
herbivore : a,초식 동물
herbivorous : a,초식의
herborist : n,식물 채집가,=herrbalist
herborization : n,식물 채집,식물 연구
herborize : vi,식물을 채집하다,식물을 연구하다
herb tea : x,(약초를0달인 약,탕약,=herb water
herby : a,초본성의,풀이 많은
Herculean : a,헤르쿨레스의(같은),장사의 힘을 요하는,초인적인,아주 어려운
Hercules : n,헤르쿨레스(괴력의 영웅),초인적인 힘을 가진 사람,헤프쿨레스 자리
Hercules' choice : x,안일을 물리치고 스스로 고난을 택함
Hercules'club : n,왕조피나무의 일종
Hercules beetle : x,큰 딱정벌레(남미산의)
herd : n,vt,vi,(소,말 따위)무리,군중,민중,목자,몰아 모으다,지키다,떼지어 모이다
herdbook : n,(소,말,돼지의 혈통 기록)
herder : n,목자,소(양)치는 사람
herdic : n,(19세기말 미국의)2륜(4륜) 마차(뒤쪽에 승강구가 있음)
herdsman : n,목자,목동자리
herd test : x,소떼의 검사(특정 젖소떼의 유지방 함유율 검사)
here : ad,여기에,여기에서,이리로,이 점에서,이때에,이 세상에서,Hero! 예!(호명의 대답) ~ and there 여기저기에,~ below 이 세상에서는
here : n,여기,이 세상
hereabout : ad,이 근처에
hereafter : ad,금후,내세에서
hereat : ad,여기에서(at this)
hereaway : ad,이 근처에,이 부근에(hereabout)
hereby : ad,이에 의하여,이로 말미암아
hereditable : a,=HERITABLE
hereditament : n,상속(가능)재산,부동산
hereditarian : n,a,유전설 신봉자(의),유전론자(의)
hereditarily : ad,유전으로,세습으로,대대로
hereditariness : n,유전,세습
hereditary : a,유전의,세습의,대대의
hereditary peer : x,세습 귀족
hereditism : n,유전설
heredity : n,유전,유전형질
Hereford : n,헤리퍼드종의 소(식육용)
Hereford and Worcester : x,잉글랜드 서부의 주(1974년 신설)
Herefordshire : n,헤리퍼드셔(잉글랜드 서부의 옛 주,1974년 Hereford and Worcester주로 편입)
herein : ad,이속에,여기에,이런 까닭으로
hereinafter : ad,(서류 등에서) 이하에
hereinbefore : ad,(서류 등에서) 위에,윗 글에
hereinto : ad,이곳 속으로,이 안으로
hereof : ad,이것의,이에 관해서
hereon : ad,=HEREUPON
Herero : n,헤레로 족(아프리카 남서부의 반투족),헤레로 말
heres : x,here is의 단축형
heresiarch : n,이교의 시조(수령)
heresiology : n,이교 연구(논문)
heresy : n,이교,이단
heretic : n,이교도,이단
heretical : a,dl이교의 ,이단의
hereto : ad,여기까지,이에 관하여
heretofore : ad,지금까지,이제 까지
hereunder : ad,아래(문장)에,다음에,이 기록(조건)에 따라
hereunto : ad,여기까지,지금까지
hereupon : ad,여기에 있어서
herewith : ad,이와 함께,이에 의하여,여기에(동봉하여),이 기회에
heritability : n,물려줄 수 있음,상속 가능성
heritable : a,상속할 수 있는,유전하는
heritably : ad,상속(권)에 의하여
heritage : n,세습,상속,재산,유산,전승,유전,God's ~ 하느님의 선민
heritor : n,상속자,교구의 토지(가옥)소유자
hermaphrodite : n,a,양성동물,어지자지,양성화,두 상반된 성질의 소유자,양성의,자웅 동체의
hermaphroditic : a,양성의,자웅 동체의
hermaphroditism : n,암수 한몸임,=hermaphrodism
hermatype : n,조초 산호
hermatypic : a,조초성의
hermeneutic : a,(특히 성서)해석의,=hermeneutical
hermeneutics : n,(단수 취급)(특히 성서)해석학
Hermes : n,상업,변론의 신(신들의 사자로,로마 신화의 Mercury에 해당)
hermetic : a,밀봉한,연금술
hermetical : a,밀봉한,연금술
hermetically : ad,밀봉한,연금술
hermit : n,은자
hermitage : n,은자의 집
hermit crab : x,소라게
Hermit Kingdom : x,중국 이외의 나라와 접촉을 않던 근세 조선 왕조
hermit thrush : x,갈색지빠귀(북미산)
hern : n,=HERON
hernia : n,탈장,헤르니아
hernial : a,탈장의
herniate : vi,헤르니아가 되다
herniation : n,헤르니아
hernio : x,(연결형)(헤르니아)의 뜻
hero : n,영웅,용사,(이야기의) 주인공
Herod : n,(잔학한 왕)헤롯
Herodian : a,n,헤롯 왕의,헤롯왕가의 일당
Herodias : n,헤로디아(헤롯왕의 후처,살로메의 어머니,남편에게 세례 요한을 죽이게 함)
Herodotus : n,헤로도투스(그리스의 역사가)
heroic : a,n,영웅적인,용감한,장렬한,(문체가) 웅대한,(조상 따위가) 실물보다 큰,영웅시(격)의,과장된 표현(감정,행위)
heroic age : x,신인의 시대(Hesiod가 주장한 인간 역사의 5기중의 시대)
heroical : a,=heroic
heroically : ad,영웅답게,용맹스럽게,늠름하게,장렬하게
heroic couplet : x,약강 오보격의 압운 대구
heroicomic : a,영웅 희극적인(용맹과 웃음이 섞인),=heroicomical
heroic poetry : x,영웅시,사시
heroic verse : x,역사시(격)(영시에서는 약강 5보격,그리스,라틴,프랑스시에서는 6보격)
heroin : n,모르핀,진정제
heroin baby : x,헤로인 중독의 아기(부모의 중독으로 인하여 미숙아로 태어남)
heroine : n,여장부,여걸,열부,여주인공
heroinism : n,헤로인 중독
heroism : n,영웅적 자질,영웅적 행위
heron : n,왜가리
heronry : n,왜가리의 집단 서식지,왜가리 떼
hero sandwich : x,고기를 듬뿍 넣은 샌드위치
hero sandwich : x,대형 샌드위치(롤빵에 고기 등을 듬뿍 끼운 것)
hero worship : x,영웅숭배
heroworship : vt,영웅으로 숭배하다
heroworshiper : n,영웅 숭배자
herpes : n,포진
herpes simplex : x,단순 포진
herpes zoster : x,대상 포진
herpetic : a,포진의
herpetology : n,파충류학
Herr : n,군,씨
Herrenvolk : n,지배 민족(나치에 의한 독일 민족의 자칭)
Herrick : x,,Robert(1591~1674) 영국의 서정시인
herring : n,청어
herringbone : n,vt,vi,(피륙등의)오늬무늬,오늬무늬의,헤링본으로 꿰메다(짜다),개각등행
herring gull : x,재갈매기
herring pond : x,(익살)청어의 못(특히 북대서양)
hers : n,그 여자의 것
Herschel : n,허셜,Sir John Frederick William(영국의 천문학자),Sir William(독일태생의 영국 천문학자,1의 아버지,천왕성을 발견)
herself : n,그 여자 자신
Hertford : n,하트퍼드(영국 Hertfordshire주의 주도)
Hertfordshire : n,하트퍼드셔(잉글랜드 남서부의 주)
Herts : n,Hertfordshire
hertz : n,헤르츠
hertzian telegraphy : n,무선 전신
Hertzian wave : x,(독일의 물리학자 H Hertz에서),헤르츠파,전자파
hes : x,he is 의 준말
hesiflation : n,헤지플레이션(강한 인플레이션 요인을 안은 침체 성장)
Hesiod : n,헤시오도스(기원전 8세기경의 그리스 시인)
hesitance : n,망설임,주춤거림
hesitancy : n,망설임,주춤거림
hesitant : a,망설이는,주춤거리는
hesitate : vi,망설이다,주저하다
hesitating : a,망설이는,주저하는
hesitatingly : ad,망설이게,주저하게
hesitation : n,망설임,주저
hesitation waltz : x,스텝에 휴지와 미끄러지듯한 움직임을 임의로 교차시킨 왈츠
hesitative : a,망설이는,주저하는
hesitatively : ad,망설이며,주저하며
Hesper : n,=HESPERUS
Hesperian : a,n,서쪽의,서방의,서쪽(나라) 사람
Hesperides : n,Hera의 금 사과를 지키는 4명의 님프
hesperis : n,꽃무 무리
hesperus : n,개밥바라기,태백성
Hesse : n,,Hermann(1877~1962) 독일의 시인,소설가
Hessian : a,n,(독일 남서부의) Hesse의 (사람),용병,돈만 주면 일하는 사람
Hessian boots : x,전면에 술이 달린 군용 장화
Hessian fly : x,파리의 일종(유충은 밀의 해중)
hest : n,명령(behest)
hester : n,여자 이름
hestia : n,화로,화덕의 여신(로마 신화의 Vesta)
het : a,흥분하여 (~ up 흥분한)
hetaera : n,첩,노는 계집
hetaerism : n,축첩,잡혼,집단혼,=hetairism
hetaira : n,=hetaera
heter : x,(연결형)타(他),이(異)의 뜻
hetero : a,n,탄소 이외의 원자,이성애를 하는(사람),동성애가 아닌(사람)
heteroatom : n,헤테로 원자
heterochromatin : n,이질 염색질
heterochromosome : n,이질(이형)염색체,성염색체
heterochromous : a,이색의,다색의
heteroclite : a,n,불규칙 변화의(말)(명사,동사 등)
heteroclitic : a,불규칙 변화의
heterocyclic : a,이종 환식의
heterodox : a,이단의
heterodoxy : n,이설의,이단,이설
heterodyne : n,헤테로다인,(진공관이 맥놀이 내는)헤테로다인 수신기
heterofil : a,혼합 섬유의,혼직의(대전 방지,저항력 보강을 위한)
heterogamete : n,이형 배우자
heterogamous : a,이형 배우자에 의하여 생식하는,세대 교번의,(2종의)이성화를 갖는
heterogamy : n,이형 배우,헤테로가미
heterogeneity : n,이종,이질
heterogeneity : n,이종,이류,불균질,이류 혼교,이질 성분
heterogenely : ad,이종으로,이질 성분으로
heterogeneous : a,이종의,이질의,잡다한
heterogenesis : n,돌연 발생,진정 세대교번
heterogeness : n,이종,이질 성분
heterogenetic : a,돌연 발생의,진정 세대교번의
heterogenous : a,외생의
heterojunction : n,이질 접합
heterology : n,이종 구조
heteromorphic : a,이형(부등)의,완전변태의
heteromorphism : n,이형,변형;완전 변태,동질이광
heteromorphous : a,이형(부등)의,완전변태의
heteronomous : a,타율의;다른 발달 법칙에 따르는
heteronomy : n,타율,타율성
heteronuclear RNA : x, 이핵리보 핵산
heteronym : n,동철 이음 이의,같은 철자의 이음이의의 말
heteronymous : a,=heteronym의,이명의
heteropathy : n,대중요법(allopathy)
heterophile : ad,이종항원에 친화성을 가지는,이호성의,다염성의
heterophobia : n,(성적인)이성 공포증
heterosex : n,=heterosexuality
heterosexual : a,n,이성애의(사람)
heterosexuality : n,이성애
heterosexualy : ad,이성애로
heterosis : n,잡종 강세
heterosome : n,=heterochromosome
heterosphere : n,이질권,(대기의 이질권),(약 90km 보다 위)
heterostructure : n,헤테로 구조체(복합 반도체 장치)
heterotaxia : n,내장 변위,지층 변위
heterotaxis : n,내장 변위,지층 변위
heterotaxy : n, 내장 변위,지층 변위
heterotelic : a,(실재,발생사가)외인의
heterozygote : a,이질(이형) 접합의
hetman : n,  (옛 폴란드의)사령관,(카자흐의)수장(chief)
Hetty : n,여자 이름(Henrietta의 애칭)
heuristic : a,n,(학생에게)스스로 발견하게 하는,발견적인,발견적 교수법
heuristically : ad,발견적 교수법으로,스스로 발견하게 하므로
heuristic approach : x,발견적 해결 방법
heuristic program : x,발견적 프로그램
hew : vi,vt,(도끼 따위로)자르다,찍어 넘기다,(석재 따위를)잘라서(깎아서,새겨서) 만들다 ~ one's way 길을 개척하여 나아가다
HEW : x,(Department of) Health Education and Welfare
hewer : vi,vt,자르는 사람,채탄부
hewn : v,hew의 과거분사
hewolf : n,수늑대
hex : n,vt,마녀,마술,마법을 걸다,호리다,매혹하다
hexa : n,6의 뜻의 결합사
hexachord : n,6성음계
hexad : n,,=hexade,여섯,6개로 된 한조,6가원소
hexadecimal : a,16진법의,16진(수)
hexadic : a,여섯개로 된 한 벌의
hexagon : n,6각형
hexagonal : a,6각형
hexagram : n,6선형,6각의 별 모양(2개의 정삼각형을 거꾸로 하여 겹친 모양,유대교의 상징)
hexahedron : n,6면체
hexameter : n,육보격,육보격의 시
hexametric : a,육보격의
hexane : n,헥산(파라핀 탄화수소에 속하는 5종 이성체의 총칭으로 용제,중간물 등에 쓰임)
hexangular : a,6각의
hexapla : n,(특히 성경의)6개 국어 대역서
hexaplar : a,(특히 성경의)6개 국어 대역서의
hexapod : a,n,6각의 곤충의,6각류(동물),곤충
hexapodous : a,6각류(동물)의
hexapody : n,6음각의 시행
hexastich : n,6행시
hexastichon : n,6행시
hexastyle : a,n,6주식의(주랑 현관)
Hexateuch : n,(구약 성서의 처음)6서
hexavalent : a,6가의
hexode : n,6극(진공)관
hexosaminidase : n,헥소사미니다제(중추신경의 필수효소의 하나)
hexose : n,6탄당
hey : int,야아,어어,이봐,어이(놀람,기쁨,주의,환기 따위의 외침)
heyday : int,이런!,야아!
heyday : n,전성기
Hezekiah : n,남자 이름,히스기야(예언자 이사야 시대의 유대의 왕,열왕기하18-20)
Hf : x,high frequency
HG : x,higher grade,High German,Home Guard,Horse Guards
hg : x,hydrargyrum
HGH : x,human growth hormone
hgt : x,hight
hh : x,heavy hydrogen
hhd. : x,hogshead
hhf : x,household furnityre
HHFA : x,Housing and Home Finance Agency
HHG : x,household goods
Hhour : n,공격(작전) 개시 시각
hi : int,야아,어이
hiatus : n,중절,틈,모음접속
Hiawatha : n,하이어워사(Longfellow의 시에 나오는 인디언 영웅)
hibernaculum : n,(동면 동물의)동면 장소,(식물의 싹의)동면용 외피,인공 동면 장치
hibernal : a,겨울의,겨울 같은
hibernant : a,동면의
hibernate : v,겨울 잠자다,동면하다
hibernation : n,겨울잠,동면,=hibernator
hibernia : n,IRELAND
hibernian : a,n,아일랜드(사람)의,아일랜드 사람(Irishman)
hibernicism : n,아일랜드 말 특유의 어법,아일랜드 사람 기질,=Irish bull,Hibernianism
hibiscus : n,목부용속의 식물(목부용,무궁화 등)
hic : int,딸꾹(딸꾹질 의성음)
hiccough : n,vi,vt,딸꾹질(하다,하며 말하다)
hiccup : n,vi,vt,딸꾹질(하다,하며 말하다)
Hichcock : n,히치콕(영국의 영화 감독,서스펜스 영화의 거장)
hic jacet : x,여기에 (길이) 잠드시다,묘비명
hick : a,n,농부(다운),순박한 (사람)
hickey : n,(자그마한)장치,(전기 기구의)연결기
hickey : n,여드름,(인쇄판,네거 등의)흠집,키스 마크
hickory : n,호두과의 나무
hid : v,hide의 과거
hidalgo : n,스페인의 하급 귀족(grandee의 다음)
hidden : v,a,hide의 과거분사,숨은,숨겨진
hiddenball trick : x,공감추기
hidden hunger : x,숨은 기아(자각되지 않는 영양 부족)
hidden persuader : x,숨은 설득자(교묘하고 악랄한 상업 광고업자)
hidden reserve : x,은닉 적립금
hidden tax : x,=indirecet tax
hide : vi,vt,숨(기)다,~ oneself 숨다
hide : vi,vt,짐승의 가죽(을 벗기다),피혁,때리다
hideandgoseek : n,숨바꼭질
hideandseek : n,숨바꼭질
hideaway : n,은신처,으슥한 음식점,오락장
hidebound : a,(가축이) 여윈,완고(완미)한,(마음이)편협한,편벽되,(식물이) 껍질이 말라붙은
hideous : a,끔찍한,섬뜩한,오싹해지는,무서운
hideously : ad,소름 끼칠 만큼
hideout : n,(범인의) 은신처
hideyhole : n,은신처
hiding : n,은닉,은신처,은닉처,매질,후려갈김
hidrosis : n,발한,발한 과다(증),다한증
hidrotic : a,발한의
hidyhole : n,=hideyhole
hie : vt,vi,서두르다,급히가다
hier : x,(연결형)신성한,성직의 뜻,=hiero
hierarch : n,교주
hierarchal : a,=hierarchical
hierarchic : a,위계 제도(조직)의,성직 정치의,성직자의 계급의,성직자단의
hierarchical : a,위계 제도(조직),성직 정치,성직자의 계급,성직자단,천사의 계급,천사들
hierarchism : n,계층제 조직(원리,주의)
hierarchist : n,계층제 조직자(원리주의자)
hierarchy : n,위계 제도(조직),성직 정치,성직자의 계급,성직자단,천사의 계급,천사들
hieratic : x,성직자의,신성한,신성한 용도의
hieratical : a,=hieratic
hiero : x,(연결형)=hier
hierocracy : n,성직자 정치,성직 계급 조직
hierocratic : a,성직자 정치의,성직 계급 조직의,=hierocratical
hieroglyph : n,상형문자
hieroglyphic : a,n,상형문자의,상형문자,비밀문자
hierology : n,(민족적 신앙이 집적된)종교 문학,종교적 전승
hierophant : n,종교상의 비의 해설자,(고대 그리스의)신비 의식의 도사(사제),주창자
hierophantic : a, 종교상의 비의,신비 의식의
hifalutin : n,a,=highfalutin
hifi : n,a,고충실도,음향재생 장치,하이파이
HiFi VHS : x,하이파이 VHS(비디오 테이프 리코더의 새로운 음성 기록 방식,상표명)
hifi VTR : x,하이파이 비디오 테이프 리코더
higgle : vi,값을 깎다,흥정하다
higgledypiggledy : n,a,ad,엉망진창,엉망진창인,엉망진창으로
higgler : n,행상인,에누리하는 사람
Higgs meson : x,(영국의 물리학자 PHiggs에서)히그스의 중간자
high : ad,높은,...의 높이의,높은 곳(으로부터)의,고지의,고귀(고상,숭고)한,고원의,고위의,고급의,값비싼,격렬한,극도의,과격한,짙은
high : x, (연결형)(~높이의)의 뜻
high altar : x,(교회당의)주 제단,중앙 제단
highalumina cement : x,고 알루미나 시멘트(경화가 빠름)
high analysis : x,(비료가)식물의 필요 양분의 20% 이상을 함유하는
highandmighty : a,거만한,불손한
highangle : a,고각도의,고각 사격의
highangle fire : x,고각 사격,곡사
high atmospheric pressure : x,고기압
highball : n,하이볼(위스키에 소다수 따위를 섞은 음료)
high beam : x,하이빔(원거리용 상향 헤드라이트)
highbinder : n,불량배,사기꾼,살인 청부업자
highblooded : a,혈통이 좋은
high blood pressure : x,고혈압
high blower : x,콧김을 세게 내쉬는 말
highblown : a,의기 양양한,도도한
high boot : x,장화
highborn : n,집안이 좋은,명문 출신의
highboy : n,다리가 높은 옷장
high brass : x,=top brass
highbred : a,순조의,본데 있는,예의바른,교양 있는
highbrow : n,a,인텔리,인텔리인체 하는 사람,인텔리를 위한
highbrowed : a,이마가 넓은,지식인의,인텔리겐치아로 자처하는
Highbrowville : n,Boston시의 속칭
high camp : x,예술적으로 진부한 것을 의도적으로 이용하기
high chair : x,(어린이의)식사용 높은 의자
highchair : n,(다리가 높은) 어린이 의자
high Church : x,고교회파(영국 교회파 중,교회의 교의 및 의식을 존중하는 한파)
high Churchman : x,고교회파 신도
highclass : a,고급의
high color : x,좋은 혈색
highcolored : a,혈색 좋은
high comedy : x,(연기의 익살 따위에 중점을 두지 않는)고급희극
high command : x,최고 사령부
high commissioner : x,(식민지의)고등 판무관
high Court : x,고등법원
high crime : x,중대한 범죄(대통령 기타 행정관의 탄핵 이유가 되는 파렴치 범죄)
high day : x,축제일
high day : x,축제일,경축일
highdefinition : a,선명한,선예한
highdefinition television : x,고선명도(고품위)텔레비젼
High Dutch : x,=High German
highenergy physics : x,고에너지(소입자) 물리학
highenery : a, 고에너지를 가진,고에너지 입자의
highenery laser : x,고에너지 레이저
higher : a,(high의 비교급)더 높은,고등의
higher apsis : x,원일점
higher criticism : x,(성경의)고등 비평(과학적 방법의 내용 연구)
higher education : x,고등 교육,대학 교육
higher law : x,도덕률(인간이 정한 법률보다 한층 높은 것으로 여겨지므로)
higher mathematics : x, 고등 수학
higherup : n,상사,높으신 양반들
higherup : n,상관,상사,상부
highest : a,(high의 최상급)
high explosive : x,고성능 폭약
highfalutin : a,n,허풍떠는,큰소리치는,호언장담
high faluting : a,n,과장된 (말)
highfaluting : a,=highfalutin
high farming : x,집약농업
high fashion : x,(의복의)최신 유행 스타일(디자인),하이 패션,=haute couture
highfed : a,호화롭게 자란
high feeding : x,미식
high fidelity : x,(라디오,전축이 원음을 재생하는)고충실도,하이파이
highfidelity : a,고충실도의,하이파이의
high finance : x,거대하고 복잡한 금융 거래
highflier : n,높이 나는 새,야심가,높은 소망을 가진 사람
highflown : a,엄청나게 희망이 큰,과대한
highflying : a,높이 나는,고공 비행의,포부가 큰,야심적인
high frequency : x,고주파,단파
highfrequency : a,고주파의
high frontier : x,우주전선
high gear : x,고속 기어,최고 속도,최고조
high German : x,GERMAN
highgrade : a,고급의
highhanded : a,고압적인
high hat : x,실크 해트(top hat)
highhat : n,vi,vt,실크해트,뽑내는사람,뽐내다
highhearted : a,의기 충천한,기고 만장한(highspirited),고매한
highheartly : ad,의기 충천의,기고 만장해서
highheartness : n,의기 충천,기고 만장
highheat : a,내열성의
highheeled : a,굽 높은,하이힐의(신)
high horse : x,(옛날 귀인이 키 큰 말을 탄 데서)거만,오만(한 태도),언짢음
highjack : vt,vi,HJACK
high jinks : x,신나게(흥청망청) 떠들기
high jump : vt,vi,높이뛰기
highkey : a,(화면이)밝은 평조의
highkeyed : a,음조가 높은,민감한,신경질인,몹시 흥분(긴장)한,기운찬,색조가 밝은
highkicker : n,치어리더,응원단원
highland : n,고지,산지,스코틀랜드 고지
highlander : n,스코틀랜드 고지 사람
Highland fling : x,스콜틀랜드 고지인의 포크댄스
highlevel : a,고관에 의한,고관의,높은 곳으로부터의
highlevel language : x,고수준 언어(일상어에 가장 가까운 프로그램용 언어)
high life : x,상류 사회(의 생활)
highlight : n,vt,(화면의)하이라이트,중요부분,(뉴스 중의) 중요사건,화제거리,두드러지게 하다,강조하다,돋보이다
highlighter : n,하이라이더(얼굴에 입체감을 주는 화장품)
high liver : x,사치스러운 생활을 하는 사람,미식가
high living : n,호화스러운 생활
highlow : n,(카드)하이로 포커
highlows : n,(복사뼈까지 올라오는)부츠,편상화
highly : ad,높이,크게,speak ~ of ...을 격찬하다
highlyspecialized : a,고도로 전문화된
highlystrung : a,=high strung
high Mass : n,(카톨릭) 장엄한 미사
highmettled : a,성미가 괄괄한,성마른,기운이 펄펄한(highspirited)
highminded : a,고결한,거만한
highmuckamuck : n,높은 사람,젠체하는 사람,=highmucketymuck
highnecked : a,(여자 옷의)깃이 높은
highness : n,높음,높이,고위,고가,전하
high noon : n,한낮,정오
highnosed : a,콧대가 높은
highoctane : a,고옥탄가의
Hig Holyday : x,(유대교)Rosh Hashanah나 Yom Kippur중의 한 제일,High Holy Day
highpass filter : x,고역 필터
high pillow : x,거물,중요 인물
high pitch : x, (노점 상인의)판매대
highpitched : a,가락이 높은,급경사의,고상한,몹시 긴장된
high place : x,산꼭대기의 예배 장소,중요한 지위,요직,고관
high pockets : x,키다리
high point : x,중대한 시점,최고의 시기
high polymer : x,고분자(거대분자) 물질
high polymer chemistry : x,고분자(화)학의,강력한,(광학 기기가)배율이 높은,정력적인
highpowered : n,정력적인,고성능의
highpowered money : x,고권 화폐,중앙 은행 화폐
highpressure : a,n,고압의,고압적인,강요하는
highpressure nervous syndrome : x,고압 신경 증후군
highpriced : a,값 비싼
high priest : x,제사장,(옛 유대교의)대제사장,고승,(주의,운동의)지도자
highprincipled : a,고매한 주의를 가진,고결한
high profile : x,명확한 태도(정책),선명한 입장
highproof : a,알코올 도수가 높은
highranker : n,고관,고급장교
highranking : a,고급(고관)의
high relief : x,=alto relievo
highresolution : a,고해상도의
highriding : a,호조의
highrise : a,고층 건물의,높이 올린
highriser : n,고층 건물,2층 침대
highroad : n,큰길,대로,쉬운길
high roller : n,낭비자,난봉꾼,노름꾼
high school : n,고등학교,중등학교
high schooler : x,고등 학교 학생
high sea : n,높은(거친) 파도,공해
high season : x,(장사에서 거래,가격 등이 가장 좋은)전성기,성수기
high sheriff : x,주장관
high sign : n,(몸짓,표정에 의한)신호
high society : n,상류 사회
highsouled : a,숭고한 정신의
highsounding : a,과장된
highspeed : a,고속도의
highspeed steel : n,고속도강
high spirit : x,진취의 기상,원기 왕성,기분 좋은
highspirited : a,기개 있는 ,용감한,기운찬,기세 좋은
high spot : a,두드러진 특색(부분),대속력으로 가다,대강(말하다)
highstakes : a,흥하든 망하든
highstepper : n,발을 높이 들며 걷는 말,기운이 펄펄한 사람,위세가 당당한 사람,젠체하는 사람,우쭐대는 사람
highstepping : a,발을 높이 들며 나아가는(말),쾌락에 빠진,난봉부리는
High Street : x,큰(번화한) 거리
high Strung : n,큰거리,중심가
highstrung : a,과민한,흥분하기 쉬운
high style : x,첨단적(최신)패션(디자인),고급 패션
hight : a,...이라고 불리워지는
high table : x,대학 학료의 fellow,학장,교수 등의 식탁
hightail : x,전속력으로 달아나다
high tea : n,(고기 요리가 따르는) 오후의 차
hightech : n,(고도의)첨단기술
hightecher : n,고도 기술 산업,고도 기술자
high technology : x,첨단 기술,고도 과학 기술,하이 테크놀로지
hightechnology : a,첨단 기술의,고도 과학 시술의
highteen : a,n,18,19세의 (소년,소녀),하이틴(의)
high tensile : x,(금속이)신장성이 높은
high tension : x,고전압
hightension : a,고압의
hightest : a,엄격한 시험에 패스하는,비등점이 낮은(가솔린 등)
high tide : x,고조,한창인 때
high time : x,좋은 때(시기),호기,흥겨울(유쾌한)때
high toned : a,가락이 높은,새된,고상한,멋진,스마트한
high treason : x,대역,대역죄
hightytighty : a,=hoitytoity
highup : a,n,현직의,현직의 사람,높은 지위의 (사람)
high voltage : x,고(전)압
highvoltage : a,강력한,활기 있는
high water : 고조,만조,사리 n,
highwater : n, (바지 등이)매우 짧은
highwater mark : x,고조표,최고 수위점,최고 수준
highway : x,공도,간선 도로,상도
Highway Code : x,(자동차의)교통 법규
highway hypnosis : x,고속 도로 최면(장시간의 단순 운전으로 인한 반수면 상태)
highwayman : x,노상강도
highway patrol : x,고속 도로 순찰대
highway robbery : x,백주 강도,노상 강도,폭리
high wire : x,(높게 친)줄타기 줄
high words : x,격론,시비조
highwrought : a,아주 정교한,공들여 마무리한,몹시 흥분한
HIH : x,His(Her) Imperial Highness
hijack : vt,(배,비행기 등을)약탈하다,공중(해상)납치하다,(수송중인 물품등을)강탈하다,~er n
hijrah : n,=hegira3
hike : n,vi,vt,도보여행(하이킹)(을 하다),인상(하다)
hiker : n,여행가
hiking : n,여행
HILAC : n,(Heavy Ion Linear Accelerator)중이온 선형가속기
hilarily : ad,유쾌하게,즐겁게
hilarious : a,매우 명랑한
hilarity : n,명랑
Hilary : n,남자(여자) 이름
Hilary term : x,대학의 1월부터 시작하는 학기
Hilda : n,여자 이름
Hildegarde : n,여자 이름
hill : n,언덕,작은산,야산,흙무더기
hill : vt,쌓아 올리다,북주다
Hillary : n,힐러리(뉴질랜드의 등산가,Mt,Everest첫 등정에 성공(1953))
hillbilly : n,(미국 남부의) 산지(두메)사람시골뜨기
hillbilly music : x,힐빌리 음악(미국 남부 산악 지대의 민요조의 음악)
hill folk : x,=hillman,구릉지의 마귀
hilliness : n,작은 산(구릉)이 많음,구릉성
hillman : n,=hillmen,산골(구릉지)의 사람
hill myna : x,구관조
hill myna : x,구관조
hillo : int,n,v,=hollo,hilloa,holla,halloo
hillock : n,작은 언덕,봉토둑
hillocky : a,낮은 산 같은,작은 언덕 같은
hillside : n,산중턱,산허리
hillsman : n,=hillsmen,hillman
hill station : x,(인도)고지 주둔지(피서지)
hilltop : n,언덕(야산)의,꼭대기
hilly : a,언덕이 많은
hilt : n,칼자루,to hte ~ 충분히,완전히
Hilton : n,힐턴 James(1900-1954)(영국의 소설가)
hilum : n,종자의 배꼽
him : pron,그를(에게)
HIM : x,His(Her) Imperial Majesty 황제(황후)폐하
Himalaya Mountains : =Himalayas
himalayan : a,히말라야 산맥의
himalayan cedar : x,히말라야삼나무
himalayas : n,히말라야 산맥 ,Himalayana
himself : pron,그자신 ,by ~ 혼자서,for ~ 자기용으로
Hinayana : n,소승
hincty : a,자만한,새침한
hind : a,n,뒤의,맨뒤의,고라니의 암컷,농장 일꾼,머슴,시골뜨기
Hind : x,Hindi,Hindu,Hindustan,Hindustani
hindbrain : n,후뇌(소뇌와 연수)
Hindenburg : n,힌덴부르크(독일의 장군,정치가)
hind end : x,엉덩이
hinder : vi,vt,a,방해하다,방해가 되다,뒤의,뒤쪽의
hindermost : a,=hindmost
Hindi : a,n,북인도의,힌디어
hind leg : x,뒷다리
hindmost : a,맨 뒤의
Hindoo : n,a,=Hindu
hindquarter : n,(쇠고기,양고기 등의)뒷다리 및 볼기
hindrance : n,방해,장애,방해물
hindsight : n,때 늦은 지혜,(총의) 후부가늠자
Hindu : n,a,힌두사람(교도),힌두의,힌두교
HinduArabic numerals : x,=Arabic numerals
Hinduism : n,힌두(인도)교
Hindu Kush : n,힌두 쿠시 산맥
hindustan : n,인도의 페르시아 이름(특히 Deccan 고원의 북부),힌두스탄(인도 반도의 힌두교 지대)
hindustani : n,a,힌두스탄어,힌두스탄의
hinforemost : ad,뒤쪽을 전면으로 하고
hinge : n,경첩,요점,off the ~s 탈(고장)이 나서,(질서가) 어지러워
hinge : vi,vt,경첩을 달다(으로 움직이다),...에 달려 있다
hinged : a,경첩(돌쩌귀)이 달린
hinge joint : x,(무릎 등의)경첩 관절
hingeless : a,경첩식의,요점식의
Hinglish : n,(힌두어와 영어가 섞인)인도 영어
hinny : n,수말과 암나귀의 잡종
hint : n,vi,vt,암시,암시하다,변죽울리기,넌지시 비추다 ,take a ~ 깨닫다
hinterland : n,배후지,오지,시골
hinterurbia : n,도시 노동자가 사는 먼 교회
hip : n,a,int,엉덩이,허리,장미의 열매,우울(하게 하다),최신 유행의,정보통의,히피의,갈채의 첫소리
hip bath : x,뒷물
hipbone : n,무명골,좌골
hip boot : x,엉덩이까지 오는 장화(어부,낚시꾼용)
hipdisease : n,고관절병
hipdom : n,=hippiedom
hipe : n,vt,안아치기(로 던지다)
hip flask : x,포켓위스키 병
hipgout : n,좌골 신경통
hiphugger : a,(바지,스커트가)허리춤이 낮은
hiphuggers : n,허리뼈에 걸쳐 입는 바지(스커트)
hip joint : x,고관절
hipness : n,최신 정보에 밝음
hipp- : x,(연결형)(말의)의 뜻(모음 앞에서는 hipp-),=hippo
hipped : n,vt,우울한,...에 열중한
hippie : n,히피(족),(일체의 기성제도,가치관을 부인,야릇한 몸차림을 하고 다니는 젊은이)
hippiedom : n,히피족의 세계(생활 태도)
hippieness : n,히피적 성격(상태)
hippish : a,우울한
hippo : n,=HIPPOPOTAMUS
hippocampus : n,해마,해마(해신의 수레를 끄는 말 머리와 물고기 꼬리를 가진 괴물),(뇌의)해마상 융기
hippocket : n,a,(바지의)뒷주머니,소형의,소규모의
hippocras : n,(중세의)향료를 넣은 포도주
Hippocrates : n,(460?,377? B.C.) 히포크라테스(그리스의 명의)
Hippocratic : a,히포크라테스의
Hippocratic oath : n,Hippocrates가 지었다는 의사의 윤리 강령
Hippocrene : n,(Muses 에게 봉헌된)영천 ,시적 영감(의 원천)
hippodrome : n,마차 경주장,경마장,곡마장,연예장
hippogriff : n,말 몸에 독수리 머리와 날개를 가진 괴물,=hippogryph
hippoket : n,뒷주머니
hippology : n,타는말에 대한 학문
hippophile : n,말을 좋아하는 사람,애마가
hippopotamus : n,하마
hippy : a,n,엉덩이가 큰 여자,=hippie
hip roof : x,=hipped roof
hiproofed : a,우울한
hipshooter : n,(생각 없이)아무렇게나 말하는 사람
hipshooting : a,되는 대로 하는,무모한,엉터리의,발작적인
hipster : n,재즈팬,비트족
hirable : a,임차할(빌릴)수 있는,고용할 수 있는
Hiram : n,남자 이름
hircine : a,염소의
hire : vt,n,고용하다,(물건을)세내다,세놓다,고용되다,임대료,임차료,~oneself out 고용되다,~ out 대출하다,for ~ 임대의(료)
hired : a,고용한,삯주는,빌린
hired girl : x,여자 삯일꾼(주로 농가의),하녀
hired hand : x,고용인,머슴,농장일꾼,=hired man
hireling : a,n,고용되어 일하는 사람,삯 말,돈이면 무엇이든 하는 (사람)
hireprchase : n,a,분할불구입의,월부구입
hire purchase : x,분할불 구입(법)
hirer : n,고용주,(동산)임차인
hires : a,=highresolution
hiring : n,고용,임대차
hiring hall : x,(노조 직영의)직업 소개소
hiring manager : x,(기업의 채용 담당의)인사 부장
hirise : n,=highrise
hirsute : a,털많은
his : pron,그의,그의 것
his'n : pron,(he에 대응하는 소유 대명사)그의 것(his),=hisn
hisandhers : a,(상품이)남녀(부부(용 한 벌씩의)
Hispania : n,=Spain
Hispanic : a,n,=Spanish,(미국 내의 스페인 말을 쓰는)라틴 아메리카 사람(계 주민)
Hispaniola : n,히스파니올라 섬(서인도 제도중 Haiti,Dominica 양 공화국을 포함하는 섬)
Hispano : a,n,남미계의 (주민),(미국 남서부의)스페인(멕시코)계의 (주민)
Hispano- : x,(연결형)(스페인의)의 뜻
hispid : a,센 털이 있는
hiss : n,vi,vt,쉿하다,쉬이하다
hissing : n,쉿소리 나기(하는 소리)
hissing sound : x, 치찰음
hist : int,쉬잇
hist. : x,histology,historian,historical,history
histamine : n,히스타민(혈압강하,위액 촉진제)
histaminic : a,히스타민의
histidine : n,히스티딘(염기성-아미노산의 하나)
histidinemia : n,히스티딘 혈증
histio- : x,(연결형)=hist-
histiochemical : a,조직 화학의
histiochemistry : n,조직 화학(조직내의 여러 물질의 성질,분포를 연구하는
histiocompatibility : n,조직 적합(친화)성
histiocompatibility antigen : x,조직 적합성 항원
histiocompatible : a,조직 적합성의
histiocyte : n,조직구(세망 내피계에 속하는 세포)
histiocytic : a,조직구의
histogram : n,막대 그래프
histoincompatibility : n,조직 부적합성
histological : a,조직학의,histologic
histologist : n,조직학자
histology : n,조직학
histolysis : n,(체조직의)조직 융해(분해)
histone : n,히스톤(단순 단백질의 일종)
histophysiologic : a,조직 생리학의,histophysiological
historaphy : n,역사편찬자,사료 편찬관
historian : n,역사가
historiated : a,상형 무늬의 장식을 한,상형기호를 붙인
historic : a,역사상 유명한,역사에 남은
historical : a,역사의,역사상의,사적인
historical linguistics : x,역사 언어학
historical materialism : x,사적 유물론
historical present : x,역사적 현재
historical school : x,역사학과
historicism : n,역사주의(역사는 현대적 각도에서 볼 것이 아니라는 학설),역사 필연주의(역사의 발전은 인간의 의지에 의한 것은 아니라는 학설)
historicist : n,실증주의자,전통주의자
historicity : n,사실성,사적 확실성
historic present : x,역사적 현재
historic rehabilitation : x,역사적 건조물 재이용(계획)
historied : a,역사적으로 유명한,유서 깊은
historiette : n,소사,사화,단편소설
historiographer : n,역사편찬자,사료 편찬관
historiographic : a,사료 편찬의,hitoriographical
historiography : n,사료 편찬,수사
history : n,역사,사학,연혁,경력,사극
Histosol : n,히스토솔,(식물)조직 토양,부엽토
histrionic : a,n,배우의,연극의,연극 같은,배우,연극
histrionics : n,연극,(연극 같은)언동
hit : vt,치다,맞히다,적중하다,...에 공교롭게 부닥치다,생각이 미치다,감정을 상하게 하다,부닥치다,꼭맞다,요구하다,(마약을) 주사하다
hit : vi,치다,치고 덤비다,부딪치다,우연히 발견하다(생각해 내다),at ~ ...에게 치고 덤비다
hit : n,타격,히트,성공,명언,빗댐,안타,히트,make a 히트치다
hitandmiss : a,되는대로 하는,마구잡이의,상태가 고르지 못한
hitandrun : a,n,히트앤드런의,치어놓고 뺑소니치는
hit batsman : x,공이 몸에 맞은 타자,=hit batter
hitch : vt,n,(소,말을) 매다,(밧줄,갈고리 따위로) 걸다,와락잡아당기다,끌어넣다 ,와락 움직이다,다리를 절다,걸리다,~ horses 일치하다,급히 멈춤,고장,지장
hitchhike : n,vi,vt,히치하이크(지나가는 자동차에 편승해서 하는 무전여행)(을 하다)
hitchhiker : n,자동차 편승 여행자,(라디오,TV)짧은 광고(방송 순서끝에 붙는)
hitchhiking : n,편승여행
hitching post : x,말(등)을 매는 말뚝
hitchy : a,벌벌떠는
hitfest : n,타격전,난타전
hither : ad,a,여기로,이리로,이쪽의
hithermost : a,가장 이쪽의
hitherto : ad,지금까지는
hitherwards : ad,이리로,이쪽으로
Hitler : x,Adolf(1889~1945) 독일(Nazi당) 수상,독재자
Hitlerism : n,(독일) 국가 사회주의
Hitlerite : n,a,(독일) 국가 사회주의자,히틀러주의자의
hit list : x,정리(암살)대상 사항(인물)의 리스트,공격 대상자 명단
hit man : x,암살자,난폭한 선수
hitormiss : a,무작정(되는대로)의(random)
hit parade : x,히트퍼레이드,히트곡 베스트셀러 소설 등의 순위를 공개
hit parade : x,유행가(베스트셀러(등))의 인기순위
hitrun : a,치어놓고 뺑소니치는
hitskip : a,=hitrun
hit squad : x,암살단,=hit team
hitter : n,치는 사람,타자
hit theory : x,표적론,충격설
hitting streak : x,연속 안타
Hittite : n,a,히타이트족(소아시아의 고대 민족),히타이트 말,히타이트족(말,문화)의
hit woman : x,여자 암살자
HIV : n,human immunodeficiency virus,사람 면역결핍 바이러스,AIDS 바이러스
hive : n,vt,vi,꿀벌통,벌집(모양의 것),와글와글하는 군중,벌통에 넣다,벌통에 들어가다,축적하다
hiveoff : n,=spinoff
hives : n,발진,두드러기
hiya : int,여!,안녕!(인사말)
HJS : x,hic jacet sepultus(=here lies buried)
HK : x,Hong Kong,House of Keys
HK$ : x,Hong Kong dollar(s)
hl : x,hectoliter,heilig(=holy)
HL : x,House of Lords
HLI : x,Highland Light Infantry
HLZ : x,helicopter landing zone
hm : x,hectometer
HMAS : x,His(Her) Majesty's Australian Ship
HMC : x,His(Her) Majesty's Customs
HMCS : x,His(Her) Majesty's Customs Ship
HMI : x,His(Her) Majesty's Inspector(of Schools)
HMSO : x,His(Her) Majesty's Staationery Office
HMT : x,His(Her) Majesty's Trawler
HNC : x,Higher National Certificate
HND : x,Higher National Diploma
HnRNA : x,heteronuclear RNA
Ho : x,holmium
ho : int,호,어이,저런,허허,흥
hoactzin : n,=hoatzin
hoagie : n,(=hoagy),=hero sandwich
hoar : a,n,흰,회색의,백발의,흰백색,흰서리
hoard : n,vi,vt,저장(물),축적,저장하다,사모으다
hoarding : n,저장,사재기,저장물,판장,게시판
hoarding : ad,매점하여,욕심을 부려
hoardingly : ad,매점하여,욕심을 부려
hoarfrost : n,흰서리
hoarhound : n,=horehound
hoariness : n,(머리털의)흼,늙음,고색 창연함,숭엄함
hoarse : a,목쉰(husky),쉰목소리의,귀에 거슬리는
hoarsen : vt,vi,목쉬게 하다,(목소리가)쉬다
hoarseness : n,쉰 목소리
hoarstone : n,(고대부터 있던) 경계석,기념석
hoary : a,회백색의,백발의,고색이 창연한,나이 들어 점잖은,오래된
hoaryheaded : a,흰머리의,백발의
hoatzin : n,호아친새(남미산)
hoax : vt,n,(장난으로) 속이다(속임),골탕 먹이다,장난
hob : n,(난로 속의 안쪽 또는 측면의)시렁,톱니내는기계,(고리 던지기 놀이의) 표적기둥,요괴
Hobart : n,남자 이름
hobbadehoy : n,=hobbledehoy
Hobbes : n,Thomas(1588~1679) 영국의 철학자
hobbit : n,호빗(영국의 작가 John R Tolkien의 작품에 나오는 가공의 난쟁이
hobble : vi,n,다리를 절다(절뚝거림),쉬엄쉬엄 이야기하다,곤경,곤란,절뚝거리게 하다,다리를 묶다
hobbledehoy : n,풋내기,애송이,꾀바르지 못한 젊은이
hobble skirt : x,밑통을 좁게 한 긴 스커트
hobby : n,vi,취미,자랑 삼는것,장기,목마,mount (ride) one's ~ (듣기 싫을 정도로) 자랑을 늘어 놓다
hobby computer : x,취미용 컴퓨터
hobbyhorse : n,목마,(말머리가 달린)죽마
hobbyist : n,취미 생활자
hobgoblin : n,도깨비,작은 요괴
hobnail : n,(구둣 바닥의)징
hobnailed liver : x,간경변
hobnob : vi,n,사이좋게(허물없이) 지내다,환담
hobo : n,부랑자,뜨내기 노동자
hoboe : n,=oboe
Hobson's choice : x,=CHOICE
Ho Chi	Minh : x,(1892~1969)호지명(월맹 대통령) ,~ trail 호지명 루트
Ho Chi Minh : n,호지명(월맹 대통령)
Ho chi Minh City : n,호지명시(옛 사이공)
hock : n,vt,(네 발 짐승의 뒷발의) 과관절(의 건을 끊어 불구로 만들다),흰 포도주의 일종,전당,전당잡히다
hockey : n,하키
hockshop : n,전당포
hoc tap : n,정치 재교육(특히 공산 정권하의)
hocus : vt,속이다,마취제를 타다,마취시키다
hocuspocus : n,vi,vt,요술,기술사의 상투적 문구,야바위,요술을 부리다,감쪽같이 속이다
hod : n,호드(벽돌,회반죽을 나르는 그릇),석탄통
hodad : n,파도 타기를 하지 않는 사람,서투른 서퍼(surfer)
hod carrier : x,hod를 나르는 인부
hodden : n,a,무늬가 없는 거친 나사,수직 나사,손으로 짠 거친 나사의(옷을 입은),시골티 나는,촌스러운(rustic)
hoddown : n,꺾쇠,죔쇠,억제
Hodge : n,남자 이름(Roger의 통칭),(전형적인)머슴,촌뜨기
hodgepodge : n,엉망진창,뒤죽박죽
Hodgkin's disease : x,호지킨 병(악성 육아종중)
hodiernal : a,오늘(날)의(of this day)
hodmam : n,=hod carrier
hodmen : n,운반인
hodometer : n,=odometer
hoe : n,vt,괭이,괭이로 파다,괭이로 갈다
hoecake : n,옥수수빵
hoedown : n,활발 명랑한 춤(스퀘어 댄스),그 판티,호다운 곡
hog : n,vt,돼지,욕심쟁이,더러운 사람,go the whole ~  철저히 하다,탐내어 제몫 이상으로 갖다
hog'sback : n,=hogback
hog's leg : x,=revolver
hogan : n,호건(북미의 Navaho인디언의 진흙과 가지,떼로 덮은 주거)
hogback : n,돈배구(양쪽편이 가파르고 양끝의 경사가 완만한 구릉)
hog cholera : x,돼지 콜레라
hogfish : n,놀래기(서인도 제도와 플로리다 근해산의 식용어),돼지 모양의 물고기(pigfish등)
hog flu : x,돼지의 유행성 감기
hogger : n,(철도)기관사
hoggery : n,양돈장,돼지 우리,돼지떼,돼지 같은 행동
hogget : n,생후 1년의 양(망아지),두살짜리 수퇘지
hoggin : n,(체질한)모래 섞인 자갈(도로용)
hoggish : a,돼지같은,주접스러운
hoghead : n,=hogger
hogling : n,새끼 양
Hogmanay : n,섣달 그믐날의 축하(파티,선물)
hogmane : n,(말의)짧게 자른 갈기
hogmaned : a,갈기를 짧게 자른
hognose snake : x,(북미산의) 독 없는 뱀의 일종
hognut : n,낙화생,땅콩
hogpen : n,돼지 우리
hogshead : n,큰통,액량단위,(미국 63갤런,영국 52.5갤런)
hogtie : v,...의 네발을 한데 묶다,...의 자유를 빼앗다
hogwash : n,돼지먹이(부엌 찌꺼기),너절한 것
hogwild : a,몹시 흥분한
Hohenstaufed : n,호엔슈타우펜(12-13세기의 독일의 왕가)
Hohenzollern : n,호엔촐레른가(의 사람)(1871-1918년 독일을 지배한 왕가)
hoho : int,오오,놀람,조소의 소리
hohum : int,a,(의성어)아아(하품 소리),따분한
hoick : vt,vi,int,훌쩍 들어올리다,(비행기가)급각도로 올라가다,=hoik,hoicks
hoicks : int,쉿!(사냥개를 부추기는 소리)
hoiden : n,=HOYDEN
hoi polloi : x,민중
hoise : vt,들어 올리다
hoist : vt,n,(기 따위를)내걸다,올리다,들어 올리다,끌어(감아) 올리기,기중기
hoist : vt,n,폐어 hoise의 과거분사,~ with one's own petard 제손으로 장치한 지뢰에 날리어(함정에 빠져)
hoisting shears : x,합장 기중기
hoistway : n,(화물을 올리고 내리는)승강구,승강기의 통로
hoitytoity : int,거참,아니,어이없군,거만한,경박한,까불어대는
hoke : vt,n,속이다,=hokum
hokey : a,진부한,지나치게 감상적인,짐짓 꾸민,속임수의
hokeypokey : n,값싼 아이스크림,요술,속임수
hokum : n,(영화,연극 연설 따위에서) 되는 대로의 저속한 대사(연기)
hol : n,=hols
HOLC : x,Home Owners' Loan Corporation
hold : vt,(손에)갖고있다,쥐다,잡다,안다,품다,소유(보유)하다,보류하다,(주의를) 끌다,수용하다
hold : n,쥐고 있다,유지(보존)하다,지탱하다,견디다,버티다,나아가다,효력이 있다,보유하다,~ by 굳게 지키다
hold : n,선창,화물실
holdall : n,여행용 옷가방,잡낭
holdback : n,장애물
holden : v,hold의 과거 분사
holder : n,소유자,hold 하는 물건
holdfast : n,고정시켜두는 기구
holding : n,보유,파지,유지,소유,토지,소유주,지주,(축구,농구 등의)홀딩(공을 너무 오래 갖고 있거나 상대를 방해하는 등의 반칙)
holding company : x,지주회사,모회사
holding paddock : x,(털을 깎기 전의 양,가축을 넣어두는)임시로 울막은 땅
holding pattern : x,(항공기의)대기 경로,착륙 차례를 기다리는 선회
holdout : n,(완고한)저항,인내,협조(타협)를 거부하는 사람
holdover : n,이월,잔존물,잔류자,낙제자,재수생
hold time : x,(로켓,미사일 발사시의 초읽기,작업 등의)일시적 중단(대기)
holdup : n,노상강도,교통의 정체
hole : n,구멍,굴,틈,토굴 감옥(과 같은 장소),결점,궁지,구멍,구멍을 뚫다
holeandcorner : a,비밀의,차찮은
hole card : x,(카드 놀이의)최후 수단의 패,비장의 수
holeinthewal : n,a, 답답한 장소,게딱지 같은 집,답답한,게딱지 같은
holeproof : a,(천이)구멍이 나지 않는,(법이)빠져나갈 구멍이 없는
hole puncher : x,펀처(종이에 구멍 뚫는 사무용구
Holesm : n,Sherlock 영국 소설가 Arthur Conam Doyle의 작품중의 명탐정,명탐정
holey : a,구멍투성이의
holibut : n,=halibut
holic : x,(연결형)(~중독자)의 뜻
holiday : n,휴일,공휴일,축일,~ clothes 나들이 옷
holiday camp : x,(해변의)휴가용 캠프장,행락지
holidayer : n,휴일(휴가)을 즐기는 사람(holidaymaker)
holidaymaker : n,휴일을 즐기는 사람,시끄럽고 저속한 유람객
holidaymaking : n,휴일의 행락
holierthanthou : a,n,짐짓 체하는,독선적인 사람,군자연하는
holily : ad,신성하게,경건하게
holiness : n,신성
holism : n,전체론
holistic : a,전체론의
holla : int,n,vi,어어이!(하고 외치다)
Holland : n,내덜란드(the Netherlands),~er 네덜란드 사람
hollandaise sauce : x,네덜란드 소스(크림 모양)
Hollander : n,네덜란드 사람(선박)(Dutchman)
Holland gin : n,네덜란드산의 진 술
Hollands : n,네덜란드 진
holler : vi,vt,외치다,큰소리로 부르다
Hollerith : n,(발명자인 미국의 기사명예서)펀치카드를 사용하는 알파벳,숫자 코드
hollo : int,n,vi,vt,어이!,이봐!(주의,응답하는 소리),(특히 사냥에서)hollo!라고 외침,큰소리로 외치다,(사냥개를)야단치다
hollow : n,a,ad,vi,vt,골짜기,구멍,우묵한 곳,우묵 들어가다,도려내다,우묵 들어간,속이 텅빈,힘없는,거짓의,공허한
holloware : n,=hollowware
Holloway : n,홀러웨이 교도소(여자 미결수를 수용)
holloweyed : a,눈이 우묵한
hollow foot : x,발바닥이 우묵한 발
hollowhearted : a,빈말의,불성실한
hollow leg : x,먹어도 살이 찌지 않는 체질,술 많이 마시는 사람
hollow wall : n,=cavity wall
hollowware : n,(도자기,은제 등의)오목한 그릇(접시,냄비)
holly : n,호랑가시나무(의 잎과 열매)(크리마스 장식용)
hollyhock : n,접시꽃
hollywood : n,Los Angeles시의 한 지구,헐리우드,영화의 도시
Hollywood Bowl : x,(자연 지형을 살린)할리우드의 원형 극장
holm : n,강 가운데 있는 섬,강섬,너도밤나무 무리의 일종
Holmes : n,홈스(영국의 소설가 Conan Doyle의 작품 중의 명탐정)(일반적으로)명탐정
holmium : n,홀뮴 (회유 금속원소,기호 Ho)
holm oak : x,털가시나무
holocaine : n,홀로카인 (안과용 국소마취제)
holocaust : n,(유대인 등이 짐승을 통째로 구워서 신에게 바침)희생,대희생,대학살
Holocene : a,완신세의
holocrine : a,(완)전분비의
hologram : n,holography에 의해 기록된 간섭도형
holograph : n,자필의 문서
holography : n,홀로그래피 (레이저 광선에 의한 입체 사진술)
holohedral : a,(결정이)완전면의
holon : n,홀론(보다 큰 전체 중의 하나의 전체),생물과 환경의 종합체(biotic whole)
holophote : n,완전 조광경(등대 등의 전광 반사 장치)
holophrastic : a,일어문적인,(언어가)포합적인
holoscopic : a,종합적인 관찰에 기초를 둔
holothurian : n,a,해삼 무리(의)
holp : v,help의 과거
holpen : v,help의 과거분사
hols : n,휴가,방학(holidays)
Holstein : n,홀스타인(젖소)
holster : n,(가죽제) 권총 케이스
holt : n,잡목 숲,야산,짐승의 굴,수달의 굴
holusbolus : ad,단숨에,순식간에,(송두리째)꿀꺽
holy : a,신성한,거룩한,성인 같은,~ of holies (유대전의) 지성소
Holy Alliance : x,신성동맹(1815년)
Holy Bible : x,성서
holy bresd : x,성찬식(미사)용 빵
Holy City : x,성도
Holy Communiom : x,성찬식,영성체
Holy Cross Day : x,성 십자가 찬미의 날(9월 14일)
Holy Day : x,종교 상의 축제일
Holy Family : x,성가족(성모 마리아의 팔에 안긴 어린 예수,요셉,어린 성요한 등을 표현한 그림,조각)
Holy Father : x,교황(의 존칭)
Holy Ghost : x,성신(Trinity의 제 3의)
Holy Grail : x,GRIAL
Holy Innocent's Day : x,무죄한 어린이들의 순교 축일(Herod왕명으로 Bethlehem의 갓난 아이가 살해된 기념일(12월 28일)
Holy Joe : x,군목,독실한 신자
Holy Land : x,성지
Holy Mother : x,성모(마리아)
holy name : x,성명(예수의)
Holy Office : x,검사성성,종교재판소
Holy One : x,예수그리스도,구세주,천주
holy orders : x,성직
holy place : x,성지,(유대교 신전의)성소
Holy Roller : x,열광적인 종파의 신자(특히 오순절파의)
Holy Roman Empire : x,신성 로마 제국
Holy Rood : x,성십자가,성가,(일반적으로)십자가
Holy Saturday : x,성 토요일(부활절 전주의 토요일)
Holy Scriptures : x,성서
Holy See : x,성좌,교황청
Holy Sepulcher : x,(그리스도가 부활할 때까지 누워 있었던)성묘
Holy Spirit : x,성령(Holy Ghost)
holystone : n,vi,vt,닦음돌(로 갑판을 닦다)
Holy Synod : x,주교회의
holy terror : x,무서운 사람(것),골칫거리(아이),망나니
Holy Thursday : x,승천 축일,성목요일(부활절 전주의 목요일)
holy war : x,성전(십자군의 원정 등)
holy water : x, 성수,(불교의)정안수
Holy Week : x,부활절의 전주
Holy Willie : x,가짜 신앙가
Holy Writ : x,성서
hom : x,(연결형)동일의 뜻,=homo-
homage : n,존경,복종,신종의 예,do(pay) ~ to ...에게 경의를 표하다
hombre : n,사나이,놈,사람(man)
homburg : n,테가 좁은 중절모자의 일종
home : n,집,가정,본국,고향,안식처,결승점,수용소,요양소,from	~ 부재하여
home : a,가정의,자기나라의,중심을 찌르는,통렬한
home : vi,vt,집으로,고향으로,급소를 찔러서,따끔하게,bring ~ to 절실히 느끼게 하다,a
home : vi,vt,귀가하다,보금자리고 돌아가다,(비행기,미시일 따위가) 유도되다,(미사일 따위를) 자동제어로 유도하다,가정을 갖다,집을 주다
home affairs : x,내정,내무
home automation : x,가정 생활면의 자동화
home banking : x,홈뱅킹(가정의 단말기가 은행 창구 역할을 하여 대체,지급,예금이 가능)
home base : x,본루
homebeat : n,(경찰의)자택 주변의 순찰(담당)구역
homebody : n,주로 집에 들어박혀 있는 사람,가정적인 사람(stayathome)
homeborn : a,본국에서난,본토박이의(native)
homebound : a,본국행(귀한)의,귀항의,집에 들어박힌
homebred : a,제 집에서 자란,조잡한,순진한,국산의
homebrew : n,a,자가 양조 음료,~ed 
homebrewed : a,n,자가 양조의(술)
homebuilder : n,주택 건설업자
homebuilding : n,주택 건설
home care : x,자택 요양(치료)
Home Circuit : x,런던을 중심으로 한 순회 재판구
homecoming : n,귀가,귀향,(대학 등에서 1년에 한번 여는) 동창회
home computer : x,가정용 컴퓨터
home cooking : x,가정 요리(의),만족 시키는(일),즐거운 (일)
Home Counties : x,런던 주변의 여러주
Home Department : x,내무성
home ec : x,=home economics
home economics : x,가정학
home economist : x,가정학자
home farm : x,(대지주의)자작 농장
homefelt : a,가슴에 사무치는
home fire : x,벽난로의 불,가정(생활)
home folks : x,고향 사람들(특히 일가 친척)
home free : x,성공(승리)이 틀림 없는,낙승의
home fries : x,삶은(날)감자 조각을 튀긴 것(=home fried potatoes)
home front : x,(전시의)후방,국내 전선,(집합적)후방의 국민
home ground : x,홈그라운드(팀 소재지의 경기장),본거지
homegrown : a,본토(본국)산의
Home Guard : x,국방 의용병,향토 방위대원
home health : x,가정 건강,가정 보건
home help : x,가정부,파출부(환자,노인의 가정을 방문하느 관급 여성)
home industry : x,가내공업
homekeeper : n,집 안에 들어박혀 있기를 좋아하는 사람
homekeeping : a,집안에만 틀어박혀 있는
homeland : n,고국,본국
homeless : a,집없는
homelike : a,마음편한
home loan : x,주택 융자
homely : a,가정의,가정적인,검소한,수수한,꾸밈없는,평범한,얼굴이 못생긴
homemade : a,손으로 만든,집에서 만든,국산의
homemaker : n,주부
homemaking : x,가사,가정,가정과(학과)
Home Minister : x,내무부장관
home movie : x,자가 제작 영화
Home Office : x,(영)내무부;본사,본점
homeopath : n,동종요법의사
homeopathic : a,동종요법의
homeopathist : n,동종요법의사
homeopathy : n,동종요법
homeoplate : x,=HOME BASE
homeostasis : n,항상성(신체 내부의 체온.화학적 성분등이 평형을 유지 조절되는 일
homeowner : n,자기집을
home plate : x,본루
home port : x,모항,(선박의)소속항
homeport : vt, (함선의)모항을 설정하다
home question : x,급소를 찌른 질문
Homer : n,호머,호메로스(기원전 10세기경의 그리스 서사시인)
Homer : x,홈런,전서비둘기
home range : x,(정주성동물의)행동권
Homeric : x,호모풍의
Homeric laughter : x,참을 수 없는 홍소,가가대소
home room : x,홈룸
homeroom : n,홈룸(학급 전원이 모이는 생활 지도 교실(시간)
home rule : x,지방 자치
home rule : x,내정(지방)자치,(영)아일랜드의 자치(문제)
home run : x,홈런
home run : x,홈런(homer)본루타
home schooling : x,자택 학습
home screen : x,(미)텔레비전
home secretary : x,내무대신,내상
Home Secretary : x,(영)내무장관(대신)
home selling : x,방문판매
homesick : x,회향병의,홈식에 걸린
homesickness : n,향수
home signal : x,장내 신호기(역구내 진입 여부를 알림)
homesite : n,(집의)대지
homespun : a,n,손으로 짠,평범한,조야한,손으로 짠 직물
home stand : x,본거지 구장에서의 일련의 시합
homestay : n,(미)홈스테이(외국 유학생이 일반 가정에서 지내기)
homestead : n,(농가의)집과 부속지 (밭을 포함해서),(이민에게 분양되는) 자작농장
homestead Act : x,(미)홈스테드법(서부 입주자에게 공유지를 불하하기로 한 1862년의 입법)
homesteader : n,(미)홈스테드법에 의한 입식자;homestead의 소유자
homesteading : n,(미)도시입식(정책)
homestead law : x,(미)가산 차압 면제법;HOMESTEAD ACT
home straight : x,(영)HOMESTRETCH
homestretch : n,(결승점 전의)직선코스,마지막부분
home study : x,통신교육
home study : x,(통신 교육에서의)자택 학습;(미)(양부모로서의 적부를 알아보는)가정조사
home terminal : x,가정용 단말기
home thrust : x,(무기로)급소를 찌르기;아픈데를 찔림
hometown : a,n,고향의 도시(의),살아서 정든 도시(의)
home truth : x,결점,약점
home truth : x,괘씸한(불쾌한)사실;명백한 사실의 진술
homeward : a,ad,귀로의,집으로,본국으로 향해서,~s ad
homewardbound : a,본국행의(을 향하는),귀항중의
homewards : ad,=HOMEWARD
homework : n,숙제,예습,복습,집안일,가내공업,(회의 등을 위한)사전 조사
homey : a,가정적인,아늑한
homicide : n,살인,살인자
homiletic : a,설교의
homiletics : n,설교학
homilist : n,설교사
homily : n,설교
homing : a,귀성소의
homing device : x,(유도탄의)자동 유도(지향)장치
homing instinct : x,귀가(귀소) 본능
homing pigeon : x,전서 비둘기
homing torpedo : x,자동 유도 어뢰
hominid : n,사람과의 동물(현대 인간과 모든 원시 인류)
hominization : n,인간화;인간성 부여
hominized : a,인간화
hominoid : a,n,사람(인류)비슷한 (동물)
hominy : n,묽게 탄 옥수수(죽)
hominy grits : x,(미)곱게 간 옥수수
homish : a,=HOMEY
homme : n,사람
homo : n,사람
homo : x,같은,동일의 뜻의 결합사
homocentric : a,같은 중심을 가진,동심의
homochromatic : a,단색의
homoeopathy : n,= HOMEOPATHY
Homo erectus : n,직립원인
homoerotic : a,동성애적인
homogamy : n,동형 배우자 생식,암수동숙
homogeneity : n,동종 동질(성);동차성
homogeneous : a,동종의,동질,동성의
homogenesis : n,순계 발생
homogenize : vt,균질화하다
homograft : n,동종이식편
homograph : n,동형 이의어
homography : n,일자 일음주의의 철자법
Homo habilis : n,호모하빌리스(최초로 도구를 만든 것으로 보이는 약 200만년전의 사람
homolog : n,=HOMOLOGUE
homologate : vt,승인하다
homologize : vt,(성질.위치 등이 각각)대응(상응)하다,일치하다
homologous : a,상응하는,일치하는
homologous chromosomes : x,상동염색체
homologue : n,상동물(기관)등;동족체
homology : n,상동,상응
homolosine projection : x,호몰로신 도법
homomorphism : n,이체 동형,동형 완전화를 가짐
homonym : n,동음 이의어
homonymic : x,동음 이의어의;동명의
homonymous : a,동음(형)이의어의
homonymy : n,동음9형)이의,동명 이물
homophile : n,a,동성애자,동성애자를 옹호하는
homophobia : n,동성애 공포증
homophone : n,동음 이자
homophonic : a,동음의;호모포니의
homophony : n,동음(성);동음적 가창,단음(단선율)적 가곡
homopolypeptide : n,단일 누클레오티드의 중합체
homopolypeptide : n,단일 펩티드가 연쇄한 것
homopterous : a,동시류의
homo sap : x,(익살.완곡)바보,얼간이
homo sapiens : x,(= wise man) 인류
Homo sapiens : n,사람(현세인)인류
homosex : n,동성애
homosexual : a,n,동성애의,동성애의 사람
homosexuality : n,동성애의 사람
homosphere : n,동질권(지상 90km까지)
homotaxis : n,(시대가 다른 화석.지층사이의)유사 배열
homotype : n,상동기관
homozygote : n,동질(호모)접합체
homuncule : n,나나쟁이,해부 실험용 인체모형
homy : a,=HOMEY
Hon : x,hon,Hono(u)r,Hono(u)rable,Honorary
Honduras : n,중앙 아메리카의 공화국
Honduras : n,a,중앙 아메리카의 공화국의 (사람)
hone : n,vt,면도날 숫돌,숫돌로 갈다
honest : a,정직한,성실한,(술,우유따위)진짜의,섞지않은
Honest Abe : x,Abraham lincoln의 애칭
honest broker : x, (국제 분쟁.기업간의 분쟁의)중재인,공정한 중재인
honest Injun : x,정직하게 말해서,정말로
honest Joe : x,성실한 사람
honest John : x,원자 로켓포의 일종
honestly : ad,정직하게,성실하게
honesttoGod : a,진짜의,정말의
honesty : n,정직,성실,솔직
honey : n,a,vi,벌꿀,화밀,감미로운,정다운 말을 하다,발림말하다
honey bag : x,=HONEY SAC
honey bear : x,=KINKAJOU;SLOTH BEAR
honeybee : n,꿀벌
honey bucket : x,(미)똥통
honeybunch : n,애인 귀여운 사람(사랑하는 사이의 호칭)
honey buzzard : n,(꿀)벌집;벌집 모양의 것(반추 동물의)벌집위
honeycomb : n,vi,vt,꿀벌의 집,벌집 모양으로 만들다,구멍투성이로 만들다,침식하다,위태롭게 하다
honeycombed : a,벌집 모양의;벌집 모양이 된,구멍투성이가 된
honeycreeper : n,꿀먹이새(꿀을 먹는 연작류의 새)
honeydew : n,(잎.줄기에서 나오는)단물;(진디 등이 분비하는)꿀
honey eater : x, 꿀빨이새(남태평양산)
honeyed : n,달콤한,간살스러운,꿀로 달게하다
honey guide : x,꿀잡이새(동작이나 울음 소리로 벌꿀이 있는 곳을 알림)
honey locust : x,(북미산)쥐엄나무
honey locust : x,수엽나무 무리(북미산)
honeymoon : n,vi,신혼여행(을 하다),밀월(결혼 후의 1개월)(을 보내다),이상하게 친밀한 기간,협조관계
honeymoon bridge : x,둘이서 하는 브리지놀이
honeymoon period : x,(미)(대통령 취임후 약 3개월간의 호의를 받는)밀월 기간
honeymouthed : a,말을 잘 꾸며 대는,말뿐인
honeypot : n,꿀단지;매력 있는 것(사람);(영)(여성의)성기
honey sac : x,(꿀벌의)꿀주머니
honey sucker : n, =HONEY EATER
honeysuckle : n,인동덩굴,인동덩굴의 무리
honeysweet : a,꿀같이 단
honeytongued : a,말 잘하는;능변의(eloquent)
honey wagon : x,쓰레기 트럭,분뇨 운반차;이동식 야외 변소
honeywort : n,지치과 풀의 일종 
hong : n,(중국의)상관,-양행
hongi : n,(마오리족의)서로 코를 맞대는 인사
HongKong : x,홍콩
Hong Kong dog : x,설사
Hong Kong flu : x,홍콩 독감
honied : a,=HONEYED
honk : vi,n,울다,기러기 우는 소리,경적을 울리다
honkie : n,(미.경멸)백인
honkytonk : n,a,저속한 카바레(댄스홀,나이트클럽),저속한(음악,레코드)
honolulu : n,하와이의주도
honor : n,명예,명성,명목,체면,자존심,염치심,정절,경의,고위,고관,예우,작위,훈장,서훈,의례
honor : n,vt,존경하다,명예를 주다,(어음을) 인수하고 지불하다
honora : n,여자 이름
honorable : a,존경할 만한,명예로운,수치를 아는,훌륭한,고귀한
honorable discharge : x,(미)명예제대(중)
honorable mention : x,선외 가작;선외 가작상,감투상
honorably : ad,명예롭게,훌륭하게
honorarium : n,사례금
honorary : a,명예상의,명예직의
honor box : x,(거리의)무인 신문 판매대
honored : a,명예로운,영광(명예)로 생각하여
honor guard : x,의장대
honorific : a,n,존경의,경칭,경어
honoris causa : a,명예를 위하여(위한)
honor roll : x,(초.중.고교의)우등생 명단;수상자 일람;재향 군인 명부
honor society : x,학업 성적 인정 위원회;우등생 사교 클럽
honor system : x,무감독 시험제도,(형무소의)무감시 제도
honour : n,honor과 동의어
honours course : x,(영)우등 졸업 학위 과정
honours degree : x,(영)우등 코스 졸업학위
honours list : x,(영)(국왕 탄생일,신년 등에 발표되는)서작(서훈)자 명단
hooch : n,주류,밀주,오두막집
hood : n,vt,두건(으로 가리다),덮개,덮개를 씌우다,뚜껑을 하다
Hood : x,Robin 전설적인 영국의 의적,활의 명수(12세기경)
hooded : a,두건을 씁,포장을 씌운
hooded crane : x,흑두루미
hooded crow : x,뿔까마귀(유럽산)
hoodie : n,(스코)=HOODED CROW
hoodlum : n,불량자,폭력단원,깡패,폭력배
hoodlum : n,불량자,갱
hoodmanblind : n,=BLINDMAN'S BUFF
hoodmold(ing)[h'udm`ould(i7)=DRIPSTONE
hoodoo : n,불운한,불길한 물건
hoodwink : vt,눈을 가리다,속이다
hooey : n,int,허튼 소리(짓),바보 같은!
hoof : n,vi,vt,(발)굽,걷다,춤추다,발굽으로 차다,ont the ~ 살아서
hoofandmouth disease : x,=FOOTANDMOUTR DISEASE
hoofbeat : n,발굽소리
hoofed : a,발굽 있는
hoofer : n,도보 여행자;(미)직업 댄서
hoofpad : n,발굽 받이
hoofpick : n,쇠 주걱(발굽에 박힌 돌등을 후벼 내는 도구)
hoofprint : n,발굽 자국
hoofrot : n,발굽이 썩는 병
hooha : n,int,소란,시끄러움,와아,떠드는 소리
hook : vt,vi,갈고리,훅,걸쇠,낚시,코바늘,갈고리 모양의 곶,(하천의)굴곡부
hooka : n,수연통,물담뱃대
hookah,hooka : dn,수연통
hookandladder truck : x,사닥다리 소방차
hooked : a,갈고리 모양의,훅이 달린,마약 중독의
hooked rug : x,황마천 등에 털실이나 천조각으로 자수한 융단
hooked schwa : x,훅트시와(발음 기호)의 명칭,이 사전의(5~r,에 해당
hooker : n,도둑,사기꾼,독한술,매춘부,후커,네덜란드의 두대박이 어선,영국의 외대박이 어선,구식의 볼품없는 배
hookey : x,=HOOKY
hooknose : n,매부리코(hooked nose)
hooknosed : a,매부리코의
hook order : x,소의 사회 서열(소의 사회에서 약자를 뿔로 받고 강자에게 받히는 일정한 순위)
hookpin : n,대가리가 갈고리 모양의 못
hook slide : x,훅 슬라이드(몸을 전면으로 내던지듯하여 터치를 피하는 슬라이딩)
hookup : n,배선,중계,배선도,접속도
hookworm : n,십이지장충
hook wrench : (spanner)대가리가 갈고리 모양인 나사 돌리게
hooky : a,갈고리의,갈고리 같은,학교를 빼먹음 play ~ 학교를 빼먹다
hooligan : n,깡패,불량자
hoop : n,vt,테,굴렁쇠,(스커트 폭을 벌어지게 하는)버팀테,(체조용의) 후프,기둥문,고생하다
hooped : a,테두리를 한;권대를 감은;테 살대로 버틴;둥글게 굽은
hoopee : n,=WHOOPEE
hooper : n,통장이
hooper rating : x,청취율 순위
hooping cough : x,=WHOOPING COUGH
hoop iron : x,(통 등의) 쇠테
hoopla : n,고리던지기놀이,대소동,과대선전
hoopman : n,농구선수
hoopoe : n,후투티
hoop skirt : x,버팀살대로 퍼지게 한 스커트
hoop snake : x,미국 남부산 독사의 일종
hoopster : n,농구선수,훌라후프를 돌리는 사람
hooray : int,n,v,=HURAH
hoosegow : n,교도소
hoosegow,hoos : n,(미)교도소;옥외 변소
hoosh : n,진한 수프,잡탕 찌개
hoosier : n,Indiana주의 사람,촌놈
Hoosier State : x,Indiana주의 속칭
hoot : vi,vt,n,야유하다(하는 소리),(올빼미가) 부엉부엉울다(우는 소리),조금
hootch : n,(미)=HOOCH
hootchykootchy : n,(미)벨리 댄스
hootenanny : n,청중이 참가하는 포크송 집회,아무것,거시기(기계 장치 등의 정확한 명칭을 모를 때 쓰임)
hooter : n,야유,올빼미,기적,호적(자동차 등의)경적,(영)코
hoot owl : x,(울음소리가 큰 각종)올빼미,(미)(광산.공장의)심야 근무
hoots : x,=HOOT
hoove : n, 고창증(가축의 위가 가스로 부풀어 오르는 병
hoover : n,vt,진공청소기(로 청소하다)
Hoover : n,Herber Clark(1874~1964) 미국의 31대 대통령(1923~1933)
Hoover Dam : n,후버 댐(미국 콜로라도강 상류를 막음;1936년 완성)
Hooverville : n,(미)1930년대 불경기 때의)실업자 수용 주택(지구)
hooves : n,HOOF의 복수
hop : vi,n,vt,뛰다,춤추다,이륙하다,앙감질,도약,홉,마약,아편,홉 열매를 따다
hop back : x,홉 거르는 통(끓인 맥아즙에서 홉을 거르는)
hopbine : n,홉 덩굴
hope : n,vt,희망,기대,유망한 사람,호프,희망하다,바라다,~ against ~ 만일을 바라다,~ for the best 낙관하다,I ~ not ...은 아니라고 생각한다
hope chest : x,처녀의 혼수감 함
hopeful : a,유망한,young ~ 장래가 촉망되는 청년
hopefully : ad,희망을 가지고,유망하게,(문장 전체를 수식하여)잘만 되면,아마
hopeless : a,희망없는,가망없는,절감의
hopelessly : ad,절망하여,가망없이
hopelessness : n,가망없음,절망 상태
hopely : ad,희망으로
hopeness : n,희망
hop field : x,=HOP-GARDEN
hop fly : x,홉 진딧물
hopgarden : n,(영)홉 재배원
hophead : n,마약중독자
Hopi : n,호피족;호피 말
hop Kiln : x,홉 건조로(건조소)
hoplite : n,(옛그리스)장갑 보병
hopomythumb : n,난쟁이
hoppedup : a,흥분한;흥분시키는,(자동차 등이)마력을 높인,마약을 사용한
hopper : n,(껑충)뛰는 사람(벌레),큰 깔대기 모양의 투입구,캥거루,홉을하는 사람
hopper car : x,호퍼차,개저식
hoppicker : n,홉 따는 사람(기계
hop pillow : n,홉 베개(안면)에 도움이 된다고 함
hopping : n,홉 따기(채집);홉의 쓴맛 조미
hopping : a,깡충 뛰는;여기저기 돌아다니는,절름발이의,바삐 움직이게(뛰어다니게)해두다
hoppin John : x,(미)쌀 완두가 든 베이컨 스튜
hopple : vt,(말등의)두 발을 묶다,-에 족쇄를 채우다;-의 자유를 방해하다
hop pocket : x,홉 자루(76kg)
hop pole : x,홉 지주;키다리
hoppy : a,홉(hop)맛이 나는;흡이 풍부한,마약중독자
hopsacking : n,거칠게 짠 포대천
hopscotch : n,오럇말놀이
hopster : n,댄서;아편상용자
hopup : n,흥분제,각서
hopvine : n,홉 덩굴;홉나무
hopyard : n,홉 밭
hora : n,루마니아.이스라엘의 원무
Horace : n,호라티우스(로마의 서정 시인)
horal : a,시간의(에 관한);시간마다의
horary : a,시간의(을 나타내는)1시간의;1시간 마다의
Horatian : a,호라티우스(풍)의
Horatio : n,남자 이름
Horatius : n,호라티우스-(로마 전설의 영웅)
horde : n,유목민의 무리,군중,큰 무리
Horeb : n,호렙산(모세가 율법을 받은 산;보통 Sinai와 동일시됨
horehound : n,(유럽산의 )쓴 박하(에서 얻은 기침약)
horizon : n,수평선,지평선,한계,범위,시계,enlarge one's ~ 안목을 넓히다
horizontal : a,지평선의,수평의,가로의,평평한,지평선,수평선,수평위치
horizontal bar : x,(기계 체조의)철봉
horizontal bombing : x,수평 폭격
horizontal divestiture : x,수평박탈(한 회사가 유시 제품을 생산하는 다른 사업이나 회사의 지주를 처분하는 일
horizontal engine : x,수평 엔진
horizontal integration : x,수평적 통합(동일 업종간의 통합)
horizontal international specialization : x,수평적 국제 분업( 선진국끼리의 공업 제품의 무역)
horizontal line : x,지평(수평)선
horizontal mobility : x,수평 이동(동일한 사회 계층내에서의 전직이나 문화의 확산 등)
horizontal parallax : x,(천체 관측 상의)지평 시차
horizontal pricefixing : x,수평적 가격 유지(가격 경쟁을 피하기 위한 가격 협정
horizontal publication : x,일반 잡지
horizontal rudder : x,수평 키,승강키
horizontal stabilizer : x, =TAIL PLANE
horizontal union : x,작업별 조합
hormonal : a,호르몬의
hormone : n,호르몬
hormonize : vt,호르몬으로 처리하다(특히 화학적으로 거세하다)
hormonology : n, 호르몬학,내분비학
horn : n,뿔,촉각,촉수,뿔제품,뿔로 받다,뿔이 나다,주제넘게 나서다
hornbeam : n,서나무
hornbill : n,코뿔새
hornblende : n,각섬석
hornblowing : n,적극적(화려한)선전
hornbook : n,글자판,어린이에게 가르치던 예전의 글자판
Hornby : n,혼비(1898-1978)(영국의 영어 교육자,사전 편찬자)
horned : a,뿔이 있는
hornedhorse : n,=GNU
horned moon : x,초승달
hornedness : n,뿔,뿔모양
horned owl : x,부엉이
horned pout : x,메기
horned toad : x,도마뱀의 일종,=horned lizard
horner : n,뿔 세공인,뿔나팔(뿔피리,호른)부는 사람,아편쟁이
hornet : n,말벌의 일종,귀찮은 사람,성가ㅈ신 사람,심술쟁이
hornfish : n,동갈치(garfish),실고기(pipe fish),꽁치아재비
hornful : n,뿔잔 한 잔(가득)
Horniman Museum : x,호니만 박물관(런던에 있음)
horniness : n,각질,경질
hornist : n,각적 연구자
hornless : a,뿔 없는(축음기 등)나팔 없는
hornlike : a,뿔 같은,뿔 모양의
hornmad : a,뿔로 받을 만큼 성이 난,격노한
Horn of Africa : x,아프리카의 뿔(아프리카 북도부의 돌출부에 대한 속칭)
Horn of Africa : n,아프리카의 뿔(아프리카 대륙 북동부,소말리아 공화국과 그 인근 지역
hornpipe : n,(옛 웨일즈의) 나무피리
hornpout : n,=horned pout
hornrimmed : a,(안경 등이)테가 플라스틱(별갑,뿔)제인
hornstone : n,각암
hornswoggle : vt,속이다
hornwork : n,뿔 세공,뿔 세공품,각제품,각보
hornwort : n,붕어마름
horny : a,뿔의,뿔있는,각질의,단단한,호색의
horny hand : x,피부가 두꺼워진 손
horol : n,horologe,horology
horologe : n,시계
horologer : n,시계 연구가,시계공
horologic : a,시계의,시계학상의,=horological
horology : n,시계학,시계 제조술
horoscope : n,점성,탄생시의 별 위치,천궁도,12궁도
horoscopic : a,천궁도의,성위상의,점성의
horoscopy : n,점성(술),운성의 상
horrendous : n,무서운
horrent : a,곤두선,소름 끼치는,오싹하는
horrible : a,무서운,심한,지겨운
horribly : ad,무섭게
horrid : a,무서운
horrific : a,무서운,소름끼칠듯한
horrifically : ad,무서워서,소름끼치는
horrified : a,겁에 질린,충격 받은,공포를 나타내는(수반하는)
horrify : vt,무섭게 하다,소름끼치게 하다
horrifying : a,무서운,소름끼치는
horripilation : n,소름끼침,소름(goose flesh)
horror : n,a,공포,염오,무서운것,열등품,소름끼치게하는
horror comic : x,공포 만화
horror fiction : x,공포 소설
horror film : x,공포 영화
horrorstricken : a,공포에 질린
horrostruck : a,공포에 질린
hors : ad,prep,~의 밖(외부에)(outside)
hors concours : a,(출품작이)심사 외의,무심사의
hors d'oeuvre : n,오르되브르,전채(수프 전에 나오는 가벼운 요리
hors de combat : a,ad 전투력을 잃은(잃고)
horse : n,말,기병,목마,안마,다리가 있는 물건걸이,발판
horse : vi,vt,말을 달다,혹사하다,승마하다,암내나다
horse's ass : x,멍텅구리,아둔한 사람,쓸모없는 사람
horseandbuggy : a,케케묵은
horseback : n,말의 등
horseback riding : x,승마
horsebean : n,(말의 사료로 쓰는) 잠두콩
horse block : x,승마용 디딤대
horse boat : x,말,마차를 나르는 나룻배,말로 끄는 배
horse box : x,말 운반용 화차
horseboy : n,마구간의 조수,마부
horsebreaker : n,조마사
horsebreaking : n,조교,조마
horsecar : n,철도 마차,말 운반자
horse chestnut : x,마로니에
horsecloth : n,말에 입히는 옷
horsecollar : n,말의 목사리,무득점
horse coper : x,(부정한 일도 가리지 않는)말장수,마도위
horse doctor : x,마의,수의,돌팔이 의사
horsefaced : a,말상의,얼굴이 긴
horsefair : n,마시장
horsefeathers : n,sing,pl,난센스,허튼 소리
horseflesh : n,말고기
horse fly : x,등에,말파리
horsefoot : n,머위,참게
horse guards : x,근위기병
horsehair : n,말총(갈기 및 꼬리),마소직
horsehide : n,말가죽
horsehoof : n,머위
horse latitudes : x,(대서양의) 무풍대
horselaugh : n,(특히 조소적인) 너털웃음
horseleech : n,말거머리,욕심쟁이,착취자,마의(horse doctor)
horseless : a,말없는,말이 필요 없는
horseless carriage : x, (구식)자동차
horse letter : x,말가마(두필의 말 사이에 다는)
horse mackerel : x,다랑어(tunny),전갱이
horseman : n,승마자,기수,기병,마술가
horsemanship : n,마술
horse marine : x,말탄 해군,부적격자,Tell that to the ~ ! 그 바보 같은 소리 좀 그만둬!
horsemaster : x,조마사,말(마차)세주는 사람
horsemeat : n,말고기
horse mushroom : x,말버섯(식용)
horsenapping : n,경주마 도둑(질)
horse opera : x,서부 영화
horse parlor : x,마권 매장
horseplay : n,vi,야단법석(하다)
horseplayer : n,경마광
horse plstol : x,마상용 대형 피스톨
horsepong : n,말에게 물을 먹이거나 씻기는 작은 못
horsepower : n,마력
horsepox : n,마두
horse race : x,경마
horse racing : n,경마
horseradish : n,양고추냉이
horse rake : x,말써레
horse sense : x,상식
horseshit : n,int,말똥,허튼소리,난센스,당찮은!,거짓말!
horseshoe : n,vi,편자,편자를 박다
horseshoe : n,편자,말편자,편자 모양의 것,U자형의 것,=horseshoe crab,편자 던지기(놀이)
horseshoe : vt,편자를 대다
horseshoe crab : x,참게(king crab)
Horseshoe Falls : x,나이아가라 폭포(Niagara Falls)의 캐나다쪽 폭포
horseshoe magnet : x,말굽 자석
horseshoer : n,편자공
horsetail : n,말꼬리,속새
horse trade : x,마시장,빈틈없는 거래,정치적 흥정
horsetrade : vi,빈틈없이 거래(흥정)하다
horse trader : x,(거래에)빈틈없는 사람,흥정잘하는 사람,말 매매인
horse trading : x,말의 매매,빈틈없는 흥정
horsetrading : n,사기
horse trailor : x,마필 운송용 트레일러
horseweed : n,쥐꼬리망초
horsewhip : n,vt,말채찍,말채찍으로 치다,징계하다
horsewoman : n,여자기수
horsey : a,말의,말같은,말을 좋아하는,기수 같은
horsily : ad,말을 좋아하여,경마에 미쳐서,기수답게
horsing : n,a,승마 공급,단독교정,(암말이)교미기의
hort, : x,horticultural,horticulture
hortation : n,권고,장려,격려
hortative : a,권고의,충고의
hortatory : a,=hortative
horticultural : a,원예(상)의
horticulture : n,원예(술)
horticulturist : n,원예가
hortus siccus : x,식물표본(집),압엽 표본,하찮은 사실등의 수집
Horus : n,(이집트신)호루스(매의 모습(머리)을 한 태양신)
Hos : x,Hosea
hosanna : int,n,호산나,하느님 예수님을 찬미하는 말
HO scale : x,HO축척(자동차,철도 모형의 축척)
hose : n,vt,긴양말,호스,긴 양말을 신기하다,호스로 물을 끼얹다
Hosea : n,호세아서(의 저서) (기원전 8세기의 히브리의 선지자
hose cart : x,(소방용) 호스 운반차
hoseman : n,(소방차의)호스 담당자
hosepipe : n,호스
hosereel : n,호스 감는 바퀴
hose tops : x,발 부분이 없는 긴 양말
hosier : n,(메리야스,양말 따위의) 양품상
hosiery : n,양품류,양품업
hosp : n,hospital
hospice : n,(종교 단체등이 경영하는) 숙박소
hospitable : a,극진한,따뜻하게 대접하는,기꺼이 받아들이는
hospitably : ad,극진하게,공손하게
hospital : n,병원
hospital bed : x,병원 침대(머리,동체,다리 부분의 높낮이 조절이 가능함)
hospital fever : x,발진티푸스
hospitalism : n,병원 제도,(특히)병원 설비의 비위생적 상태
hospitality : n,친절한 대접,환대,후대
hospitality industry : x,서비스업(호텔,식당업 등)
hospitality suite : x,(회사 등의)응접실,접객용 스위트(특별실)
hospitalization : n,병원 수용,입원 가료,입원 기간,입원 보험
hospitalize : n,입원시키다
hospitaller : n,종교적 자선 단체 회원,병원 부속 교회 목사(런던의),=Knight Hospitaler
hospital nurse : x,간호사(=trained nurse)
hospital orderly : x,위생병,간호병
hospital Saturday : x,병원 기부금 모집의 토요일(가두 등에서 함)
hospital ship : x,(전시 등의)병원선
Hospital Sunday : x,병원 기부금 모집의 일요일(교회에서 함)
hospodar : n,(터키 지배하의)태수,군주
hoss : n,말
host : n,(손님에 대하여) 주인,(여관의) (남자) 주인,(기생 생물의) 숙주,reckon(count) without one's ~ 제멋대로 치부(판단)하다
host : n,많은 떼,다수,군세,heavenly ~s,~(s) of heaven 하늘의 별,천사의 떼
hostage : n,볼모,저당,~ to fortune 언제 잃을지 모르는
host city : x,(경기 등의)개최 도시
host computer : x,(단말기,마이크로 컴퓨터를 거느린)호스트 컴퓨터,대용량 컴퓨터
hostel : n,호스텔,여행하는 청년들을 위한 숙박소
hosteler : n,호스텔 이용(경영)자
hostelry : n,여관
hostess : n,여주인,스튜어디스,여급,여주인
hostess gown : x,(여자의)접객용 가운
hostile : a,적의,적의 있는,적대하는
hostility : n,적의,적대,저항,전쟁상태
hostitiesonly : a,전시만의
hostler : n,마부
host plant : x,기주 식물
hot : a,뜨거운,더운,매운,강렬한,열렬한,열심인,격한,격렬한,호색적인,드릴에 찬,흥분시키는
hot : vi,vt,데우다,격화하다,속도를 더내다
hot air : x,잡담,허풍
hotair : a,열기의
hotair balloon : x,열기구
hot atom : x,방사성 원자
hot baby : x,정열적이며 섹시한 여자
hotbed : n,온상
hot blast : x,용광로에 불어 넣는 열풍
hotblooded : a,노하기 쉬운,뒤를 돌보지 않는,무모한,정열적인,(가축이)혈통이 좋은
hotbox : n,(철도 차량의)열축함,금방 달아오르는 여자
hotbrained : a,=HOTHEADed
hot cake : x,핫케이크,sell like ~s 날개 돋치듯 팔리다
hot cell : x,방사성 물질 처리용 차폐실
hotcha : n,a,매력적인,호차
Hotchkiss paperfastener : x,호치키스(stapler)(상표명)
hotchpot : n,재산병합(유언이 없는 경우 유산의 균등 분배를 위해 모든 재산을 그러모으는 일)
hotchpotch : n,잡탕찜,뒤범벅
hot cockles : x,눈가림하고 자기를 때린 사람을 알아맞히는 놀이
hot corner : x,3루수의 수비 위치
hot cross bun : x,십자가가 그려있는 빵
hot dog : x,핫도그
hotdog : vi,a,여봐란듯한 태도를 취하다,(서핑,스키,스케이트보드에서)곡예 같은 묘기를 보이다,(보란듯이)잘하는,뛰어난(스키어 등)
hotel : n,호텔,여관
hotel de ville : n,시청
hotel Dieu : n,(중세의)병원,(시립)병원
hotelier : n,=hotelkeeper
hotelkeeper : n,호텔경영자
hotelkeeping : n,호텔경영
hotelman : n,=hotelkeeper
hotel register : x,숙박자명부
hot flash : x,(폐경기의)일과성(전신)열감,=hot flush
hotfoot : ad,vi,부리나케,부리나케 가다
hotgospeler : n,몹시 열심인 복음 전도자
hothead : n,성급한사람,성급한,격하기 쉬운
hotheaded : a,성급한,성마른
hotheadly : ad,성급하게,성마르게
hothouse : n,온실,(도자기)건조실,매음굴,죄악의 온상
hothouse effect : x,=greenhouse effect
hot issue : x,인기 있는 신주
hot lab : x,(방사성 물질을 다루는) 원자핵 연구소
hot line : x,긴급 직통 전화선,미소 수뇌간의 직통 전용 텔레타이프선
hot liner : n,(캐나다)전화로 하는 시청자 참가 프로의 사회자
hotly : ad,뜨겁게,맹렬히,열렬히,열심히,흥분하여,골나서,노기를 띠고
hot mamma : x,=redhot mamma
hot money : x,핫머니(국제 금융시장에서 고리를 위해 이동하는 단기 자금),부정한 돈
hot mooner : x,월면 분화설 주장자
hotness : n,뜨거움,열심,열렬,격렬,격노,성급
hot news : x,(특히 센세이셔널한)최신 뉴스
hot number : x,최신의 인기 있는 것,정열적이고 섹시한 여자
hot pack : x,온습포,(통조림의)열간 처리법
hot pants : x,(여성용) 핫 팬츠
hot pepper : x,고추
hot plate : x,요리용 철판,전기풍로
hot pot : 소,양고기와 감자를 찐 요리n,
hot potato : x,난처한 상태,불쾌한 상태
hotpress : n,vt,가열압착기,가열 압착하다
hot rock : x,열암,무모한 항공기 조종사,거물(hot shot)
hot rod : x,쾌속차
hotrodder : n,운전자,폭주족,=hot rod
hot seat : x,전기의자,곤란한 입장
hot shoe : x,핫슈(카메라 상부의 플래시줄을 꽂는 부분),솜씨좋은 경주용차 운전자
hotshort : a,열에 약한
hotshot : n,소방수,수완가,급행 화물 열차
hot spot : x,분쟁 지역,환락가
hot spring : x,온천
hotspur : n,성급한 사람,격하기 쉬운 사람
hot stuff : x,정열가,정력가,대단한 것
hottempered : a,성미급한,성마른
hottentot : a,(남아프리카의)호텐토트 사람,미개인
hottie : n,탕파,=hotty
hot toddy : x,하토디(위스키에 레몬,설탕,더운물을 섞은 음료,추울 때 마심)
hot tray : x,요리 보온기(전자 가열 장치가 달린 접시)
hot tub : x,(집단 물리 요법,레크리에시션용 대형)온수 욕조(spa)
hot war : x,무전력,열전
hot water : x,더운물,뜨거운 물
hot water bag : x,탕파
hot water heating : x,온수 난방
hot water pollution : x,(원자력 발전소의 페수로 인한)열 오염(thermal pollution)
hot water system : x,스팀용 배관
hot well : x,=HOT SPRING,탕조(보일러에 되돌리기 전의 응축 증기를 모으는 곳)
hot wire : x,=hot spring,(기관의)온수 저장통
houdah : n,=howdah
hough : n,=hock
hound : n,vt,사냥개,비열한자,열중하는 사람,사냥개로 사냥하다,맹렬히 쫓다,follow the ~s or ride to ~s 사냥개를 전면에 세워 말타고 사냥하다
hound's tooth : x,개 이빨(톱니)모양의 격자무늬
hound dog : x,사냥개(hound),섹스만 생각하는 남자,여자 뒤꽁무니만 쫓아다니는 남자
houndfish : n,=dogfish
houndtongue : n,큰 꽃말이의 일종
hour : n,한시간,시각,시,영업시간,every ~ on the ~ 매시 정시 in an eril ~ 나쁜 때에
hour angle : x,시각(자오선과 천제가 이루는 각도
hour circle : x,시권(천공의 양극을 지나는 12개의 대원)
hourglass : n,각구,모래시계,물시계
hour hand : x,시침
houri : n,천녀,미인
hourly : a,ad,한 시간마다(의),빈번한,빈번히
hour plate : x,(시계의)문자판
house : n,집,가옥,집안,일문,,건물,상점,회사,회관,극장,관객,청중,의사당,의회,증권 거래소,궁,성수
house : vt,vi,집에 들이다,수용하다,덮다,안전한 곳에 들다,묵다,살다
house ad : x,자사 광고(자사 출판물에 게재하는)
house agent : x,복덕방,가옥 매매 소개업자
house arrest : x,자택 감금,연금
houseboat : n,집배
housebody : n,=homebody
housebound : a,두문 불출하는
houseboy : n,(가정에서 잡일을 하는)일꾼
housebreak : vi,n,침입 강도짓을 하다,~ing
housebreaker : n,(가택)침입 강도
housebreaking : n,침입 강도(죄),주거 침입,가옥 해체(업)
housebroken : a,집안에서 길러 길이 든
housebuilder : n,가옥 건축업자
house call : x,왕진
houseclean : vi,vt,(집안을)대청소하다,(회사,관청 등)인원 정리하다,숙청하다,일소하다
housecleaning : n,대청소,숙청
housecoat : n,자락이 긴 여자용 실내복
house counsel : x,(법인체의)전속 변호사
housecraft : n,가사 처리 솜씨,가정학,가정과
house cricket : x,집귀뚜라미
house detective : x,=house dick,(호텔,백화점,회사 등의)경비원
house dinner : x,(클럽,학교 따위에) 특별 만찬회
house doctor : x,병원 입주 의사
housedog : n,집 지키는 개,집에서 기르는 개
housedress : n,홈드레스,실내복(여자의 긴 원피스)
house duty : x,가옥세
house famine : x,주택난
housefather : n,9기숙사 등의)사감
house flag : x,(소속 회사의) 사기
houseflannel : n,투박한 플란넬(마룻바닥 청소용)
housefly : n,집파리
houseful : n,집에 가득
housefurnishings : n,가정용품
house girl : x,=housemaid
houseguest : n,(하룻밤 이상 묵는)손님,유숙객
household : n,a,가족,가족의,(교용인도 포함한) 온 집안 사람,가사의
household affairs : x,가사,가정
household arts : x,가정,가정학
Household Cavalry : x,근위(의장)기병대
household effects : x,가재 도구
householder : n,호주,세대주
household franchise : x,=household suffrage,호주 선거권
household gods : x,(옛 로마의) 가정 수호신
household head : x,세대주
household hunting : x,셋집(파는 집)찾기
household manager : x,가정 관리자,주부
household name : x,=household word
household stuff : x,가재
household technician : x,가정 기사,가정부
household troops : x,근위대
household word : x,흔히 잘쓰이는 말
househusband : n,(아내가 취업한 가정의)가사를 돌보는 남편
housekeep : vi,가정을 가지다,살림하다(keep house),=housekept
housekeeper : n,주부,가정부,하녀 우두머리
housekeeping : n,가정
houseleek : n,돌나물과의 잡초
houseless : a,집 없는
houselights : n,pl,(극장의) 객석조명
house magazine : x,=house organ
housemaid : n,가정부
house maid's knee : x,무릎 피하의 염증
houseman : x,(가정,호텔 등의)잡역부,허드렛일꾼,(병원 입주)의학 연수생,인턴(intern)
house martin : x,(유럽의)흰털발제비의 일종
housemaster : n,(남자 기숙사의) 사감,여자 주인
house match : x,기숙사 등의 대항 시합
housemate : n,동거인
housemistress : n,사감,여자주인
housemother : n,기숙사의 여사감(matron)
house mouse : x,생쥐
house nigger : x,백인에 굴종하는 흑인
house organ : x,사내보
houseparent : n,=housefather,housemother
house parlormaid : x,잔심부름하는 여자 아이,여자 사환
house party : x,(별장 따위에서의 ,수일간에 걸친) 접대회,그체재객들
houseperson : n,가사 담당자(housewife와 househusband의 구별을 피한 말)
housephone : n,(호텔,아파트 등의) 내선 전화
house physician : x,(병원,여관 등의)입주 내과 의사
houseplace : n,농가의 거실
houseplant : n,실내 화분용 화초
houseproud : a,(주부 등이)집의 정리,미화에 열심인,집 자랑하는
houseraising : n,(시골에서 이웃 사람들끼리 하는)상량식
houseroom : n,집,가옥
housesit : vi,(가족 대신에)집을 지키다
house sitter : x,(가족 대신에)집 보는 사람
house slipper : x,실내화
house steward : x,(유럽산)참새(English sparrow)
house style : x,(출판사,인쇄소의 독자적인)용자 방식,(조판)스타일
house surgeon : x,(병원 입주)연수 외과 의사
housetohouse : a,집집마다의,호별의
housetop : n,지붕,claim from the ~s 널리 알리다(선전하다)
house trailer : x,이동 주택차
housetrained : a,=housebroken
housewares : n,pl,가정용품
housewarming : n,집들이
housewife : n,주부
housewifely : a,주부다운,알뜰한
housewifery : n,가정,가사
housework : n,가사
housewrecker : n,가옥 해체업자
houseyhousey : n,lotto 비슷한 카드놀이
housing : n,주택공급 (계획) ,집,주택,피난소,가구,마의,말의 장식
housing association : x,(공동)주택 건축(구입) 조합
housing development : x,집단주택(용지),주택단지
housing problem : x,주택 문제
housing project : x,주택 계획,(저소득자용)공영 단지
housing shortage : x,주택 부족,주택난
housing start : x,주택 신축 착공(수)(경제 지표로서 사용됨)
Houston : n,미국 Texas 주의 도시(우주선 비행 관제 센터가 있음)
houtie : n,(경멸)(짐바브웨에서)흑인,아프리카 토인
Houyhnhnm : n,(걸리버 여행기 중의) 이성을 갖춘 말나라의 말
hove : v,heave의과거
hovel : n,vt,오두막집,광,헛간,오두막집에 넣다
hoveller : n,무면허 수로 안내인
hover : vi,n,하늘에 날다,배회하다,방황하다,어정거리다,주저하다
hoverbarge : n,호버바지(공기 쿠션식 짐배)
hoverbed : n,호버베드(공기 쿠션식 침대,화상,피부병 환자용)
Hovercraft : n,호버크라프트(고압공기를 분출하여 기체를 띄워 달리는 탈것)
hoverferry : n,호버페리(연락선용 호버크라프트)
hovering : n,호버링,공중 정지(헬리콥터가 공중에 정지해 있는 상태)
hovering ceiling : x,호버링 한계(헬리콥터의 상승 한도)
hoverplane : n,= HELICOPTER
hoverport : x,호버크라프트 발착장
hovertrailer : n,호버트레일러(공기 쿠션식 트레일러,호소,습지대 등에서 중량 화물을 운반함)
hovertrain : n,호버트레인(자력에 의한 공기 쿠션을 이용한 고속 열차
how : ad,n,어떤식으로,어떤모양으로,어떻게  하여,어떻게,얼마만큼,얼마나,참으로
Howard : n,남자 이름
howbeit : conj,ad,하지만,그렇지만
howd'yedo : n,난처한 상황,곤란한 입장(dilemma)
howdah : n,상교,코끼리의등의 닫집 가마
howdoyoudo : n,곤란한일
howdy : n,여어,안녕하세요
howe : n,움팬 땅,분지,넓은 골짜기
howe'er : n,=HOWEVER
however : ad,아무리 ...일지라도,도대체 어떻게 해서,그럴지라도,도대체 어떻게해서,그렇지만
howgozit curve : x,(특히 대양횡단 항공중의)상황 판단 곡선
howitzer : n,곡사포
howl : vi,n,vt,(개,늑대 따위가 소리를 길게 빼어)짖다,짖음,멀리서 짖다(짖음),큰 소리를 내다(냄),(바람이) 윙윙 휘몰아 치다,울부짖으며 말하다,호통쳐서 침묵시키다
howler : n,짖는 짐승,짖는 원숭이,큰소리를 내는 것(사람,라디오 따위)
howlet : n,=owl,owlet
howling : a,울부짖는,쓸쓸한,터무니 없는 ,대단한
howling monkey : x,=howler monkey
howling wilderness : x,(들짐승이 우짖는 황야)
howsoever : ad,아무리...일지라도
howto : a,입문서의,초보적인
hoy : int,n,어어이
hoya : n,새박덩굴과의 덩굴
hoyden : n,말괄량이
Hoyle : n,카드놀이 규칙,according to ~ 규칙대로의,올바른
HP : x,high pressure,horsepower
HQ : x,headquarters
HR : x,Home Rule,House of RerRESENTATIVES
HRH : x,His (or Her) Royal Highness
HSGT : x,high speed ground transportation,초고속 육상 수송 기관
Hsinhua : n,신화사(Xinhuashe)n,
HST : x,hypersonic transport
HSUS : n,Humane Society of the United States,미국 동물 애호 협회
HTR : x,high temperature reactor,고온 원자로
Hua Kuofeng : n,화궈펑(1970-)(중국 공산당 주석(1976-80)),=Hua Guofeng
Huang Hai : n,황해(the Yellow Sea)
Huang He : n,황하(the Yellow River)
Huang Hua : n,황화(1913-)(중국의 외상(1976-82),부수상(1980-82))
huarache : n,가죽끈으로 만든 굽이 낮은 샌들
hub : n,바퀴통(수레바퀴의 중심),중심부
hubble : n,작은혹
Hubble's constant : x,허블정수(은하 후퇴 속도가 거리에 비례하여 증가하는 비율)
hubblebubble : n,물 담뱃대,수연통,부글부글9소리),와글와글
hubbly : a,혹투성이의,우툴두툴한
hubbsbubba : int,좋아좋아,빨리빨리
hubbub : n,왁자지껄,소란,=hubbaboo,hubbuboo
hubby : n,남편
hubcap : n,(자동차의)휠캡
Hubert : n,남자 이름
hubris : n,오만,자기 과신,오만으로 인한 폭력
huckaback : n,허커백직(투박하고 튼튼한 린네르 또는 무명의 타월감)
huckle : n,엉덩이,허리,넓적다리(haundh)
hucklebacked : a,곱사등이의
huckleberry : n,월귤나무
Huckleberry Finn : x,Mark Twain작 소년 모험 소설의 주인공
hucklebone : n,좌골,둔골,무명골(hipbone),(사족수의)거골
huckster : n,vi,vt,소상인,행상인,상인,선전업자,자그마하게 장사하다,외치며 팔다,도부치다,값을 깍다
hucksterism : n,판매 제1주의
hucksterize : vt,~에 강요하다,강매하다
huckstery : n,도붓장수 노릇,행상
HUD : x,Department of Housing and Urban Development
huddle : vt,vi,n,뒤죽박죽 섞어 모으다,쳐넣다,쌓아 올리다,되는대로 해치우다,급히 입다,붐비다,난잡,밀담
Hudibrastic : a,(영국 시인 Samuel Butler의 작품 Hudibras에서)익살스럽고 풍자적인
Hudson : n,뉴욕주를 흐르는 강
Hudson Bay : x,캐나다 북부의 큰 만
Hudson Institute : x,허드슨 연구소(h,Kahn이 설립(1961)한 미래 예측,분석을 하는 두뇌 집단)
Hudson seal : x,모조 바다 표범 털가죽
hue : n,빛깔,색채,색상,색조
hue : n,고함,외침소리,a ~ and cry 추적(공격)의 함성,비난의 소리
hued : a,(보통 복합어를 이루어)~색조의
huff : vt,vi,n,못살게 굴다,울러대다,성나게하다,성내다,분개,화,take ~ 성내다
huffduff : n,고주파대 잠수함 탐지기
huffish : a,성난,뻐기는,성마른
huffy : a,성난,뻐기는,성마른
hug : vt,n,껴안다,고집하다,접근하여 지나다,꼭 껴안음,끌어안기
huge : a,거대한,~ly ad
hugely : ad,크게,매우
hugeous : a,(익살)=huge
huggermugger : n,a,ad,vi,vt,혼란,혼란한,비밀,비밀의,숨기다,비밀히하다
huggery : n,(변호사 등의)사건 쟁탈전
Hugh : n,남자 이름
Hughes : n,남자 이름
Hughie : n,남자 이름,비(일기)의 신
Hugo : n,Victor(1802~1885) 위고(프랑스의 작가,시인,극작가)
Hugueism : n,위그노 교의
Huguenot : n,위그노(16,17세기 프랑스의 신교도)
huh : int,하아,흥,허어,뭐라고(놀람,경멸,의문 따위를 나타냄)
Huhehot : n,후허하오터(중국의 내몽고 자치구의 주도),=Huhhot
hui : n,공동영업,클럽,협회
hula : n,vi,(하와이의)훌라댄스
hula hoop : x,훌라후프
hula skirt : x,(긴 풀로 엮은)훌라댄스용 스커트
hulk : n,노후선,폐함,멋없이 큰배
hulking : a,몸집이 큰,부피가 큰,보기 흉한,=hulky
hull : n,vt,껍데기,껍데기를 제거하다,덮개,덮개를 벗기다
hull : n,vt,선체(마스타나 돛은 포함하지 않음),(비행정의)정체,(탄알로) 선체를 궤뚫다,~ down (돛대만 보이고)선체가 수평선 밑에 안보일 정도로 멀리
hullabaloo : n,왁자지껄함,떠들썩함,시끄러움
Hull House : x,헐하우스(미국의 여성 사회 봉사자 Jane Addams에 의해 1889년에 설립된 복지 시설)
hulloa : int,=hallo(a)
hum : n,int,(벌,팽이가)윙윙하다,윙울리다,우물우물 말하다,콧노래를 부르다
human : a,사람의,인간적인,인간에게 있기 쉬운
human document : x,인간기록
humane : a,인정있는,친절한,사람을 고상하게 만드는,우아한,~ studies 인문 과학
human ecology : x,인간 생태학
humane killer : x,무통 도축기
humanely : ad,자비롭게,인도적으로
human engineering : x,인간공학
human figure : x,=Human One
human geography : x,인문지리학
human growth hormone : x,인간성장 호르몬(인체의 성장을 지배하는 뇌하수체 종합 호르몬
humanics : n,pl,인간학
humanism : n,인문주의,인본주의,인문학,인도주의
humanist : n,인문주의적인
humanistic : a,인간성 연구의,인본주의적인,인문학의,인문주의적인,고전 문학적인,인류주의의,인도주의적인
humanistic psychology : x,인간성 심리학
humanitarian : a,n,인도주의의,박애의,인도주의자,박애주의자
humanitarianism : n,인도주의
humanity : n,인류,인간,인간성,인간임,인정,박애,사람의 속성,자선 행위,the humanities 그리스,라틴 문학,인문 과학(어학,문학,철학,예술 따위)
humanization : n,인간화,인체 적응,인간성
humanize : vt,vi,인간답게 하다,교화하다,인정있게 만들다
humankind : n,인류
humanly : ad,인간답게,인정에서,인간적 견지에서,인력으로
human nature : x,인성,인간성,인정
humanness : n,사람임,인간성
humanoid : a,원인,인간에 근사한,인간에 유사한 우주인
Human One : x,사람의 아들,예수 그리스도
human potentials movement : x,인간 잠재 능력 회복 운동(일종의 집단 요법적 수양 운동)
human power : x,인적 자원
human race : x,인류
human relations : x,인간 관계,대인 관계
human resource administration : x,인적 자원 관리(종업원의 고용,해고,불만 처리 등의 인사관리)
human rights : x,(기본적)인권
human rights diplomacy : x,인권 외교(Jimmy Carter미국 전대통령(1977-81)의 인권 옹호 촉진을 위한 외교 방침)
human sciences : x,인문 과학(인류학,언어학,사회학,문학,심리학 등의 총칭)
Human Society : x,동물 애호 협회,수난 구조회
human torpedo : x,인간 어뢰(목표 가까이까지 인간이 유도함)
humber : x,영국 동부 Trent강과 Ouse강이 합류하는 강 어귀
humberside : n,험버사이드주(1974년 신설된 잉글랜드 북부의 주)
humble : a,vt,(신분이)비천한,낮추는,겸손한,검소한,(품위지위 따위를) 천하게(떨어지게) 하다,욕을 보이다,창피를 주다,~ oneself 스스로를 낮추어
humblebee : x,=BUMBLEBEE
humble pie : x,굴욕,사슴 내장 파이
humble plant : x,=sensitive plant
humbly : ad,낮추고,겸손히
humboldt : n,훔볼트Friedrich Heinrich Alexander von(1769-1859)(독일의 자연 과학자,저술가)
humbug : n,vt,vi,int,협잡,속임수,야바위,속이다,협잡하다,속임수를 쓰다,엉터리,시시하다
humbuggery : n,눈속임,협잡,기만,사기
humdinger : n,아주 훌륭한 사람(물건),아주 이상한(이례적인)것
humdrum : n,a,평범,평범한,단조로운,지루한
Hume : n,David(1711~1776)스코틀랜드의 철학자,역사가
humectant : n,휴멕턴트(흡습성 물질)
humerus : n,상완골
humid : a,습기 있는
humidification : n,습기
humidifier : n,가습기,습윤기
humidify : vt,습도를 주다
humidistat : n,습도 자동 조절 장치
humidity : n,습기,습도
humidor : n,담배 저장 상자(실)(적당한 습도를 주는),이와 유사한 설비
humiliate : n,욕 보이다,굴욕을 주다,창피를 주다
humiliating : a,굴욕적인
humiliation : n,부끄러움,창피를 줌,굴욕
humiliator : n,창피 주는 사람,모욕하는 사람
humility : n,겸손,겸허
humint : n,=HUMINT,사람에 의한 정보 수집(첩보 활동)
hummel : a,(소,사슴 등이)뿔 없는,(보리 등이)까끄라기 없는
hummer : n,윙윙거리는 곳,콧노래하는 사람,=hummingbird,속구,멋진 사람(것)
humming : a,n,붕붕(윙윙)하는 (소리),콧노래(를 부르는),활발한,씽씽한,(장사가)번성하는,(맥주가) 거품 이는
hummingbird : n,벌새
hummingtop : x,윙윙 소리 나는 팽이
hummock : n,작은 언덕
hummocky : a,작은 언덕의
hummorous : a,해학적인,익살맞은,유머러스한,우스운,희롱하는
hummy : a,ad,(아무것도 모르고)행복한(하게),만족한(하게),천진난만한(하게)
humongous : a,거대한,터무니없이 큰(tremendous),굉장한(huge)
humor : n,vt,유머,해학,우스개,기질,일시적인 기분,심기,만족시키다,비위를 맞추다,양보하다,in good (ill) ~ 기분이 좋아(언짢아),out of ~ 기분이 나빠서,성이나서
humoral : a,체액의(에서 생기는)
humored : a,(보통 복합어를 이루어)기분이~한,~한 기분의
humoresque : n,유머레스크,표일곡
humorist : n,해학가,익살꾼,유머 작가
humoristic : a,유머(감각)이 있는,해학적 작품의
humorless : a,유머가 없는,멋없는,재미없는
humorly : ad,기분이~해서,~한 기분으로
humorsome : a,변덕스러운
humorsomeness : n,변덕
humour : n,=humor
hump : n,vt,(등의)혹,육봉,우울,화가남,(등을) 둥그렇게 하다,get the ~ 화를 내다,~ oneself 노력하다,열심히 하다
humpback : n,a,곱사등,곱사등의,꼽추,새우등
humpbacked : a,곱사등의,꼽추의,북모양의
humped : a,혹이 있는,등이 굽은
humph : int,흥(불신,불만,경멸 등을 나타냄)
Humphrey : n,남자 이름
HumptyDumpty : n,땅딸막한 사람,넘어지면 못 일어나는 사람,(마더구스에 나오는 계란의 의인),어떤 기분이라도 말로 나타낼 수 있는 사람
humpy : a,혹 모양의,혹이 있는
humus : n,부식토
Hun : n,훈족,흉노(4,5세기경 유럽을 휩쓴 아시아의 유목민),(예술 따위의) 파괴자,야만인,독일 살마(병사)
hunch : n,vt,육봉,혹,두꺼운 조각,덩어리,예감,구부리다
hunchback : n,곱사등
hunchbacked : a,=humpbacked
hunchy : a,=humped
hundred : a,n,백(사람,개)의,많은,백,백사람,다수,백달러,a ~ and one 많은 ,by ~s 몇 백이고,많이,a great (long) ~ 백 이십,~s and thousands 몃 십만,무수,굵은 설탕,like a ~ of brkcks 대단한 무게로
hundredandeightydegree : a,ad,180도의(로),완전한(히),정반대의(로)
hundred Days : x,(나폴레옹의) 백일 천하(1815년 3월20일 ~ 6월 28일)
hundredfold : a,n,
hundredpercent : a,ad,완전한,철저한,확실한,아주,전혀
hundredpercenter : n,과격한 국수주의자,극단론자
hundredproof : a,알코올 농도 50도인,순수한,진짜의
hundredth : n,a,백번째의,제 백의,백분의 일
hundredweight : n,무게의 단위
Hundred Years' War : x,백년 전쟁(1337-1453)의 영불 전쟁
Hundred Years'War : x,백년 전쟁(1337~1453의 영불 전쟁)
hung : v,hang의과거분사
Hung, : x,Hungarian,Hungary
Hungarian : a,n,헝가리의,헝가리 사람(말)(의)
Hungary : a,n,헝가리
hunger : n,vi,vt,굶주림,공복,갈망,굶주리다,갈망하다
hunger cure : x,절식요법,단식요법
hunger march : x,기아 행진(실업자의 데모 행진)
hunger marcher : x,기아 행진 참가자
hunger strike : x,단식 투쟁
hunger striker : x,단식 투쟁자
hung jury : x,불일치 배심,의견이 엇갈려 판결을 못 내리는 배심원단
hungover : ad,주려서,시장한듯이,게걸스럽게,탐욕스럽게,열심히
hungrily : ad,굶주린 듯이,게걸스럽게
hungriness : n,공복,갈망,굶주림
hungry : a,굶주린,공복의,배고픈,갈망하는,메마른
Hungry Forties : x,기아의 40년대(1840-49년의 대기근)
hungry work : x,배고파지는(배꺼지는)일
hunk : n,(빵 따위의)두꺼운조각,훌륭한 사람
hunker : vi,n,쭈그리고 앉다,궁둥이
Hunker : n,보수주의자(1845-48년 민주당원 중의)구식 사람
hunkie : n,=hunky
hunks : n,노랑이,구두쇠
hunky : a,n,건장한,튼튼한,무승부의,비긴,외국 태생의 미숙련 노동자(특히 헝가리 등지의)
hunkydory : a,만족스러운,최상의,최고의
Hunnish : a,Hun의,흉노의(같은),야만의
hunt : vt,vi,n,사냥하다,(개,말을)사냥에 쓰다,몰이하다,찾다,추적하다,쫓아 버리다,괴롭히다,박해하다,사냥을 하다,사냥,~ down (궁지에) 몰아넣다,~ up 찾아 내다
hunt and peck : x,타자기를 제멋대로 치는 일
hunt ball : x,사냥꾼들의 무도회
hunter : n,사냥꾼,사냥개,탐구자,양딱지 회중 시계
hunter's moon : x,수렵월(중추의 만월(harvest moon)다음의 만월)
hunter green : x,연두빛
hunterkiller satellite : x,위성 파괴(공격)위성,킬러 위성(satellite killer)
HunterRussel syndrome : x,헌터 러셀 증후군(유기 수은 중독)
hunting : n,사냥,탐색,추구
hunting box : x,사냥산막
hunting cap : x,사냥모
hunting case : x,hunter 4의 겉 뚜껑
hunting crop : x,사냥용 채찍
hunting dog : x,사냥개
Hunting Dogs : x,사냥개자리
hunting field : x,사냥터
hunting ground : x,사냥터
hunting horn : x,수렵용 나팔
hunting knife : x,사냥칼
hunting lodge : x,=hunting box
hunting pink : x,(여우 사냥꾼이 입는 상의의)진홍색(의)
hunting season : x,사냥철
hunting watch : x,=hunter 4
huntress : n,여자사냥꾼
huntsman : n,사냥꾼,사냥개지기
hunttheslipper : n,슬리퍼 찾기 놀이
hup : int,(말을 재촉할 때 또는 오른쪽으로 돌릴 때의)이러!,(개를 앉힐 때의)앉아!
hupping : vt,vi,(말을)오른쪽으로 돌리다,=hupped,(개가)앉다
hurdle : n,vt,(장애물 경주의)허들,(울타리 대용의) 바자,장애,뛰어 넘다
hurdler : x,허들 선수
hurdle race : x,허들(장애물) 경주
hurdygurdy : n,손잡이를 돌려서 타는 오르간
hurl : vt,n,내던지다,내던짐,(욕을)퍼붓다
hurlbat : n,(하키)타구봉
hurler : n,hurl하는 사람,투수
hurley : n,=hurling,헐링용 스틱,헐링볼
hurling : n,던짐,헐링(아일랜드식 하키)
hurlingham : n,(영국의 Middlesex주 Fulham에 있는)폴로 경기장,폴로 경기 본부
hurly : n,(hurlyburly의 단축형,소동,혼란,hurley
hurlyburly : n,혼란,소동,혼잡
Huron : n,휴런호(북미 5대호중 제2의 큰 호수)
hurrah : int,vi,vt,n,만세,만세하고 외치다,환호하여 맞이하다
hurricame deck : x,상갑판
hurricane : n,폭풍,열대의 구풍,폭팔,허리케인 전투기
hurricane bird : x,=frigate bird
hurricane deck : x,(하천용 객선의)최상 경갑판
hurricane globe : x,램프의 등피
hurricane house : x,갑판실
hurricane hunter : x,허리케인 관측기(승무원)
hurricane lamp : x,강풍용 램프
hurricane warning : x,폭풍 경보,폭풍 주의보,=hurricane watch
hurricoon : n,허리케인 관측 기구
hurried : n,vi,vt,매우 급한
hurriedly : ad,매우 급히
hurry : n,vi,vt,(매우) 급함,서두름,in a ~ 서둘러서,허둥대어,쉽사리,서두르게하다,서두르다
hurry call : x,비상호출
hurryingly : ad,급히,서둘러,허둥지둥
hurryscurry : ad,,vi,n,황급히,황급한,허둥지둥하는,허둥대다
hurryup : a,급히 서두르는,긴급(용)의
hurst : n,숲,숲있는 언덕,모래언덕
hurt : n,vt,vi,상처,상처를 입히다,부상,부상을 입히다,다치다,고통(을 주다),아프다,fell ~ 불쾌하게 생각하다,~ oneself 다치다
hurt book : x,하자본,파손본
hurter : n,(비녀장 끝의)바퀴 멈추개
hurtful : a,해로운
hurtfully : ad,해로워서,유해하므로
hurting dance : x,(인간 관계에서 생긴)비통함(슬픔,질투,실망 등)
hurtle : vi,(돌,화살 따위가) 부딪히다
hurtless : a,해가 없는,무해한,상처를 입지 않은
husband : n,vt,남편,절약가,절약하다,남편이 되다
husbandage : n,선박 관리 수수료(ship's husband에게 지불하는)
husbandman : n,,농부
husbandry : n,농업,절약,규모 없는 살림살이
hush : n,vi,vt,침묵,침묵하다,고요해지다,고요하게하다,쉿,~ up 입다물게 하다,쉬쉬해버리다,입 밖에 내지 않다
hushabye : int,자장자장,아기를 잠 재울때
hush boat : x,=Qboat,hush boat
hushed : a,조용해진,고요한
hushhush : a,vt,n,(계획 등이)극비의,침묵시키다,(보도 등을)덮어 두다,쉬쉬해 버리다,비밀(주의).검열
hush kit : x,(제트 엔진용)소음 장치(흡음형 내통과 개량형 노즐의 조합
hush money : x,입막음 돈
hush puppy : x,허시퍼피(옥수수 가루의 둥근 튀김빵)
husk : n,vt,(과실,옥수수 따위의)껍질,껍질을 벗기다,(일반적으로) 쓸데없는 외피
huskily : ad,쉰 목소리로,허스키(보이스)로
husking : n,옥수수 껍질 벗기기,=husking bee
husking bee : x,옥수수 껍질을 까기 위한 (친한사람끼리의) 모임
husky : a,n,깍지의(와 같은,수가 많은),쉰 목소리의,허스키,억센,실팍진,실팍한 사람,에스키모 개
Huss : x,,John(1369~1415) 보히미아의 종교 개혁자
hussar : n,경기병
Hussein : n,후세인(1935-)(요르단왕(1952-)
Hussite : n,a,Huss의 추종자(의)
hussy : n,말괄량이
hustings : n,(국회의원 선거의) 연단
hustle : vi,vt,n,힘차게 밀다,서로 떠밀다,서두르다,맹렬히(정열적으로) 일하다,서로 떠밀기,서두름
hustlebustle : n,활기 넘치는 혼잡
hustler : n,세게 미는 사람,적극적인 활동가,추진 엔진
hut : n,vt,vi,오두막,오두막집,임시병사,임시병사에 머무르다
hutch : n,(작은 동물용)우릿간,우리,오두막
hut circle : x,(주거지를 나타내는)환상열석
hutment : n,숙영,가병사 숙박,숙영지,(바라크의)가병사
hutte : n,휘테,산막
hutting : n,(병사 따위의) 건재
hutzpah : n,=chutzpah,hutzpa
Huxley : n,Aldous(1894~1963)영국의 소설가
Hu Yaobang : n,후야오방(1913-89)(중국의 정치가,공산당 총서기(1980-87))
huzza : n,vi,만세,환호하다
huzzy : n,=hussy
Hwang Hai : n,=Huang Hai
Hwang Ho : n,(중국의) 황하
HWM : x,high water mark
hwyl : n,a,(시 낭송 때 등의)열정,감정의 고조,가슴 두근거리는 듯한
hyacinth : n,히아신스,보라색,풍신자석
hyacinthine : a,히아신스의(같은),보라색의,사랑스러운,아름다운
Hyacinthus : n,히아신투스(Apollo가 사랑한 미소년)
Hyades : n,Atlas의 7명의 딸,히아데스 성단,=Hyads
hyaena : n,=hyena
hyal- : x,(연결형)(유리(모양)의,투명한)의 뜻(모음 앞에서는 hyal-),=hyalo-
hyaline : n,유리같은,유리같은 물건,투명한,히알린
hyalite : n,옥적석(무색 투명)
hyaloid : a,n,유리 모양의,투명한,(안구의)유리 모양의 막
hyaluronic acid : x,히알루론산 (산성당류)
hyaluronidase : n, 히알루로니다제(히알루론산을 분자화한 효소)
HY antigen : x,H-Y항원(Y염색체 유전자에 의존하는 조직 적합 항원)
hybrid : n,a,잡종,잡종의,혼성의
hybrid bill : x,혼합 법안(공적과 사적의)
hybrid computer : x,복합형 계산기(analogue와 digital 계산 장치를 결합한 것)
hybrid integrated circuit : x,하이브리드 IC,혼성 집적 회로
hybridism : n,잡종성(hybridity),교배,혼성
hybridist : n,잡종 육성자
hybridity : n,잡종성
hybridization : n,잡종,혼성
hybridize : vt,교배시키다,잡종을 넣다,혼성어를 만들다
hybridoma : n,하이브리도마(암세포와 정상세포를 융합하여 만든 잡종 세포,단 클론 항체를 산출함
hybrid tea (rose) : x,장미의 일종(꽃잎이 크고 사철 피는)
hybrimycin : n,하이브리마이신,혼합마이신(합성 항생 물질)
hycanthone : n,히칸톤(박테리아,포유류의 세포에 돌연변이를 일으키는 화학 물질,주혈흡충증의 치료제)
hyd, : x,hydraulics,hydrostatics
Hyde : n,하이드씨
Hyde Park : x,London의 공원(정치적 시위도 벌어짐)
hydr- : x,(연결형)(물의,수소의)의 뜻(모음 또는 h 전에는 hydr-),=hydro
hydra : n,(머리를 배면 다시 또 나는) 아홉머리의 괴이한 뱀,근절하기 어려운 것,히드라,바닷뱀자리
hydracid : n,수소산
hydraheaded : a,(Hydra처럼)머리가 많은,근절하기 어려운
hydrangea : n,수국
hydrant : n,급수전,소화전
hydrargyrum : n,수은 (기호 Hg)
hydrasorter : n,하이드러소터(액상 폐기물에서 유용 고형물을 채집하는 동시에 발전용 증기를 발생하는 장치)
hydrate : n,수화물
hydration : n,수화(작용)
hydration : n,수화(작용)
hydrator : n,수화기
hydraul : n,=hydraulic(s)
hydraulic : a,수력학의,수력 공학의,수력(수압)(이용)의,유압의(으로 작동하는)
hydraulically : ad,수력으로,수압으로
hydraulic cement : x,수경(성) 시멘트
hydraulician : n,수리 학자,수력 기사
hydraulic lift : x,수압(유압)승강기
hydraulic press : x,액압 프레스
hydraulic ram : x,수압 펌프,자동 양수기
hydraulics : n,수력학
hydraulic system : x,유압 장치(계통)(유압으로 조종계통이나 착륙장치를 작동시키는
hydrazide : n,하이드라지드,결핵 치료제
hydrazine : n,히드라진,환원제,로켓 원료용
hydric : a,수소의(를 함유한)
hydride : n,수소화물
hydrilla : n,하이드릴라(미국에서는 양어조 식물로서 사용됨)
hydriodic : a,옥화수소산의
hydriodic acid : x,옥화 수소산
hydro : x,물,수소의 뜻의 결합사
hydro : x,(연결형)=hydr-
hydroairplane : n,수상 비행기
hydrobiologist : n,수생 생물학자
hydrobiology : n,수생 생물학,육수(호소)(생물)학
hydrobiplane : n,복엽 수상 비행기
hydrobomb : n,(뇌격기에서 발사하는) 공중 어뢰
hydrobromic : a,브롬화수소의
hydrocarbon : n,탄화수소
hydrocarbonaceous : a,탄화수소의
hydrocele : n,수류(음낭 등의),고환류
hydrocephalous : a,뇌수종의,수두증의
hydrocephalus : n,뇌수종
hydrochloric : a,염화 수소의
hydrochloric acid : x,염산
hydrochloride : n,염산염
hydrocortisone : n,하이드로코르티손(부신 피질 스테로이드의 하나)
hydrocracking : n,(탄화수소의)수소화 분해(법)
hydrocyanic : a,시안화 수소의
hydrocyanic acid : x,시안화 수소산,청산
hydrodynamic : an,유체역학의,유체동역학의
hydrodynamically : ad,유체역학으로,유체동역학으로
hydrodynamics : n,유체역학,유체동역학
hydroelectric : a,수력전기의
hydroelectricity : n,수력전기
hydroextractor : n,원심 탈수기
hydrofluoric : a,불화 수소의
hydrofluoric acid : x,불화 수소산
hydrofoil : n,=HYDROVANE
hydrofracturing : n,수압 파쇄법(지하의 암반에 액체를 압송하여 틈을 만들어 석유의 통로를 만드는 방법)
hydrogasification : n,석탄의 메탄 가스화
hydrogel sheet : x, 히드로겔 시트(95%의 물과 5%의 플라스틱으로 만든 인공 장기의 일종)
hydrogen : n,수소 (기호 H)
hydrogenate : vt,수소화하다,수소를 첨가하다
hydrogenation : n,수소첨가
hydrogen bomb : x,수소폭탄
hydrogen chloride : x,염화 수소
hydrogen corona : x,수소 코로나(혜성의 대기 외측에 존재하는 거대한 수소 가스의 구름)
hydrogen ion : x,수소이온
hydrogenize : vt,수소와 화합시키다
hydrogenous : a,수소의,수소를 함유하는
hydrogen peroxide : x,과산화수소
hydrogen sulfide : x,황화수소
hydrogen warhead : x,수폭 탄두
hydrograph : n,수위 기록계,수위도
hydrographer : n,수로학자,수로 측량가
hydrography : n,수로학,(하천학 따위),수로 측량(학)
hydroid : a,n,히드로충의
hydrokinetics : n,유체 동역학
hydrolab : n,해중(해저) 실험선,하이드로래브
hydrologic : a,수문학의
hydrologist : n,수문학자
hydrology : n,수문학(육지상의 물의 성질,현상,분포,법칙 등을 연구함)
hydrolysis : n,가수분해
hydrolytic : a,
hydrolyze : vt,vi,가수분해하다
hydromagnetic : n,자기 유체 역학
hydromechanics : n,유체 역학
hydromel : n,(발효하지 않은)꿀물
hydrometer : n,액체 비중계
hydrometric : a,비중 측정의,유속 측정의,=hydrometrical
hydrometry : n,액체 비중 측정(법),유속 측정(법),유량 측정
hydromonoplane : n,단엽 수상(비행)기
hydromorphine : n,히드로모르핀(강력 진통 작용이 있는 마약의 일종)
hydronaut : n,심해정 승무원
hydronautics : n,해양 개발 공학
hydronic : a,(냉난방의)순환수식의
hydronics : n,(폐관내를 순환하는 냉수,온수에 의한)순환수식 냉난방 시스템
hydropathic : a,(광천에 의한)수치료법의
hydropathy : n,(광천에 의한)수치료법
hydrophane : n,투단백석
hydrophilic : a,n,친수성의,소프트 콘택트 렌즈
hydrophilicity : n,친수성
hydrophobia : n,공수병,광견병
hydrophobicity : n,소수성
hydrophone : n,수관 검루기,수중 청음기(잠수함 탐색 등에 씀)
hydrophyte : n,수생 식물
hydropic : a,수증성의
hydroplane : n,수상 비행기
hydroplaning : n,하이드로 플레이닝(자동차가 빗길을 고속으로 달릴 때 미끄러지는 현상)
hydroponics : n,수경법
hydroponist : n,수경식 농업 경영자
hydropower : n,수력 전기
hydrops : n,수종병
hydropsy : n,=dropsy
hydropsychotherapy : n,물에 의한 정신 요법(목욕탕,풀장 등을 이용한 정신 요법)
hydroquinone : n,하이드로퀴논,사진현상액
hydroscope : n,수중 안경
hydroski : n,하이드로스키(이착수하기 쉽도록 수상기의 동체 아래에 붙인 수중날개)
hydroskimmer : n,에어쿠션정,수상스키머(공기 쿠션으로 선체를 부상시켜 달리는 쾌속정)
hydrosol : n,히드로졸(물을 분산매로 하는 콜로이드)
hydrospace : n,(대양의)수면 밑의 영역,수중(역)
hydrosphere : n,(대기중의) 물기,(지구면의) 수권,수계
hydrostat : n,누수검출기,(보일러의)폭발방지 장치
hydrostatic : a,정수의,유체 정역학적의,=hydrostatical
hydrostatic press : x,수압기
hydrostatics : n,유체 정역학,정수 역학
hydrosulfide : n,수황화물
hydrotaxis : n,수분 주성(생물의 수분에 대한 주성)
hydrotherapeutics : n,물요법
hydrotherapy : n,수치 요법(water cure)(환부를 물,광천에 담가서 치료하는 방법)
hydrothermal : a,열수(작용)의(에 의한)
hydrothorax : n,흉수(증)
hydrotreat : vt,(기름등을)수소화(수소 첨가)처리하다
hydrotrope : n,굴수성 유발물질
hydrotropic : a,굴수성의
hydrotropism : n,굴수성
hydrous : a,수소를 함유하는,함수의
hydrovane : n,(잠수함,비행정 따위의)수중익,수중익선
hydroxide : n,수산화물
hydroxyl : n,수산기
hydroxyl radical : x,수산기
hydroxyurea : n,수산화 요소(백혈병 치료제)
Hydrozoa : n,히드로충류
hydrozoan : n,히드로충
hyena : n,하이에나,욕심꾸러기
hyet- : x,(연결형)(비의)의 뜻(모음 전에서는 hyet-),=hyeto-
hyetograph : n,우량도
hyetography : n,우량학,우량도법
hyetology : n,우학
hyetometer : n,우량계
Hyfil : n,하이필(탄소 섬유로 강호한 플라스틱,상표명)
hygeia : n,건강의 여신
hygeian : a,건강의,위생의
hygiene : n,위생학
hygienic : a,위생(학)의
hygienics : n,위생 관리,위생(학)
hygienist : n,위생학자,위생사,위생 기사
hygr- : x,(연결형)(습기,액체)의 뜻(모음 전에서는 hygr-),=hygro
hygroexpansivity : n,습전성(습도에 의한 물체의 팽창성)
hygrograph : n,자기 습도계
hygrology : n,습도학
hygrometer : n,습도계
hygrometric : a,습도 측정(법)의
hygrometry : n,습도 측정(법)
hygroscope : n,습도계,건습계
hygroscopic : a,검습기의,검습기로 알 수 있는,습기 차기 쉬운,흡습성의
hying : v,hei의 현재분사
Hyksos : n,힉소스(B.C. 18~16세기경의 이집트 왕조)
hyla : n,청개구리
hyla : n,청개구리
hylic : a,물질의,물질적인,목재의
hylology : n,재질학(naterials science)(과학,공학 분야에서 쓰는 재료의 특질을 연구하는 학문)
hylotheism : n,물시신론(신 또는 신들과 물질을 결부시키는 생각)
hylozoic : a,물활론의
hylozoism : n,물활론(생명과 물질이 서로 불가분의 관계에 있음을 주장함
hylozoist : n,물활론자
hymen : n,결혼의신,처녀막,결혼의 축가
hymen- : x,(연결형)(처녀막,막)의 뜻(모음 전에서는 hymen),=hymemo-
hymeneal : a,n,혼인의(nuptial),결혼식의 노래
hymenopteron : n,막시류의 곤충
hymie : n,(경멸)유대인
hymn : n,vt,찬송가,찬송하다,찬미하다
hymnal : a,n,찬송가의,성가의,찬송가(성가)집
hymnary : n,=hymnal
hymnbook : n,=hymnal
hymnist : n,찬송가 작자
hymnodist : n,=hymnist
hymnody : n,찬송가를 부름,(집합적)찬송가,찬송가 연구
hymnographer : n,=hymnist,찬송가 연구가
hymnology : n,찬송가학,(집합적)찬송가,찬송가 작사(작곡)
hyoid : n,a,설골(의)
hyoid bone : x,설골(tonguebone)
hyoscine : n,히오스신(동공 산대약,진정제)
hyosyamine : n,히어시아민,진정제,동공확산제
hyp : n,우울
hyp- : pref,=hypo,(아래에,이하,조금,차아)의 뜻(모음 전에서 hyp-)
hypaethral : a,창공의,(원래 고대 그리스 신전이)지붕이 없는,옥외의
hypallage : n,대환법
hype : n,vt,마약중독,마약중독자,사기,과대광고,흥분시키다,자극하다,속이다
hypedup : a,꾸며댄 듯한,가짜의,(흥분제를 맞은 듯이)흥분한
hyper : n,떠버리,허풍쟁이
hyper- : x,(연결형)(건너편의,초월,과도히,비상한)의 뜻
hyperacid : a,위산 과다의
hyperacidity : n,위산과다증
hyperactive : a,n,지나치게(비정상적으로)활동적인(과민한)(사람)
hyperaesthesia : n,지각(촉각) 과민(증)
hyperalimentation : n,(점적 등에 의한)과영양
hyperanxious : a,몹시 걱정하는,지나치게 걱정하는
hyperbaric : a,고압산소요법의
hyperbaric oxygen therapy : x,고농도 산소 요법(일산화탄소 중독,뇌졸증,다발성 경화증 등에 사용됨)
hyperbaton : n,전치법
hyperbola : n,쌍곡선
hyperbole : n,과장법
hyperbolic : a,과장법의,과대한,과장적인,쌍곡선의
hyperbolical : a,=hyperbolic
hyperbolism : n,과장법(hyperbole)
hyperbolize : vi,vt,과장법을 쓰다,(일반적으로)과장하다
hyperboloid : n,쌍곡면
hyperborean : n,a,상춘의 나라의 주민,극북의
hypercatalectic : a,행 끝에 여분의 음절이 있는
hypercharge : n,vt,하이퍼차지(소립자의 하전 상태를 나타내는 연산자,~에 지나치게 집어넣다(부과하다)
hypercorrect : a,지나치게 정확한,까다로운,과잉 정정의
hypercorrectinon : n,과잉 정정,지나치게 고침(정용법을 지나치게 의식,오히려 틀린 언어 형식을 씀)
hypercritic : n,혹평가
hypercritical : a,혹평의,혹평적인
hypercriticism : n,혹평
hypercriticize : vt,vi,혹평하다,헐뜯다
hyperdialectism : n,과도 방언 사용
hyperemia : n,충혈
hyperesthesia : n,=hyperaesthesia
hyperexcitability : n,과흥분(성),흥분성 항진
hyperexcitable : a,과흥분(성)의,흥분성 항진의
hyperfocal distance : x,(카메라 렌즈가 잡을 수 있는)최단 거리
hyperglycemia : n,과혈당증
hypergol : n,자연성 연료
hypergolic : a,과장의,쌍곡선의
hyperinflation : n,초인플레이션
hyperion : n,히페리온(Uranus와 Gaea의 아들,종종 Apollo와 혼동됨),토성의 제7위성
hyperirritability : n,과잉 자극 감수성
hyperirritable : a,과잉 자극 감수성의
hyperlipemia : n,고지방혈(증),지방 과잉혈(증),=hyperlipidemia
hyperlipoproteinemia : n,고리포 단백혈(증)(혈액에 리포 단백 농도가 증가하는 병)
hypermarket : n,(교외의)대형 슈퍼마켓
hypermeter : n,음절 과잉 시구,2 또는 3행(colon)으로 된 피리어드(period)
hypermetric : a,음절과잉의
hypermetropia : n,=hyperopia
hypermetropic : a,원시의
hyperon : n,중핵자
hyperopia : n,원시
hyperphagia : n,식욕 항진(증),과식(증)
hyperpiesia : n,=hypertension
hyperrealism : n,하이퍼(초) 리얼리즘
hyperscope : n,참호용,잠망경
hypersensiness : n,		  과민증
hypersensitive : a,과민한,과민증의
hypersensitivity : n,과민증
hypersexual : a,성욕 과잉(항진)의
hypersonic : a,극초음속의
hypersonic airliner : x,극초음속 여객기(마하 4-6의 극초음속으로 비행)
hypersonic transport : n,극초음속 
hypersonic transport : x,극초음속수송기
hyperspace : n,초공간
hypersthene : n,자소휘석
hypertension : n,고혈압
hypertensive : a,n,고혈압의,고혈압의 환자
hyperthyroid : a,n,갑상선 기능 항진(증)의 (환자)
hyperthyroidism : n,갑상선(기능) 항진(증)
hypertonic : a,(특히 근육의)긴강 과도의,(용액이)긴장 과도의,고장의
hypertophic : a,비대성의,=hypertrophied
hypertrophy : n,vi,vt,비대,비대하게하다,비대해지다
hypervelocity : n,최고속도(특히 우주선,핵입자 등 초속 10000피트(약 3000m)이상의 속도)
hyperventilation : n,환기(호흡) 항진,과환기
hypethral : a,=hypaethral
hypha : n,균사
hyphen : n,vt,하이픈,하이픈으로 연결하다
hyphenate : vt,=hyphen
hyphenated : a,하이픈으로 연결한,(시민이)외국계의
hyphenize : vt,=hyphen
hypicrite : n,위선자
hypn- : x,=hypno(연결형)(수면,최면)의 뜻(모음 전에서는 hypn-)
hypnagogic : a,최면의
hypnoanalysis : n,최면 분석(최면술을 걸어 심층 심리를 유도함으로써 정신 분석을 하는 방법)
hypnodrama : n,최면극(최면자가 어떤 상황을 연기해 보임)
hypnogenesis : n,최면
hypnoid : a,수면(최면)상태의,=hypnoidal
hypnology : n,수면학,최면학
hypnopedia : n,수면 학술법
Hypnos : n,히프노스(잠의 신,꿈의 신 Morpheus의 아버지,로마의 Sommus에 해당)
hypnosis : n,최면,최면술,최면상태
hypnotherapy : n,최면요법
hypnotic : x,최면술의,최면제,최면에 걸린 사람
hypnotic regression : x,최면 회귀(최면술에 의해 전생의 기억으로 되돌아감)
hypnotic suggestion : x,최면 암시(최면하에서의 암시(요법))
hypnotism : n,최면상태
hypnotizability : n,피최면성의
hypnotize : vt,vi,최면술을 걸다,매혹하다,호리다,최면술을 행하다,암시를 주다
hypnotizer : n,최면술사
hypo : n,하이포
hypoacidity : n,저산(증),위산 감소(증)
hypoallergenic cosmetics : x,저자극성 화장품
hypoblast : n,내배엽(endodoerm)
hypocaust : n,(옛 로마)마루밑,난방,온돌
hypocenter : n,폭심
hypochlorite : n,차아염소산염
hypochlorous acid : x,차아염소산
hypochondria : n,히포콘드리증,심기증,우울증
hypochondriac : n,a,히포콘드리증의(환자),심기증의(환자)
hypochondriacal : ad,히포콘드리증의(같은)
hypochondriasis : n,히포콘드리증,심기증,침울증
hypochondrium : n,계륵부,하륵부
hypocorism : n,애칭,애칭 창작(사용),(유아에게 말할 때의)유아어,완곡어(euphemism)
hypocoristic : a,친애를 표시하는,애칭의(endearing)
hypocotyl : n,어린 줄기,배축
hypocrisy : n,위선,위선적 행위
hypocrite : n,(대답하는 사람,배우)의 뜻에서,위선자,위선을 부림
hypocritical : a,위선의,위선(자)적인
hypocritically : ad,위선으로,위선(자)적으로
hypoderm : n,=hypodermis
hypodermic : a,n,피하의,피하주사액
hypodermic injection : x,피하 주사
hypodermic needle : x,피하 주사침(침을단)피하 주사기
hypodermic syringe : x,피하 주사기
hypodermic tablet : x,주사용 정제
hypodermis : n,하피
hypogastric : a,하복부의
hypogastrium : n,하복부
hypogene : a,(암석이)지하에서 생성된,심성의,내성의
hypoglycemia : n,저혈당(증)
hypophosphate : n,차인산염
hypophosphite : n,차아인산염
hypophosphoric acid : x,차인산
hypophosphorous acid : x,차아인산
hypophysis : n,뇌하수체
hypospray : n,괴하분사기,바늘을 사용하지 않고 고압으로 피하에 주사함
hypostasis : n,실체,본질,삼위일체
hypostatic : a,본질의,실재의,침하성 충혈의,위격의
hypostatization : n,본질로 생각함,인성화
hypostatize : vt,(개념 등을)실체시하다,실체화하다,구상화하여 생각하다
hypostyle : a,n,다주식의(건축)
hyposulfite : n,차아황산염,차아황산나트륨
hyposulfurous : a,차아황산
hypotaxis : n,종속
hypotension : n,저혈압증
hypotensive : a,n,저혈압의(사람)
hypotenuse : n,빗변
hypoth : x,hypothesis,hypothetical
hypothalamus : n,시상 하부
hypothec : n,담보권
hypothecate : vt,저당(담보)에 넣다
hypothecation : n,담보 계약
hypothenuse : n,=hypotenuse
hypothermia : n,저체온(증),(심장수술등의)저체온(법)
hypothermic : a,저체온(증)의
hypothesis : x,가설,가정
hypothesize : vt,가설을 세우다,가정하다
hypothetic : a,가설의,hypothetical
hypothyroidism : n,갑상선(기능)저하(부전)(증)
hypotonic : a,(근육이)저긴장의,(용액이)저침투압의,저장성의
hypotonicity : ad,(근육이)저긴장으로,(용액이)저침투압으로,저장성으로
hypotrophy : n,발육부전
hypoxemia : n,저산소혈(증)
hypoxemic : a,저산소혈(증)의
hyps- : x,,=hypro-(연결형)(높이,높은)의 뜻(모음 앞에서는 hyps-)
hypsography : n,지세 측량,지세,지세 도시법,측고법
hypsometer : n,측고계(액체의 비등점을 재어 토지의 높이를 알아내는)
hypsometry : n,고도 측정(술)
hyrax : n,바위너구리(아프리카,지중해 지방산)
hyrst : n,=hurst
hyson : n,희춘차(중국산 녹차의 일종)
hy spy : x,숨바꼭질의 일종(I spy 라고도 함)
hyssop : n,(유럽산 박하의 일종)버들박하,히숍,우슬초(고대 유대인들이 불제의식에 그 가지를 사용했음)
hyster- : x,=hystero-,(연결형)(자궁,히스테리)의 뜻(모음 전에서는 hyster-)
hysterectomy : n,자궁 절제(술)
hysteresis : n,(자기,전기 등의)이력 현상
hysteretic : a,이력 현상의
hysteria : n,히스테리,병적흥분
hysteric : a,n,히스테리의발작,히스테리의,병적으로 흥분한
hysterical : a,히스테리의(적인),히스테리의,병적으로 흥분한
hysterical fever : x,히스테리열
hysterically : ad,히스테리의(적인),히스테리의,병적으로 흥분한
hysterogenic : a,히스테리를 일으키는,히스테리 기인성의
hysteroid : a,히스테리 비슷한,=hysteroidal
hysterology : n,자궁 절개(술),(특히)제왕절개술
hysteron proteron : x,전후 도치,도역 논법
hysterotomy : n,자궁 절제(술)
hyzone : n,3원자 수소,히존
Hz : x,hertz
