T : n, 알파벳 20번째의 문자,T자 모양의 것,cross one's (the) t's t자의 횡선을 긋다,사소한 점도 소홀히 하지 않다,to a T 정확히,꼭 들어맞게 (to a nicety)
T-bill : n,=treasury bill,
T-bone : n,티본 스테이크(소의 허리 부분의 뼈가 붙은 T자형 스테이크),
T-dress : n,티드레스(긴 티셔츠 같은 원피스),
T-junction : n, T자길,T자꼴 연결부
T-shirt : n, 티셔츠
T-time : n, 로켓 발사 시간
T.A.B : x, Typhoid-paratyphoid A and B vaccine
T.A.F : x, Tactical Air Force전술 공군
T.T. : x, telegraphic transfer 전신환,tuberculin-tested 투베르쿨린 검사가 끝난
ta : int, thank you의 단축,전화
ta'en : v, =TAKEN
ta-da(h) : int, 나오신다,기대하시라사람,물건을 처음 소개할 때 세우는 소리)
tab : n,vt, 드림(끈,고리,휘장,찌찌(tag))(을 달다),계산(서),keep ~(s) on ...의 셈을 하다,...을 지켜보다
tabard : n, 전령사의 옷,(기사가 갑옷위에 입던)문장 박인 겉옷
Tabasco : n, 고추(capsicum)로 만든 매운 소스
tabbouleh : n, 타블레(중동식 야채 샐러드)
tabby : n, (갈(회)색 바탕에 검은 줄무늬의)얼룩 고양이,암코양이,심술궂고 수다스러운 여자
tabby : a, 얼룩진 (a ~ cat 얼룩고양이)
tabefaction : n, 여윔,소모증
tabernacle : n, 가옥,천막집,(이스라엘 사람이 방랑 중 성전으로 사용한)장망(tent),유대성소,(비국교파의)예배소,(영혼의 임시 거처로서의)육체,성궤,성기상자
tabernacular : a, 천개가 있는,(경멸)(비국교파의) 비밀 집회에서 쓰는 용어 같은
tabes : n, 쇠약,소모,척수로
tabescent : a,여위는,쇠약해지는
tabid : a, =TABETIC
tabinet : n, 태비넷(물결무늬가 든 견모직물)
tabla : n, 타블라(인도 음악의 한 쌍의 작은 북
tablature : n, 태블러추어 악보,문자(그림,무늬)가 새겨진 평판(평면),(일반적으로)그림,의식에 떠올리는 그림,심상
table : n, 테이블,탁자,식탁,음식,식탁을 둘러싼 사람들,고원,대지,서판(에 새긴 글자),(수상이 나타나 있는)손바닥,표(the ~ of contents 목차),리스트
table : vt, 탁상에 놓다,표로 만들다,(의안 등을) 묵살하다
tableau : n, 극적 장면,그림,활인화
tableau curtains : x, 한가운데서 양쪽으로 여는 막
tableau vivant : x, 활인화
tableboard : n, 식탁판,식사(하숙은 하지 않고) 식사만 제공받기,게임대,도박대
table book : x, 계산표(책),(응접실의) 탁상,장식용 서적,수첩
tablecloth : n, 테이블 보
table cut : x, 테이블 컷(8면체 결정의 위 아래 각을 깍아 평평하게 하는 컷 양식)
table d'hote : x, 정식
tableflap : n, (경첩을 달아서 접었다 폈다 할 수 있게 만든)탁자의 판
tableful : n, 한 식탁의 분량,한 식탁에 둘러앉을 수 있는 사람 수
table garden : x, 가정 채소밭
tablehop : vt, (식당,나이트 클럽 등에서) 자리를 옮기며 지껄이다
table knife : x, 식탁용 나이프
tableland : n, 대지,고원
table linen : x, 식탁용 흰 천(테이블 클로스,냅킨 따위)
tablemanners : n, 식사 때의 예법
table mat : x, (식탁에서 뜨거운 접시 등의 밑에 까는) 깔개
tablemate : n, 함께 식사하는 사람
table money : x, (고급 장교의)교재비
table of organization : x, 편성표
table salt : x, 식탁용 소금
tablespoon : n, 식탁용 큰 스푼
tablespoonful : n, 큰 스푼(테이블 스푼) 하나 가득(의 분량)
table sugar : x, 그래뉴당(일반적으로) 설탕
tablet : n, (나무,상아,점토,돌 등의)평판,서판,메모장,편지지 첩,타블렛(안전 통과표),정제
table talk : x, 식탁 좌담,다화
tabletarm chair : x, 태블릿체어(우측 팔걸이 끝이 넓어서 필기대 구실을 하는 의자)
table tennis : x, 탁구
table tennis : x, 탁구,핑퐁
table tilting(tipping,turning) : x, (강령술에서) 몇 사람이 손을 대면 신령의 힘으로 테이블이 저절로 움직이는 현상
tabletop : n, 테이블의 표면
tabletopper : a,n, 탁상(용)의,테이블 표면,(테이블 위에 놓은) 정물 사진
table tripod : x, (영화,텔레비전 카메라용) 낮은 삼각재(가)
table turning : x, 심령의 힘으로 테이블을 움직이는 심령술의 일종
tableware : n, (식탁용)식기류
table water : x, 식탁용 광천수
table wine : x, 식탁용 포도주
tablifter : n, 나이트 클럽의 손님
tabling : n, 식탁보,냅킨,갓돌,맞물리기,(돛의) 갓천
tabloid : n, 타브로이드판 신문,정제
tabloid : a, 요약한,타블로이드판의
tabloid play : x, 촌극
taboo : n,a, (폴리네시아 사람 등의) 금기(터부)(의),금제(의)
taboo : vt, 금기(금제)하다
tabor : n, (납작한) 작은 북(손으로 침)
taboret : n, 낮은 대,작은 북
tabula : n, 필기판,골판,상판
tabular : a, 표의,표로한,얇은 판자(모양)의
tabula rasa : x, 글자가 씌어 있지 않은 서판(석판),(어린이의 마음의)백지 상태,때 안 묻은 마음
tabular standard : x, 계표(계수) 본위,물가 지수 본위
tabulate : vt, 평판 모양으로 하다,(일람)표로 만들다
tabulate : a, 평면(평판 모양)의
tabulation : n, 도표 작성,표,목록
tabulator : n, 도표 작성자,(타자기의) 도표 작성 장치,도표 작성용 컴퓨터
tabun : n, 타분(독가스의 일종)
TAC : x, Tactical Air Command 전술공군 사령부
tacamahac : n, 타카마학 수지,타카마학 수지를 내는 나무
TACAN : n, tactical air navigation 기상용 단거리 항법장치
tache,tach : n, 고리,죔쇠
tachism : n, =TACHISME
tachisme : n, 태시즘 (그림 물감을 흘리거나 뿌리는 추상화법)
tachistoscope : n, 순간 노출기(그림,문자등 시각적 자극을 주는 장치
tacho : n, =TACHOMETER
tacho : x, (연결형) 속도의 뜻
tachogram : n, 태커 그램(태커 그래프의 기록)
tachograph : n, (자동차 따위의) 자기 속도계
tachometer : n, 속도 기록계,유속계
tachycardia : n, 심계항진,심박급진(증)
tachygraphy : n, 속기법(특히 옛 그리스,로마 시대의) 속서법
tachymeter : n, 시거의
tachyon : n, 타키온(빛보다 빠른 가상의 소립자)
tacit : a, 무언의,침묵의,암묵의
taciturn : a, 말없는,과묵한
taciturnity : n, 말없음,과묵
Tacitus : n, 타키투스 Publius Cornelius ~ (55?-120?)(로마의 역사가)
tack : n, 못,압정,가봉,시침질,지그재그 항정,돛의 위치에 따르는 배 진로의 방향,돛 위치에 따르는 배 진로의 방향,돛 위치 변경에 의한 방향 전환,(육상을)지그재그로 나감,지그재그 침로(의 한 구간),방침,정책
tack : n, 음식물,hard tack 건빵
tack-driver : n, 납작못 박는 자동 기구
tack board : x, (도표,통지 등을 붙이는) 게시판
tacker : n, 납작못 박는 사람,납작 못 박는 기구,시침질 하는 사람
tack hammer : x, 징박는 망치
tackhead : n, 바보,멍청이,얼간이
tacking : n 납작못 박기,시침질 하기,고정시킨 접합물,맞바람 받아 침로 바꾸기,지그재그로 결합,부가,(법안에의) 조항 부가
tackle : n, 도구,테이클(선구,삭구),복활차,태클
tackle : vt,vi, (말에)마구를 달다 (harness),도르래로 끌어 올리다(고정하다),붙잡다,태클하다,(일에)달려들다,부지런히 시작하다(to)
tackle box : x, 낚시 도구 상자
tackling : n, 붙잡고 방해함,(축구에서) 태클 동작,고패 장치,도르래 장치,밧줄
tackling bag : x, (미식 축구,럭비 등의) 태클 연습용 백
tack room : x, (마구간에 딸린) 마구실
tacky : a, 초라한,야한,시대에 뒤진
taco : n, 타코스(멕시코 요리,저민 고기 등을 tortilla로 싼 것)
taconite : n, 타코나이트 철광
TACSAT : x, tactical communications satellite(미) 전술용 통신 위성,택새트
tact : n, 재치,솜씨,요령,촉감
tactful : a, 지치 있는,빈틈없는,약삭빠른,감각이 세련된,적절한
tactical : a, 병학의,전술(상)의,전술적인,책략(술책)이 능란한,빈틈없는
Tactical Air Command : x, (미) 전술 공군 사령부
tactical nuclear weapon : x, 전술 핵무기
tactician : n, 전술가,책사
tactics : n, 전술,용병학,책략,술책
tactile : a, 촉각의,만져서 알 수 있는
tactile impression(sensation) : x, 촉감
tactile organ : x, 촉각 기관
tactility : x, 감촉성,촉감
taction : n, 접촉
tactless : a, 요령이 없는,서투른
tactual : a, =TACTILE
TACV : x, tracked air cushion vehicle 공기 부상식 초고속 철도
tad : n, 꼬마(특히 사내 아이),약간,조금,소량,소년
tadpole : n, 올챙이
tadpole galaxy : x, 태드폴 은하(올챙이 모양의 외관을 가진 전파 은하)
Tadzhidistan : n, 타지크(공화국)(소련방의 한 공화국)
taedium vitae : n, 생의 권태,염세
taekwondo : n, (한국의) 태권도
tael : n, 테일(중국의 구화폐 단위,또 중량 단위)
taenia : n, (고대 그리스,로마의) 머리 장식용 띠(끈),(도리아식 건축에서) 기둥 상부의 띠 모양의 도래(frieze 아래의),끈 모양의 기관,촌충
taeniafuge : n, 촌충 구제약,촌충을 구제하는
taenioid : a, 끈 모양의,촌충 모양의
taffarel,tafferel : n, =TAFFRAIL
taffeta : n,a, (얇은) 호박단(의)
taffrail : n, 고물의 난간
Taffy : n, (속)Wales 사람
taffy : n, =TOFFEE,아첨
taffy pull : x, 태피를 만드는 모임
tafia : n, 태피아 술(럼주의 일종,서인도산
Taft Hartley Act : x, =LABOR MANAGENENT RELATIONS ACT
tag : vt, tag를 달다,잇다,압운하다,(술래잡기에서 술래(it)가) 붙잡다,붙어 다니다
Tagalog : n, 타갈로그 사람(필리핀 무손섬 중부의 원주민),타갈로그 말
Tagalog : n, (루손 섬의 말레이 족의 한 종족)타갈로그 인
tagalong : n,a, 언제나 남을 따라다니는 사람,트럭의 트레일러,남의 뒤를 따라다니는
tagari : n, 타가리(그리스의 숄더백)
tagboard : n, (짐표,포스터 용의) 두꺼운 종이
tag day : x, 가두 모금일
tag end : x, 마지막 부분(대목),끝토막,자투리,종말,말기
tagged atom : x, 표지(가붙은) 원자(방사성 원자핵을 가진 원자,특유한 방사능에 의하여 식별할 수 있음)
tagger : n, tag를 붙이는 사람(도구),얇은 생철
tagger : n, (술래잡기의) 술래
tagging : n, 표지 방류
tag line : x, 끝맺음말,결구,결언
tag match : x, 두사람씩 편짜고 하는 레슬링
tagmeme : n, 문법소(뜻을 갖는 문법의 최소 단위)
tagmemic grammar : ㅌ, 문법소 문법(K.L.Pike 등이 제창한 비국의 언어 이론)
Tagore : n, 타고르 Sir Rabindranath ~ (1861-1941)(인도의 시인, 1913년 노벨 문학상 수상)
tag question : x, 부가 의문
tagrag : n, 하층민,어중이떠중이,넝마
tag sale : x, 파치 염가 판매(장)
Tagt : n, 태프트 W.H.~ (1857-1930)(미국 제 27대 재통령)
tag team : x, (레슬링) 태그팀(2인조 팀)
Tahiti : n, 타히티 섬(남태평양의 섬)
taichi : n, 태극권(중국의 체조식 권법)
taiga : n, (시베리아 등지의) 상록 침엽수림(지대),타이가
tail : n,a, 계사 한정,한사 상속 재산(estate in ~ 이라고도 함),한사의
tail : vt, ...에 꼬리를 달다,잇다,꼬리를(끝을)자르다,...의 꼬리를 잡아 당기다,미행하다
tail-down : a,ad, 비행기의 미부를 내리는(내리고)
tail-end Charlie : x, 맨 뒤에 선 사람
tail back : n, (럭비) 후위
tailboard : n, (짐마차,트럭등의) 후미판(떼었다 붙일 수 있는)
tail coat : x, 연미복,모닝코트
tail cone : x, 테일콘(기체 꼬리 부분의 원추형 구조물)
tail end : x, 꼬리,끝
tailender : n, (사람,팀 등의) 꼴찌,최하위
tailer : a, 꼬리가 잘린,...한 꼬리가 있는,꼬리가...한
tailer : n, TAIL 하는 사람(것),(특히) 미행자
taileron : n, 테일러론(피치와 롤을 제어하기 위한 수평 미익)
tailfate : n,vi,vt, (트럭,홰건 등의) 뒷문, 차 뒤를 바싹 따라가다, 차에 바싹 대어 차를 몰다
tail fin : x, (자동차 뒤끝 양측의) 수직판
tailfirst : ad, 꼬리(꼬리 부분)를 옆으로 하고,뒷걸음질하여
tailgate picnic : x, 테일 게이트 피크닉(왜건 등의 뒷문에 음식을 펴 놓고 먹는 야외 파티)
tailgating : n, (미)(미식 축구의 팬 또는 응원하는 학생 등이) 시합 전후에 경기장 밖에서 가지는 야외 파티
tail group : x, TAIL UNIT
tail gun : x, 비행기의 미포
tailheavy : a, (비행기가)꼬리가 무거운
tailing : n, 물건의 마지막 부분,체질하고 남은 자갈,선광 부스러기,사라사를 물들일 때 생긴 흠
tail lamp : x, (light) 꼬리등
tailless : a, 꼬리가 없는,미부가 없는
tailless airplane : x, 꼬리에 날개가 없는 비행기
taillight : n, (열차,자동차 등의) 테일라이트,미등
tail margin : x, (책의) 페이지 아래쪽의 여백
tailor : n, 재봉사,양복장이,The ~ makes the man, 옷이 날개
tailor : vi, 양복점을 경영하다
tailor's chair : x, 다리가 없는 재봉사용 의자
tailor's chalk : x, 재단 초크
tailor's clippings : x, 양복감 견본
tailorbird : n, 재봉새
tailoring : n, 양복저 경영,재단업,양복 짓는 솜씨,사용 목적에 알맞게 만듦
tailormade : a,n, 특히 여성복을 남자 옷처럼 지은,산뜻한,주문품의,공장에서 만든(궐련)
tailpiece : n, 꼬리 조각,(책의) 장말,권말의 컷
tail pipe : x, (펌프의) 흡입관,(자동차 등의) 배기관,(제트 엔진의) 미관
tailpipe burner : x, =AFTERBURNER
tail plane : x, 수평 꼬리 날개(미익)
tailrace : n, (발전소,물방아의) 방수로,광석 부스러기 방출로
tail rotor : x, (헬리콥터의) 꼬리 회전 날개
tails : a,ad, (던진 화폐가) 뒷면이 나온 (나와서)
tail skid : x, 꼬리 썰매(기체를 안정시키는 착륙 장치)
tail slide : x, 후미 활공(비행기가 뒤쪽으로 활공하는 일)
tailspin : n, (비행기의) 나선식 급강하,낭패,혼란,공황,의기 소침
tail unit : x, 미익
tail water : x, 수차 방수로의 물,(댐 등의)방수된 물
tail wheel : x, (비행기 등의) 뒷바퀴,미륜
tail wind : x, 뒤에서 부는 바람
taint : vt,vi, 더럽히다,더러워지다,오염하다,해독을 끼치다(받다),썩(히)다
taint : n, 더럼,오명,(잠재한) 병독,감염,타락,기미
tainted : a, 썩은,더럽혀진
taintless : a, 더러워지지 않은,부패하지 않은,순결한,깨끗한
Taipeh,-pei : n, 타이페이
Taiping : n,a, 태평천국 농민 혁명 참가자,장발적,태평천국의,장발적의
Taiwan : n, 타이완(Formosa)
Taiwanese : a,n, 대만 (사람)의,대만 사람,대만 말
Taj Mahal : x, 타지 마할(인도 Agra에 있는 순백 대리석의 영묘)
taka : n, 타카(방글라데시의 화폐 단위)
takahe : n, (뉴질랜드 산) 타케이히,노토르니스
take : vt, 취하다,잡다,붙잡다,받다,획득하다(gain,win),섭취하다,먹다,마시다,(병이) 들다 (~cold 감기들다),타다(~ a train,plane,taxi),받아들이다,감수하다,따르다(submit to),필요로 하다,고르다,채용하다,(병에) 걸리다
take : vi, 취하다,(붙)잡다,(장치가) 걸리다(catch),(톱니바퀴가)맞물리다,(물고기,새 등이)걸리다,잡히다,뿌리가 내리다,(약이)듣다,(우두가)되다,(극,책이)호평을 받다,...으로 되다(become),(사진으로) 찍히다
take : n, 포획(수확),(입장권) 매상고,촬영
takealong : a, 휴대용의,여행자용의
takeaway : a,n, =TAKEOUT
takedown : n, 굴욕,창피 치욕
takehome (pay) : n, (세금 등을 공제한) 실수령 급료
takein : n, 사기,협잡
takeitorleaveit : a, 받아들이느냐 거절하느냐 양자택일의,교섭의 여지가 없는
takeitwithyou : a, 휴대용의,들고 다닐 수 있는
taken : v, take의 과거분사
takeoff : n, (익살스러운)흉내(mimicking),이륙(이수)
takeone : n, 한 장씩 떼도록 되어 있는 엽서(신청서)
takeone ad : x, 한 장씩 떼어 가는 광고지
takeout : a,n, 집으로 (사)가지고 가는 (요리)
takeover : n, 인계,접수,경영권 취득
takeover bid : x, (매수를 노리는 기업 주식의) 공개 매입
takeover zone : x, (육상의 릴레이에서) 바톤을 주고 받는 구역
taker : n, take하는 사람(것)
takest : v, =TAKE (thou가 주어일 때의 형태)
taketh : v, =TAKES
take up : n, 팽팽하게 침,죔,(천,종이 등을) 감아 올리는 장치,죄는 도구,실조이개,(필름) 감는 장치,(옷의) 수축
takin : n, 타킨(티벳산 영양의 일종
taking : a, 매력있는,전염하는,옮는
taking : n,pl, 취득,포획물,(물고기 따위의)포획고,수입
taking off : n, 제거,치우기,이륙,이수,이함,출발,흉내
taky : a, 매력적인,마음이 끌리는
tala : n, 탈라(서사모아의 화폐 단위)
talaria : n, (그,로신) 날개 달린 샌들(특히Hermes의)
Talatan : n, 엷은 메린스(무용복용)
Talbot : n, 톨벗(귀가 늘어진 사냥개의 일종)
talc : n,vt, 곱돌(로 문지르다)
talcum : n, 활석,곱돌(talc),= ~ powder (면도 후에 바르는) 화장 분말
talcum powder : x, 활석 가루,탤컴 파우더(활석 가루에 붕산말,향료 등을 섞은 것)
tale : n, 이야기,고자질,험담,소문,거짓말,수,총수,전체,tell its own ~ 자명하다,tell ~s(out of school) 고자질하다,비밀을 퍼뜨리다
talebearer : n, 고자질쟁이,나쁜 소문을 퍼뜨리는 사람
talebearing : n, 고자질,소문을 퍼뜨리기
talent : n, 고대 그리스,히부리의 무게(화폐) 이름,재능(for),재능 있는 사람들,인재,연예인
talented : ad, 재능 있는
talentless : a, 무능한
talentmoney : n, (크리켓)(프로 선수의) 우수 성적 특별 상금
talent scout : x, (운동,실업,연예계의) 인재(신인) 발굴 담당자
talent scout(spotter) : x, (스포츠,실업,연예계의) 신인 발굴 담당자
talent show : x, 탤런트 쇼(아마추어 연예인들이 연예계 진출을 위해 하는 공연)
taler : n, =THALER
tales : n, 탈러(독일의 옛 3마르크 은화)
talesman : n, 보결 배심원
taleteller : n, 이야기꾼,고자쟁이,소문 퍼뜨리는 사람
taletelling : n,a, 남의 비밀을 퍼뜨리는 (일)
tali : n, talus의 복수
talion : n, 동태 복수법(눈에는 눈,이에는 이로 는 복수법)
taliped : a, (발이) 굽은,발이 내반족인,발이 내반족인 사람(짐승)
talipes : n, 기형족,내반족
talipot : n, (인도 남부에서 사는) 탈리폿야자
talisman : n, 호부,부적
talisman : n, 부적,신비한 힘이 있는 것
talismanic : a, 부적의,귀신을 쫓는,마력 있는,신비한
talk : vi, 말(이야기)하다,의논하다(~ over a matter = ~ a matter over),(종알종알) 지껄이다
talkathon : n, (의사를 방해하기 위한) 지연 연설,(TV에서) 후보자와의 일문 일답
talkative : a, 말 많은
talkee-talkee : n, 아리송한 어법,(흑인 등의) 서투른 영어,(경멸) 수다,다변
talker : n, 이야기 하는 사람,말이 많은 사람,공론가,연설(강연)자,좌담가
talkfest : n, (형식에 구애되지 않는) 간담회,토론회
talkie : a, 토키,발성 영화,the ~s 발성 영화 (사업)
talkin : n, 항의 집회,격의 없는 회담,회의,토론
talking : a,n, 말하는,표정이 풍부한,수다(스러운),담화
talking book : x, 말하는 책(맹인용 레코드(테이프))
talkingdown system : x, 무전 유도 방식
talking film : =TALKIE
talking head : x, (텔레비전,영화에서) 화면에 등장하는 해설자(내레이터)
talking machine : x, 축음기
talking paper : n, 입장 표명서
talking picture (f'ilm) : x, 발성영화
talking point : x, 화제
talking shop : x, (경멸) 잡담 장소(의회 등)
talkingto : n, 잔소리,꾸지람
talk jockey : x, (미 전화로 청취자가 참가하는 라디오 프로의) 사회자
talk show : x, (방송에서) 유명 인사 특별 출연 프로(토론회,인터뷰)
talk show : x, (미)(텔레비전,라디오에서) 유명인사 인터뷰 프로
talky : a, 수다스러운,(극,소설 등) 쓸데없는 대화가 많은
tall : a, 키 큰,높은(a ~ man,tower,tree,&c),...높이의,(값이)엄청난,과장된
tallage : n,vt, (영주에게 납부한) 토지 사용료,지대,토지 사용료를 부과하다
tallboy : n, 다리가 높은 장롱
tall copy : x, 상하의 여백을 보통 책보다 많이 두고 재단한 책
tall drink : x, 톨드링크(알코올 음료에 소다,과즙,얼음 등을 넣어 운두가 높은 잔에 마심)
tall hat : x, 실크 해트
tallish : a, (키가) 좀 (약간) 큰
talllith,-lit : n, 탈리스(유대인 남자가 아침 기도 때 걸치는 숄)
tallness : n, 높음,높이
tall oil : x, 톨유
tall order : x, 어려운 주문,무리한 요구
tallow : n,vt,vi, 짐승 기름,수지 양초,수지를 바르다,(양을) (수지를 얻기 위해) 살찌게 하다,수지가 생기다
tallow chandler : n, 수지 양초 제조(판매)인
tallowfaced : a, 해쓱한
tallowy : a, 수지(모양)의,수지를 바른,기름기 있는,살찐(짐승),창백한
tall poppy : x, (오스구) 봉급을 많이 받는 사람,걸출한 인물
tally : n, 부신,그 눈금,짝의 한쪽,일치,물표,표,패(tag),계산,득점
tally clerk : x, 화물계,(선거의)계표원
tallyho : n, 쉭쉭~ (사냥꾼이 여우를 발견하고 개를 추기는 소리),대형 4두마차
tallyman : n, 할부 판매인,수를 세는 사람,(하역 등의)계수 담당,검수계,내연의 남편
tally sheet : x, 계산 기입지,투표수 기입지
tallyshop : n, 할부판매점
Talmud : n, 탈무드(유대 법전 및 전설집)
talmudic : a, talmud의(와 같은)
talmudical : a, talmud의
talmudist : n, talmud편집자(연구가,신봉자)
talon : n,pl, (맹금의)발톱 (claw),움켜쥐는 손
taloned : a, talon의 형용사
talos : n, 탈로스(Daedalus의 조카,Crete 섬을 지키게 하기 위하여 Hephaestusr가 만든 청동인간),(미군)탈로스(지대공 유도 미사일)
talow : n,vt, 수지 (쇠기름) (를 바르다)
talus : n, 거골,복사뼈
talus : n, 경사,(담 따위의) 물매진면,경사면,(낭떠러지 아래의)경사 암석퇴
tam : n, =TAM-O'-SHANTER
tamable : a, 길들일 수 있는,사육할 수 있는
tamale : n, 타말레(옥수수 가루,다진 고기,고추로 만든 멕시코 요리)
tamandua : n, 작은 개미 핥기(열대 아메리카산)
tamarack : n, 아메리카 낙엽송,그 제목
tamarin : n, 타마린(남미산 비단 원숭이과)
tamarind : n, 타마린드(열대산 통과의 상록수),그 열매
tamarisk : n, 위성류
tamarugo : n, 타마루고(칠레의 사막에서 자라는 콩과식물)
tamasha : n, (동인도 제도에서의)구경거리,흥행,행사
tambala : n, 탐발라
tambour : n, 북,수(틀)
tambourin : n, 탕부랭(남프랑스의 무용(곡))
tambourine : n, 템버린(가장자리에 방울을 단 손북)
tame : a, 길든,길들인,순한,무기력한,재미없는,따분한
tame : vt,vi, (길러) 길들(이)다,복종시키다,누르다,무기력하게 하다,(색을) 부드럽게 하다
tameable : a, =tamable
tameless : a, 길들지 않은,야생의
tamely : ad, 길들어서,유순하게
tameness : n,  길들여져 있음,유순,온순,무기력
tamer : n, (야수 등을)길들이는 사람
Tamerlane : n, (1336-1405)티무르(몽고왕)
tamerlane : n, 타메를란
Tamil : n, (남인도 및 Ceylon 섬의) 타밀 사람(말)
Tammany : n,a, 태머니파(의)
tammy : n, =TAM-O'-SHANTER,스코틀랜드 사람
tamoshanter : n, 큰 흑두건 비슷한 스코틀랜드의 베레모
tamoxifen : n, 유방암 치료에 쓰이는 항에스트로겐 약물
tamp : vt, (흙을) 밟아(다져) 단단하게 하다,(폭약을 잰 구멍을) 진흙 (등)으로 틀어막다
tamper : vi, 간섭하다(meddle),만지작 거리다,장난하다(with),(원문을) 함부로 변경하다(with),뇌물을 주다(with)
tamperevident : a, 손댄 흔적이 분명한,개봉한 흔적이 보이는
tamperindicative : a, =tamperevident
tamperproof : a, 간섭을 방지할 수 있게 되어 있는,독극물 혼입 등을 하기 쉽게 되어 있는
tamperresistant : a, (포장 등이)손을 타기 어렵게 되어 있는
tamping : n, 틀어막음,충전,탬핑,충전재료
tampion : n, 나무마개,포전,(파이프오르간의)음관전
tampon : n,vt, 지혈전,탐폰(을 틀어막다)
tamponade : n, 탐폰 삽입법
tamtam : n, 징(gong)
tan : vt, (가죽을)무두질하다,(피부를) 햇볕에 태우다,매질하다(thrash)
tan : vi, 햇볕에 타다
tan : n,a,pl, 탠 껍질 (무두질용의 나무 껍질) 햇볕에 탄 빛깔(의),황갈색(의),황갈색 옷 (구두)
tanager : n, (아메리카산의) 풍금조
tananarive : n, 티나나리브
tanbark : n, 탠(tan) 껍질
tandem : ad, (한줄로)세로 늘어서서
tandem : a,n, 세로 늘어세운 (말,마차),2인승 자전거
tang : n, 싸하는 맛,톡 쏘는 냄새,특성,기미,슴베(칼,끌 등의)
tang : n,vt,vi, (금속 등의)날카로운 소리,(종 따위가) 뗑하고 울리다
tanga : n, 탕가(짧은 끈 모양의 비키니)
Tanganyika : n, 아프리카 동부의 지역
tangelo : n, 탄젤로(귤과 그래이프프루트의 교배종)
tangency : n, 접촉
tangent : n,a, 탄젠트,접하는,접선(의),fly (go) off at a ~ 갑자기 길로 벗어나다
tangential : a, 접선의,접선에 따라 작용하는,접하는,거의 관계가 없는,빗나가는,탈선하는
tangerine : n, 귤의 일종
tangibility : n, 만져서 알 수 있음,명백,확실
tangible : a, 만져서 알수 있는,확실(명백)한
tangible : n,pl,  유형재산
tangible : n, 엉킴,분규,혼란
tangier : n, 탠지어(아프리카 북서부 끝에 있는 모르코의 옛 국제 관리 지대
tangle : vt,vi, 엉키(게 하)다,얽히(게 하)다,빠뜨리다,빠지다,
tangled : a, 얽힌,분규의,혼란을 일으킨
tanglefoot : n, (싸구려)위스키,독한술
tangly : a, 뒤얽힌,혼란된
tango : n, 탱고(춤,곡)
tangram : n, 지혜 놀이판
tangya : n, 짜릿한,(냄새가) 톡 쏘는
tank : n, (물,가스 등의)탱크,물,저수지,전차,탱크
tank : vt, 탱크에 넣다(저장하다)
tankage : n, 탱크 사용료,탱크 설비,탱크 저장,탱크 찌기(지스러기 고기,내장 등을 탱크에 넣어 지방을 채취하고 남은 찌끼)
tankard : n, 대형 맥주컵
tankatorium : n, 탱크 요법 진료소
tankbuster : n, 대전차포,대전차포 탑재기
tank car : x, 탱크차(액체,기체 수송용)
tank destroyer : x, 대전차포
tanked : a, 만취한
tanker : n, 탱커,유조선,급유(비행)기,전차 대원
tankman : n, 탱크 담당자
tank station : x, 급수역
tank truck : x, 탱크차,유조(수조)트럭
tannable : a, 무두질할 수 있는
tannage : n, 무두질
tannate : n, 타닌산염
tanned : a, 무두질한,햇볏에 탄
tannenbaum : n, 크리스마스트리
tanner : n, 무두장이,제혁소,무두질(공장)
tannery : n, 무두질 공장
tannic : a, 탠껍질에서 얻은,타닌성의
tannic acid : n, 타닌산
tannin : n, 타닌산
tanning : n, 무두질,햇볕에 태움(탐),매질
tannish : a, 황갈색을 띤
tannoy : n, 태노이(스피크 장치)
tansy : n, 쑥국화,양톱풀(즙을 오물렛에 넣어 부활절에 먹음)
tantalization : n, 감질나게 함
tantalize : vt, 보여서 감질나게 하다,주는 체하고 안주다
tantalizing : a, 애타게 하는,감질나게하는
tantalum : n, 탄탈(금속원소)
Tantalus : n, zeus의 아들,그리스의 왕(신벌로 물속에 턱까지 잠겨졌는데,물을 마시려 하면 물이 빠지고,머리 위의 과실을 따려고 하면 가지가 뒤로 물러갔음)
tantamount : a, 동등한,같은(to)
tantara : n, 나팔(뿔피리) 소리 (비슷한 소리)
tantivy : n, 질주,돌진,(질주하라)는 소리
tanto : ad, 지나치게,너무,그렇게(지시로서)
tantony : n, (한배 중)가장 작은 돼지새끼
tantra : n, 탄트라(힌두교,불교 경전)
tantrum : n, 울화
tanyard : n, 무두질 공장
Tanzania : n, 아프리카 중동부의 공화국
tanzanian : a,n, 탄자니아의,탄자니아 사람
Taoism : n, (노자의)도교
Taoist : n,a, 도사,도교의,도교신자(의)
taoistic : a, 도교의
tap : vt,vi,n, 가볍게 치다(두드리다),가볍게 치기(두드러기),그 소리,똑똑 (두드리다),(구두 바닥에) 가죽을 대다,창갈이 가죽,소등나팔
tap : n, 꼭지,통주둥이(faucet),마개(plug),탭,콘센트,술의 종류(품질),술집,on ~(언제나 마실 수 있게)꼭지가 달려,언제든지 쓸 수 있게)꼭지가 달려,언제든지 쓸수 있게 준비되어
tap : vt, (통에) 꼭지를 달다,(통의) 꼭지로부터 술을 따르다(~ a cask),...의 꼭지를 따다,(나무에)진집을 내어 수액을 받다,째고 물(따위)을 빼다,(전기 본선에서) 지선을 끌다,(본길에서) 셋길을 내다,(전화를)도청하다
tapa : n, 타파천 (남양산의 나무 껍질로 만든 깔개)
tap dance : x, 탭댄스
tapdance : vi, 탭 댄스를 추다
tapdancing : n, =tapdance
tape : n, (납작한) 끈,테이프,(천 또는 강철로 만든)줄자,녹음테이프,스카치테이프(따위),breast the ~ 가슴으로 테이프를 끊다,1착이 되다
tape deck : n, 테이프 덱(앰프,스피커가 없는 테이프 리코더)
tapedelay : n,   테이프딜레이,녹음시차,라이브 이중녹음
tapeline : n, 줄자
tape machine : x, 테이프 레코더,증권 시세 표시기
taper : n, 가는 초,초먹인 심지,약한 빛,끝이 뾰족함 (뾰족한 모양)
taper : a, 끝이 가는
taper : vi,vt, 점점 가늘어지다(가늘게 하다),점점 줄다(away,off,down)
taperecord : vt, ...을 테이프에 녹음하다
tape recorder : x, 테이프 녹음기
tape recording : x, 테이프 녹음
tapering : a, 끝이 뾰족해진(가늘어진),점점 적어지는,체감의
tapestried : a, TAPESTRY로 꾸민
tapestry : n,vt, 무늬 놓은 두꺼운 천(의 벽걸이)(으로 꾸미다)
tapeworm : n, 촌충
taphonomy : n, 화석 생성(론)
tapioca : n, 타피오카(cassava 뿌리의 전분)
tapir : n, 맥(중남미산)
tapis : n, 무늬놓은 두꺼운 테이블 보,on the ~ 심의중에
tapotement : n, 경타 안마법
tapper : n, 전신기의 키,전건,(열차의)검차원
tappet : n, 태핏,철자
tappintg : n, 복수 천취,암나사 깎기,(통신의)도청
taproom : n, (호텔 따위 안의)술집
taproot : n, 직근
taps : n, 소등 나팔(북),(군대장,위령제의)영결 나팔
tapster : n, (술집의)급사 (특히 남자의)
taptap : n, 똑똑 (두드리는 소리)
tar : n,vt, (콜)타르(를 철하다),뱃사람,~ and feather 타르를 칠하고 새털을 온몸에 꽂다(린치),엄하게 벌하다
taramasalata : n, 타라마살라타(어란으로 만든 그리스식 오르되브르)
tarantass : n, 타란타스(러시아의 대형 4륜 마차)
tarantella : n, (남이탈리아의) 경쾌한 춤,타란텔라 무곡
tarantism : n, 무도병
tarantula : n, 독거미의 일종
taratantara : n, 딴따라따(나팔소리)
taraxacum : n, 민들레 무리,그 뿌리에서 만든 약제
tarboosh : n, 터킴모자(이슬람 교도의 차양 없고 술 달린 남자용 모자)
tarbrush : n, 타르 솔,흑인의 혈통
tardiddle : n, 거짓말
tardigrade : a,n, (걸음,움직임이)느린,굼뜬(slow),완보류의,완보류의 동물
tardo : a,ad, 느린,느리게
tardy : a, (걸음걸이 등이)느린(slow),더딘(in),늦은(late)
tardyon : n, 타디온입자(광속보다 느린 소립자)
tare : n, 살갈퀴(vetch),가라지,해독
tare : n,vt, 포장 중량(을 달다,공제하다)
targe : n, 작은 원형 방패
target : n, 과녁,목표,목표액,hit a ~ 과녁에 맞히다,목표액에 달하다
targetable : a, 목표를 정할 수 있는
targeting : n, 약물 표적화(환부에 약물을 유효하게 도달시켜 약효의 지속화,증강을 꾀하는 일
target practice : x, 사격연습
targtcard : n, (사격의)득점 기록 카드
Targum : n, 타굼
Tarheel,t- : n, North Carolina의 주민(태생 사람)
tariff : n, 관세(세율)표,관세(on),(여관 등의)요금표,운임(표),요금
tariff wall : x, 관세 장벽
tarmac : n, 타르머캐덤 도로(활주로)
tarmacadam : n, 타르머캐덤(쇄석과 타르를 섞어 굳힌 포장 재료),그 포장 도로
tarn : n, (산속의)작은 호수
tarnish : vt,vi, 흐리(게 하)다,(명예 따위)손상시키다(되다)
tarnish : n, (광물 따위의)흐림,녹,더러움,오점
taro : n, 타로 토란(남양산의 식용,장식용 식물)
tarot : n,타로 카드(22매 한 벌),
tarpan : n,타팬(Tatrar horse)(중앙 아시아 초원 지대의 발이 빠른 소형의 야생마,19세기에 멸종),
tarpaulin : n, 방수포,방수 외부(모자)
tarpon : n, 미국 남해안산의 큰 물고기
tarradiddle : n,TARADIDDLE,
tarragona : n, 단맛이 도는 포도주
tarred : a, 타르를 칠한
tarry : vi, 머무르다(stay)(at,in),망설이다,늦어지다,기다리다
tarry : vt, 기다리다
tarry : a, 타르(질)의,타르를 칠한,타르로 더럽혀진
tarsal : a,n, 족근골의,안검 연골의,족근골
tarsia : n, (이탈리아의)쪽나무 세공,쪽모이
tarsier : n, 안경 원숭이(동남 아시아산)
tarsus : n, (발의) 부골,안검 연골
tart : a, 신,신랄한
tart : n, 과일을 넣는 과자(파이),갈보,매춘부
tartan : n, (스코틀랜드의 고지 사람이 입는)격자 무늬의 모직물(옷),격자무늬
tartan track : x, 탄타트랙(아스팔트 위에 합성 수지를 깐 전천후 경주로)
Tartar : n,a, 달단사람(의,같은),난폭자(a young ~ 다루기 힘든 아이),catch a ~ 만만치 않은 상대를 만나다
tartar : n, 주석,치석
tartar(e) sauce : x, 마요네즈에 썬 오이나 올리브 등을 넣어 만든 소스
Tartarean : a, 지옥의(infernal)
Tartarian : a, 타르타르(사람)의
tartaric : a, 주석의 (을 함유하는)
tartaric acid : x, 주석산
Tartarus : n, (Hades 보다 훨씬 아래에 있는) 지옥(골짜기)
Tartary : n, 타타르(지방)
tartlet : n,작은 파이,
tartrate : n,주석산염,
tartrated : a,주석산과 화합한,주석을 함유한,
Tartuffe : n,타르튀프(프랑스의 극작가 Moliele 작의 희극 제명 위선자,	
Tarzan : n, 타잔,초인적 힘을 가진 사람
Tasaday : n,타사다이족(Mindanao섬의 동굴에 사는),타사다이 말,
Taser : n,vt,테이저 총,테이저총으로 쏘다,
Tashkent : n,타슈켄트(소련 uzbek공화국의 수도),
tasimeter : n,미압계,
task : n, (의무적인) 일,직무,작업,사업,고된 일,call(take) a person to ~ 비난하다,꾸짖다(for)
task : vt, 일을 과하다,혹사하다
task force : x, 기동부대,특수 임무 부대,특별 전문 위원회,프로젝트 팀
taskmaster : n, 십장,감독
taskwork : n, 할당된 일,강제 노동,도급일
Tasmania : n,태즈메이니아,
tasmanian : a,n,데즈메이니아의 (사람),
Tass : n, (소련의) 타스 통신사
tassel : n,vt, 술(장식)(을 달다),(옥수수의)수염(을 뜯다),(책의)서표 끈
tassel : vi, (옥수수 따위)수염이 나다
tasset : n,(갑옷의)허리에서 넓적다리까지 늘이는 방호구,
Tassie : n,Tasmania,그 주민,
Tasso : n,타소,
tastable : a,=tasteable
taste : vt, 맛보다,먹다,마시다,경험하다
taste : vi, 맛을 보다,...의 맛이 나다,풍미(기미)가 있다(of)
taste : n, 맛,풍미,미각,경험,시식,한 입,한 번 맛보기,취미,기호,심미안,풍치,a bad ~ in the mouth 개운치 않은 뒤맛,나쁜 인상,in good(bad) ~ 품위 있게(없게),to the King's(Queen's)~ 더할 나위없이
tasteable : a,맛볼 수 있는,맛 있는,
taste bud : x, (혀의) 미뢰
tasteful : a, 풍류있는,품위있는,풍아한
tasteless : a, 맛 없는,아취 없는,품위없는
taster : n,맛보는 사람,맛을 감별하는 사람,검미기,원고 심판원,
tasty : a,맛 좋은,멋있는,고상한,세련된,
tat : vt,vi, 태팅(tatting)을 하다(으로 만들다)
tata : int, 안녕,빠이빠이
tatar : n,타타르 사람,타타르 말,
Tatarian : a,=Tartar,
Tataric : a,=Tartar,
tatary : n,=Tartary,
tatersall : n,태터솔 무늬,
tatra : n,타트라(체코제 자동차),
tatter : n, 넝마,누더기옷
tatter : vt, 너덜너덜 해뜨리다(찢다)
tatterdemalion : n, 누더기를 걸친 사람
tattered : a,해진 옷,
tatting : n, 태팅(뜨개질의 일종),그렇게 뜬 레이스
tattle : n,vi,vt, 객담(뒷공론)(을 하다),고자질(하다)
tattletale : n,a, 밀고자(의)
tattoo : n,vi, 귀영 나팔(을 불다),귀영북(을 치다),똑똑 두드리다(두드리는 소리).beat the devil's ~ 손가락으로 책상 따위를 똑똑 두드리다(초조,기분이 언짢을 때)
tattoo : n,vt, 문신(을 넣다)
tatty : a, 초라한,넝마의,싸구려의
tau : n, 그리스어 알파벳의 19번째글짜
taught : v, teach의 과거(분사)
taulogous : a,=tautollgist,
taunt : vt,n, 욕설(을 퍼붓다),조롱,냉소,조롱거리,욕하여...시키다
tauntingly : ad, 욕지거리 하여,조롱하여
Taunton : n,톤턴,
taupe : n, 두더지색,진회색
taurine : a,=bovine,황소자리의,
tauromachy : n,투우술,
Taurus : n, 황소자리,금우궁
taut : a, 팽팽하게 친(tight),(옷차림이) 단정한(tidy)
tauten : vt,vi, (...을) 팽팽하게 켕기다
tautog : n, 미국 대서양 연안산 도미류의 물고기
tautological : a,동의어 중복의중언부언하는
tautologist : n,동의어를 되풀이 하는 사람,
tautologize : vi,동의어를 되풀이하다,되풀이해서 말하다,
tautology : n, 뜻이 같은 말의 반복
tautomer : n, 호변체,
tautomeric : a,,
tautomerism : n, 호변이성
tavern : n, 선술집,여인숙(inn)
taw : n, 돌튀기기,튀김돌,돌튀기기의 개시선
tawdrily : ad,
tawdry : a,n, 몹시 야한,값싼(물건)
tawnily : ad,
tawniness : n,
tawny : n,a, 황갈색(의),(사자의 빛깔)
taws : n,vt,가죽 채찍(아이들을 벌주는),징계,가죽 채찍으로 때리다,
tax : n, 세금 조세(on,upon),(무리한)요구,과로(strain)
tax : vt, 과세하다,무거운 짐을 지우다,혹사하다,무리한 요구를 하다,청구하다,비난하다(accuse),(소송 비용 등을)사정하다
taxability : n,,
taxation : n,과세,징세,세제,전조세,세수,소송 비용 사정,
taxble : a,n, 과세해야 할,세금이붙는,과세 대상,
tax collecotr : x, (g'atherer)징세리
taxdeductible : a,소득에서 공제할 수 있는,
taxdermic : a,박제(술)의,
tax dodger : x, 탈세자
taxdodging : a,탈세하는,
taxeme : n,문법 특성소,
tax evasion : x, 탈세
taxexempt : a, 면세의
tax farmer : x, 세금 징수 청부인
taxfarmer : n,세금징수 청부인,
taxflation : n,높은 세율이 주요 원인이 되어 일어나는 인플레이션,
taxfree : a, =TAX EXEMPT
taxgatherer : n,=Taxcollector,
tax haven : 세금피난지,
taxi : n,vi,vt, 택시(로 가다,로 운반하다),(비행기가) 육상(수상)을 활주하다(시키다)
taxicab : n, 택시
taxi dancer : x, (댄스홀의) 직업댄서
taxidermal : a, 박제(술)의
taxidermist : n,박제사,
taxidermy : n, 박제술
taximan : n, 택시 운전기사
taximeter : n, 택시요금 표시기
taxing : a,부담스러운,고생스러운,귀찬은,
taxingly : ad,
taxingmaster : n,소송 비용을 부과하는 관리,
taxiplane : n, 전세비행기
taxis : n,순서,배열,(탈장등의)정복술,주성,배치,순서,분대,
taxi stand : x, 택시 승차장
taxiway : n, (비행장의)유도로
taxless : =taxfree,
taxman : n,세금징수원,
taxmobile : n,순회 세무 서비스차,
taxology : n,분류학,
taxonomist : n,분류학자,
taxonomy : n, 분류(학)
taxpayer : n, 납세자
tax reduction : x, 감세
tax return : x, 납세(소득세) 신고서
taxtion : n, 과세,세수
Tay-Sachs : n,a,테이색스병,테이색스병의
Tayside : 테이사이드(1975년에 신설된 스코트랜드 중동부주의 주,
taza : n,taxon의 복수,
tazza : n,높은 굽이 달린 큰 접시,
TB : n, (폐)결핵(tuberculosis)
Tbar (lift) : x, 티바리프트(케이블에 늘인 거꿀 T자꼴의 스키리프트)
Tchaikovsky : n, Peter Ilych(1840-93)러시아의 작곡가
tchick : int,n,vi,이러 쯧쯧,(말을 몰 때 혀 차는 소리),쯧쯧하고 혀를 차다,
tchotchke : n,조그만한 장남감,골동품,장식 소품,
tea : n, 차(보통,홍차),차잎,(차 비슷한) 달인물(beef~),저녁식사,black(green)~ 홍(녹)차,high(meat) ~ 고기 요리를 곁들인 오후의 차
teaberry : n,=checkerberry,
teaboard : n,찻쟁반,
tea break : x, 차마시는(휴게) 시간
tea caddy : x, 차통
tea cart (wag(g)on) : x, 찻그릇 운반대
teach : vt, (taught)가르치다,교수(훈련)하다
teach : vi, 가르치다,선생질하다(at),I will ~ you to (tell a lie,betray us,& c)(거짓말을,배반을)하면 용서 안할 테다
teachable : a,가르침을 받을만한,잘 알아 듣는,가르치기 쉬운,
teachbility : n,교육용으로 알맞음,학습 능력,
teachbly : ad,
teacher : n,선생,가르치는 사람,
teachers college : x, 교육대학
teachership : n,교직,
teachin : n, 티치인(대학 안에서 학생이 중심이 된 정치,사회 문제 등의 토론 집회),토론회
teaching : n,가르치기,교습,교수,수업,
teaching aid : x, 교구
teachness : n,
teachnophobe : n,과학 기술을 겁내는 사람,
teachware : n,시청각 교재,교구,
tea cozy : x, (차 끓이는 주전자의) 보온카버
teacup : n, 찻잔
teacupful : n, 찻잔 하나 가득한 양
Teague : N,(경멸)아이랜드 사람,
teahouse : n, (한국 등지의)다방,찻집
teak : n, 티크,티크재(가구재,조선재)
teakettle : n, 차(물)끓이는 주전자
teakwood : n,티크재,
teal : n, 상오리
tea leaf : pl, 차잎,엽차,차찌끼
tealeaf : n,찻잎,차 찌꺼기,도둑,
team : n, 팀,(수레에 맨) 한 떼의 짐승 (소,말 등)
team : vi, 한 떼의 짐승을 몰다,팀이 되다
team : vt, 한 수레에 매다,한데 맨 짐승으로 나르다
team game : x, 단체경기
teammate : n, 팀의 일원
team spirit : x, 단체(공동)정신
teamster : n, 한데 맨 짐승떼(team)를 부리는 사람,트럭 운전기사,두목,왕초
teamwork : n, 협동(작업)
tea party : x, 다과회
tea plant : x, 차나무
teapot : n, 찻주전자
teapoy : n,작은 탁자,
tear : n,pl, 눈물,비애,in ~s 울며
tear : vt,vi, 찢(어 지)다,잡아뜯다,할퀴다,쥐어뜯다(~ one's hair),분열시키다(하다),괴롭히다,돌진하다,미친듯이 날뛰다(about,along),~ away 잡아째다(떼다),질주하다,~ down 당겨 벗기다,부수다
tear-off : n,(절취선이 있는)절취 부분,
tearaway : n,돌진하는(무모한)젊은이,망나니,
tear bomb : x, 최루탄
teardown : n,분해,해체,
teardrop : n, 눈물방울
tear duct : x, 누선
tearer : n,찢는 사람,사납게 날뛰는 것,폭풍우,
tearful : a,눈물어린,곧잘 우는,슬픈,
tearfully : ad,
tearfulness : n,
teargas : vt, (폭도등에) 최루가스를 사용하다(쏘다)
tearing : a,ad,(잡아)찢는,쥐어 뜯는,사납게 날뛰는,맹렬한,맹렬이,냅다,미친듯이,
tearjerker : n, 눈물을 짜게 하는 영화(노래,이야기)
tearless : a,눈물 없는,눈물을 흘리지 않는,무정한,
tearoom : n, 다방
tearspoonful : n, 찻숟가락 하나의 양
tearstained : a, 눈물로얼룩진
tear strip : x, (깡통,담배갑 둘레의) 따개비
teary : 눈물의(같은),눈물이 글썽한,
tease : n, 괴롭히는 사람,괴롭히기,놀려대는 사람,놀려대기,조르는 사람,조르기
teasel : vt, 티즐(보풀 세우는 기구)로 보풀을 세우다
teaser : n,괴롭히는 사람,남자를 애타게 하는 여자,소모기,어려운 일,
tea service (set) : x, 차그릇일습,티세트
teashop : n, 다방,경식당
teasing : a,짖궂게 괴롭히는,귀찮은,
teaspoon : n, 찻숟가락
teaspoonful : n,찻숫가락으로 하나,약간,소량,
teat : n, 젖꼭지(nipple)
teathings : n, =TEA SERVICE
teatime : n,(오후의) 차마시는 시간,
tea tray : x, 찻쟁반
teaurn : n,차탕관,
teazel,-zle : n,v, =TEASEL
teched : a,머리가 조금 돈,
techie : n, 기술 특히 전자분야의 전문가,열광자
technetium : n, 테크네튬(인공 원소,기호 Tc)
technetronic : a, 과학기술(전자공학)이 지배하는 (시대,사회),정보화 시대의 (사회)
technic : n,pl, 학술(전문)어,학술(전문)적 사항(법칙),공예(학)
technic : a, =TECHNICAL
technical : a, 공업의,공예의,전문의,기술(상)의,학술의
technicality : n, 전문(학술)적임,학술(전문)사항,전문어
technical knockout : x, 테크니컬 녹아웃
technically : ad,전문적으로,기술적으로,,법 적으로,
technical school : x, 공업 학교
technical sergeant : x, 중사(현재는 sergeant first class)
technical terms : x, 술어,전문어
technician : n, 기술자,전문가
technicism : n,갸술(지상 주의,
technicist : n,=technician,
Technicolor : n, (미국의) 테크리컬러식 천연색 촬영법(에 의한 천연색 영화)
technics : n,=technic,
technify : vt,vi,기술화 하다,기술 혁신하다,고도로 기술화하다,
technique : n, (예술상의)기법,기교
techno : (기술,기교,공예)의뜻,
technocentered : a,과학기술 중심주의,
technocracy : n, 기술자 정치,기술 중심주의(1932년경 미국서 제창)
technocrat : n, 
technocratic : a,
technography : n,과학사,기술사,
technological innovation : x, 기술혁신
technologist : n,과학기술자,공학자,
technologize : vt,기술 혁신하다,
technology : n, 과학(공업)기술,공예(학),전문어
technomania : n,과학기술편중주의,
technopeasant : n,기술(컴퓨터)에 약한 사람,
technophoobia : n,과학 기술 공포증,
technopolis : n,기술 지배 사회,
technopolitan : a,기술 지배 사회의,
technosphere : n,인류의 과학 기술적 행동,
technostress : n,테크노 스트레스(고도 과학화 사회에의 적응에 실패했을 때 생기는 증상),
technostructure : n,기술 구조(전문 지식을 가진 사람들로 된 의사 결정 조직),
techscam : n,(첨단 기술정보를 입수하는)스파이 행위에 대해 함정 수사,
techy : a,=TETCHY,
tectology : n, 조직 형태학
tectonics : n, 축조학,구조학,구조지질학
tectonomagnetism : n,지각 자기,
Ted : n, Edward,Theodor,Theodore의 애칭
tedder : n, 건초기
teddy : n,풀을 말리는 사람(기계),
teddy bear : x, (특히 봉제훔의)장남감 곰
teddy boy : x, (1950년대의 영국의)반항적 청소년
tedious : a, 지루한,장황한
tedium : n, 권태
tedium vitae : x, =ANNUI
tee : n,vt,vi, 공자리(위에 놓다(공을)),목표,정확한 점,~ off (공을)공자리에서 치기 시작하다,(제안 따위를)개시하다,to a ~,or to a T 정연히
teehee : int,n,지루한,지겨운,진저리,
teel : n,참깨,참기름,
teem : vi, 충만하다,많이 있다(abound) (with)
teemful : a,풍부한,수확이 풍성한,
teeming : a,풍부한,우글우글한,새끼가 많은,다산의,
teen : n,비탄,불행,
teenage : n,a, 10대의 소년(소녀)
teener : n, =TEEN-AGER
teenpix : n,pl,10대를 위한 영화(kids movie),
teens : n,pl, 10대(a girl in her ~,10대의 소녀),high (middle,low)
teensy : a,=TINY,
teensyweensy : a,
teenybopper : n, 10대의 소녀,히피 훙내를내거나 일시적 유행을 쫓는 10대
teenyweeny : a,=TINY,
teepee : n, =TEPEE
teeter : n,vi,vt, 시소(seesaw),전후(상하)로 흔들어 움직이다
teeterboard : n,=SEESAW,티터보드(널뛰기 널같이 한쪽 끝에 뛰어내리면 다른쪽의 끝의 사람이 튀어오르는 널),
teetertotter : =SEESAW,
teeth : n, tooth의 복수
teethe : vi, 이(젖니)가 나다
teething : n, 젖니의 발생
teethridge : n,치경,잇몸,
teetotal : a, 절대 금주의,절대적인,완전한
teetotum : n, 네모 팽이
teevee : n, 텔레비젼
Teflon : n, 테플론(열에 강한 수지)
Tegucigalpa : n,테구시갈파(Hounduras 공화국의 수도),
tegular : a,기와의(같은),미늘단,어깨판의,
tegument : n, 외피
Teh(e)ran : n, 테헤란(이란의 수도)
tehee : n,int,vi=TEEHEE,
teil : n, 보리수(linden)
tektite : n, n,텍타이트(흑요석 비슷한 유리질 물질)
telaesthesia : n, 원격 지각(먼 곳에서 생긴 일을 초감각적으로 지각하는 일)
telamon : n, 남상주
telautogram : n, 전송 서화 인쇄물
TelAutograph : n, 서화 전송기
Tel Aviv : n, 텔아비브 (Israel 최대의 도시)
tele : pref, 먼,텔레비전(의)의 뜻
telearchics : n, (무전에 의한 항공기의) 원격 조종
telecamera : n, 텔레비전 카메라
telecast : n,vt,vi, 텔레비전 방송(을 하다)
telecaster : n, 텔레비전 방송자,텔레비전 뉴스 해설자
telecine : n, 텔레비전 영화
telecom : n, 전기 통신
telecommunication : n, 원격 통신
telecommute : n, 텔레컴퓨니케이셔(전기 통신과 전자 계산기가 융합한 새로운 정보 처리의 공학,기술,산업(분야)
telecon : n, 텔레콘(원격 회의용 텔레타이프 영사 장치(에 의한 회의))
teleconference : n, (텔레비전,전화를 이용한)원격지간 회의
teleconsultation : n, 원거리 상담(원거리 측정 기기나 텔레비전을 이용한 의료 상담)
telecontrol : n, (전파 등에 의한) 원격 조작
Telecopier : n,전화 복사기(문자나 도형을 전화로 전송하고 복사하는 텔레팩시밀리,상표명),
telecourse : n, 텔레비전 강좌
telediagnosis : n, 텔레비전 (원격)진단
teledrama : n,=TELEPLAY,
teledu : n,말레이오소리(Java 및 Sumatra 산),
telefacsimile : n, 전화 전송
telefilm : n, 텔레비전 영화
telegenic : a, 텔레비전(방송)에 알맞은
telegony : n,텔레비전 방송에 알맞은,텔레비전에 잘 영사되는,
telegram : n, 전보
telegraph : n,vt,vi, 전신(기),타전하다
telegrapher : n,전신 기사,
telegraphese : 전문체,극단적으로 간결한 문체(말투),
telegraphic : a,전신기의,전송의,전신(전보)의,
telegraphist : n,전신 기사,
telegraph money order : x, 전보환
telegraphone : n,(구식의)전자식 녹음(재생)기,
telegraphy : n, 전신(술)
telegraphy : n,전실(술),
teleguide : vt, vt,(미사일 등의)원격 유도하다
telekinesis : n, 격동(외력을 가하지 않고 사람,물건을 움직이는)
telekinesis : n, 격동 (현상),염동 작용
telelecture : n, 전화 강연(전화를 이용한 마이크 방송)
teleman : n, 사무,암호,통신 임무를 맡은 상급하사관
telemark : n,vi, (스키)텔레마크 회전(하다)
telemarketing : n, 전화 판매,전화 광고
telematiks : n,
telemechanics : n,pl(기계의)원격 (무전)조종법,
telemedicine : n,(전화,텔레비전으로 환자가 받을 수 있는)원격 의료,
telemeter : n,vt,vi측거기,원격 계측기,(자동 계측 전송 장치),(측정치를)원격 계측기로 송신하다,
telemetric : a,
telemetry : n, 원격 측정법,원격 계측기로 얻은 자료
telemotor : n, 텔레모터,원격 조타기
teleological : a, 목적론(적)의
teleology : n, 목적론
teleonomy : n, 목족론적 법칙,목적률
teleoperator : n, 원격 조작 장치(로봇)
teleosaurus : n, 완룡속(중세대의 파충류)
telepaper : n, 텔레비전 신문
telepathic : a, 정신 감응(가능)론
telepathist : n, 텔레파시 연구가,텔레파시 능력자
telepathize : vt,vi, 텔레파시로 전하다,정신 감응술을 쓰다
telepathy : n, 정신 감응,이심전심현상
telephone : n, 전화(기),by ~ 전화로,~booth (공중)전화실,~ directory 전화 번호부,~ exchange (office) 전화 교환국
telephone : vt,vi, 전화로 이야기하다,전화를 걸다(to),전화로 불러내다
telephonee : n, 전화 받는 사람,수화자
telephoner : n, 전화 거는 사람
telephonic : a, 전화
telephonist : n, 전화 교환수
telephonitis : a, 전화(기)의,전화에 의한
telephony : n, 전화(술)
telephote : n, 사진 전송기
telephoto : n,a, 망원 사진(의)
telephotograph : n,vt, 망원 사진(을 찍다),전송 사진(을 보내다)
telephotographic : a,
telephotography : n, 망원 사진술,사진 전송술
teleplay : n, 텔레비전 드라마(극)
teleport : vt, (물건,사람을)염력으로 움직이다(옮기다)
teleprinter : n, =TELETYPEWRITER
teleprocessing : n, 텔레프로세싱(통신 회선을 통해 행하는 데이터 처리)
TelePrompTer : n, 텔레프롬프터(글씨가 테이프처럼 움직여 연기자에 대사 등을 일러주는 장치)
teleran : n, 텔레란(레이다 항공술)
telerecord : vt, (TV)녹화하다
telerecording : n, 녹화,녹화 프로그램
telergy : n, 원격 정신 작용
telescope : n,vi,vt, 망원경,(충돌하여) 박(히)다,짧아지다,짧게하다
telescopic : a, 망원경의,망원경으로 본(볼 수 있는),멀리 볼 수 있는,뽑았다 끼웠다 할 수 있는,신축 자재의
telescopist : n, 망원경 사용자,망원경 관측자
telescopy : n, 망원경 사용(제조)법
telescreen : n, 텔레비전 수상면(면 유리판)
telescript : n, 텔레비전 프로용 대본
telesecurit : n, 전화 도청 방지
teleseism : n, 먼 곳에서 일어난 지진에 의한 미동
teleshopping : n, 텔레쇼핑(TV에 나온 물건을 보고 주문하기)
telesis : n, (지적 노력의 동원에 의한)목적 달성,지적으로 계획된개발
telespectroscope : n, 망원 분광기
telestereoscope : n, 입체 망원경
telesthesia : n, =TELAESTHESIA
teletex : n, 텔레텍스(종래의 Telex를 고속,고성능화한 것)
teletext : n, 문자 다중 방송
telethermometer : n, 원격 자기 온도계
telethon : n, (자선 등을 위한) 장시간 텔레비전 프로그램
teletranscription : n, TV프로의 녹화
teletype,T- : n,vt,vi, 텔레타이프(전신 인자기) (로 송신하다,를 조작하다)
Teletypesetter : n, 전신 식자기
teletypewriter : n, 전신 인자기
teletypist : n, 텔레타이프 타자수
teleview : vt,vi, 텔레비전으로 보다
televise : vt, 텔레비전으로 보내다(보다)
television : n, 텔레비전
televisionese : n, 텔레비전 용어
Televisor : n, 텔레비전 장치
televisual : a, 텔레비전(방송)의
televkewer : n, 텔레비전 시청자
televox : n, (발성 장치를 가진)기계 인간(robot)
teleworking : n, 자택 근무(telecommuting)
telewriter : n, 전기 사자기,인자 전신기
Telex : n, 텔렉스(국제 텔레스 타이프 자동 교환기)
telfer : n,a, =TELPHER
tell : vt,vi, 말하다,이야기하다,언급하다,고하다,누설하다,명하다,알다(Who can ~? 누가 알 수 있겠는가),분간하다(~ silk from nylon 비단과 나일론을 분간하다),세다,고자질하다,(약,말,타격이)효력(반응)이 있다,명중하다
teller : n, 말하는 사람,세는 사람,(은행의)금전 출납 계원,투표 집계원
telling : a, 효과적인,유효한,현저한,뚜렷한,인상적인,감정(속사정)을 (저도 모르게)나타내는,드러내는
tellingly : ad, 효과적으로,강력하게(forcefully)
tellodynamic : a, 동력 원거리 전송의
telltable : n,a, 고자쟁이,수다쟁이,(감정,비밀 등의) 표시,증거,자연히 나타나는,숨길 수 없는
telltale : 남의 말하기 좋아하는 사람,고자질하는 사람,밀고자,비밀(속사정 등)을 폭로하는 것,증거,자동 표시기,지수기,등록기,출퇴근 시각 표시 시계(time clock),(오르간의)풍압표시기,타각 표시기,달아맨 나침의,경렴(터널 등의,접근을 알리는 위험 표지),고자질하는,비밀을 폭로하는,감추려해도 드러나는,(자동적으로)점검기록(경고)하는(장치 등)
tellurian : a, 지구(지상)의(주민)
telluric : a, 지구의,땅에서 생기는,텔루르의(를 함유하는)
tellurium : n, 텔루르(비금속 원소,기호 Te)
tellurize : vt, 텔루루화하다,텔루르로 처리하다
telly : n, 텔레비전
teloholic : n, 텔레비전 중독자
telome : n, 텔롬(유관속 식물의 구조 단위)
telop : n, 화면에 삽입되는 글자 따위
telophase : n, (유사 핵분열의)말기
telotype : n, 인자 전신기,인자 전보
telpher : n, (가선식) 전기 케이블카
telpherage : n, 텔퍼 운반 장치
telson : n, 꼬리마디
Telstar : n, (미국의) 통신위성
temblor : n, 지진
temerity : n, 만용,무모
Temin enzyme : x, 테민 효소(RNA에서 DNA를 만드는 역전사 효소)
Teminism : n, 테민이론(역전사 이론)
temp : n,vi, 임시 직원,임시 교용 비서,임시 직원으로 일하다
temper : n, (여러 가지 재료의) 알맞은 조합정도,적당한 정도,(마음의)침착,평정,(강철의)되불림,(회반죽의)굳기,기질,기분,hot ~ 발끈거리는 성미,in a good(bad) ~ 기분이 좋아서(나빠서),in a ~,or out of ~ 화가 나서
tempera : n, 템페라화(법)
temperament : n, 기질,성미,격정,평균율(법)
temperamental : a, 기분의,기질상의,타고난,신경질적인,변덕스러운,성마른
temperamentally : ad, 기질적으로,성질상,흥분하기 쉽게
temperance : n, 절제,삼감,절주,금주
temperate : a, 절제하는,삼가는,온건한,절(금)주의,온난한
temperately : ad, 적당하게,절도 있게,온건하게
Temperate Zone : x, the 온대
temperature : n, 온도,체온,run a ~ 열이 있다,열을 내다,흥분하다,take one's ~ 체온을 재다
temperaturehumidity index : x, 불쾌지수
tempered : a, 조절된,완화된,(강철이)불린,달구어 단련한
tempersome : a, 참을성이 없는
tempest : n, 사나운비바람,폭풍우(설),대소동
tempestswept : a, (불운,불행 등에)시달린,번롱된
tempesttossed : a, 폭풍우에 시달린,세파에 시달린
tempestuous : a, 사나운 비바람의,폭풍(우)같은,격렬한
Templar : n, =KINGHT TEMPLAR
template : n, 본 뜨는 공구,형판,보받이,도리 받이,조선대의 쐐기,(핵산의)주형
temple : n, 성단,신전,절,고대 유대의 3신전의 하나,(기독교의 어떤 송파의)교회
temple : n, 관자놀이
tempo : n, 속도,박자,템포
temporal : a, 현세(뜬 세상)의,세속의,때의,시간의,순간적인
temporal : a,n, 관자놀이의,측두골
temporality : n, 세속적 소유물(특히 교회,성직자의 수입,재산),세속적(정치적) 권력(권위),속사,속인,속계,일시적 소유(수입),(영원에 대하여)일시적임,덧없음
temporalty : ad, 시간적으로,속사에 관하여
temporary : a, 일시의,잠시의,임시의,덧없는
temporization : n, 타협,미봉,형세 관망
temporize : vi, 형세에 따르다,기회주의적 태도를 취하다,타협하다,(시간을 벌기위해)꾸물거리다
temporizer : n, 시세에 영합하는 사람,기회주의자
temporizing : a, 고식적인,임시변통의,타협적인,기회주의적(영합적)인
tempt : vt, 유혹하다,(식욕을)당기게 하다,꾀다(to do),성나게 하다,무릅쓰다,시도하다,~ providence 모험하다
temptable : a, 유혹할 수 있는,유혹받기 쉬운
temptation : n, 유혹(물)
tempter : n, 유혹자(물),악마,사탄
tempting : a, 유혹하는,부추기는,황홀하게 하는,마음(구미)이 당기는
temptress : n, 유혹하는 여자
tempus fugit : x, 세월은 화살 같다
temulent : a, 술에 취한
ten : n,a, 10(의),열 개(사람)(의),~ to one 십중 팔구(까지),the best ~ 10걸
tenability : n,
tenable : a, (성,진지 등)지킬수 있는,(학설 등)조리에 댑e
tenace : n, 2장의 끗수 높은 패를 맞추기
tenacious : a, 고집하는,완고한,(기억력이)강한,끈기 있는
tenacity : n, 고집,끈기,강인성,완강,불굴,점착력,뛰어난 기억력
tenaculum : n, 지지 고리,간직틀
tenancy : n, (땅,집의)임차,그기간
tenant : n, 차지인,차가인,소작인,거주자
tenant : vt, 빌다,임차하다,...에 살다
tenantable : a, (토지,가옥 등)임차할 수 있는,거주할 수 있는
tenant farmer : x, 소작농
tenantless : a, 빌어 쓸 사람(거주자)이 없는,빈땅(집)의
tenantry : n, 차지인(소작인,차가인)의,지위(신분),토지(가옥)의 차용,전 차지인,소작인,차가인
tencent store : x, 10센트 균일의 상점
tench : n, 잉어의 일종(유럽산)
tend : vt, 지키다(watch over),돌보다,간호하다
tend : vi, 시중들다(on,upon),주의하다(to)
tend : vi, 향하다,기울다(to),경향이있다,...하기 쉽다(be apt),도움이 되다(to)
tendance : n, 시중,돌보기
tendencious,-tious : a, 경향적인,목적이 있는,선전적인
tendency : n, 경향,버릇,(이야기의)취지
tendentious : a, (문서,발언 등이)특정 입장을 옹호하는 경향이 있는,선전적인,편향적인
tender : n, 감시인,돌보는 사람,간호인,부속선,(기관차의)탄수차
tender : vt, 제출(제공,제의)하다,(감사 등을)말하다,(접견 등을)허용하다
tender : vi, 입찰하다(for)
tender : n, 제공(물),신청,입찰,변화
tender : a, (살,피부,색,빛 따위가)부드러운,허약한,무른,부서지기(상하기)쉬운,민감한,상냥한,친절한,젊은,연약한,텔리키트한,...을 조심(걱정)하는(of,for)
tendereyed : a, 눈매가 부드러운,시력이 약한
tenderfoot : n, (미국 서부의 목장,광산 등의)신출내기,풋나기
tenderhearted : a, 상냥한,인정많은
tenderize : vt, (고기 등을)연하게 하다
tenderloin : n, (소,돼지의)연한등심,(뉴욕에 있던 악덕으로 이름난)환락가,부패한거리
tenderly : ad, 상냥하게,유약하게,상하기 쉽게,예민하게
tenderminded : a, 이상주위적인,낙관적인,독단적인
tenderminded : a, 마음이 약한,이상주의적인,관념론적인
tenderness : n, 유연함,마음이 무름,민감,친절,다정,애정
tenderometer : n, (과일,야채의)성숙도 측정기
tendinitis : n, 건염
tendinous : a, 건의(같은)
tendon : n, 건
tendril : n, 권수,덩굴손
tenebrific : a, 어둡게 하는,어두운
tenebrous : a, 어두운,음침한
tenement : n, 보유물,차지,차가,가옥
tenemental : a, 보유물의,주택의,차지(차가)인이 보유하는
tenement house : x, 싸구려 아파트,연립주택
tenesmus : n, 이급후중(배설 후에 남는 불쾌한 동통
tenet : n, 신조,주의,교의
tenfold : a,ad, 10배의(로),열겹의(으로)
tengallon hat : x, 카우보이 모자
tenner : n, 10파운드 지폐,10달러 지폐
Tennessee : n, 미국남동부의 주
tennies : n,pl, 테니스화(tennis shoes)
tennis : n, 테니스
tennis court : x, 테니스 코트
tennis elbow : x, 테니스 등이 원인으로 생기는 팔꿈치의 관절염
tennist : n, 테니스하는 사람,테니스 선수
Tennyson : n, ,Alfred (1809-92) 영국의 시인
tenon : n,vt, 장부(를 만들다),장부이음하다
tenor : n, 진로,취지,대의,테너(가수)
tenorist : n, 테너 가수(악기 연주자)
tenorless : a, 방침(취지)이 없는
tenotomy : n, 건절제술
tenpeg : n, 천막 발뚝(쐐기못)
tenpercenter : n, (작가,연예인의)대리인,에이전트(인세,출연료의 10%를 받는 데서)
tenpins : n,pl, 십주희,십주희용 기둥
tenpounder : n, 10파운드 무게의 물건(탄환,물고기 등),10파운드 포,값 10파운드의 물건,10파운드의 지폐,1년에 10파운드의 땅세(집세)를 바차고 선거권을 얻는 사람,청어 비슷한 은빛의 큰 물고기(lady fish)
tenred : a, 천막을 친,천막으로 덮인,천막을 숙사로 하는,천막 모양의
tense : a, 팽팽한,긴장한
tensed : a, 정신적으로 긴장한,신경이 곤두선
tensibility : n, 신장성
tensible : a, 잡아 늘일 수 있는
tensile : a, 장력의,잡아늘일 수 있는
tensility : n, 장력,신장성
tensimeter : n, 가스 압력계,증기 압력계
tensiometer : n, 장력계
tensiometry : n, 장력학
tension : n, 팽팽함,긴장,(정신,국제 관계의)긴장,장력,팽창력,(기체의)압력,전압
tensional : a, 긴장(성)의
tensioned : a, 긴장된
tensity : n, 긴장(상태)
tensive : a, 긴장의,긴장을 일으키는
tenson : n, 논쟁시,경시
tensor : n, 장근,텐서
tenspeed : n, 10변속의 자전거
tenspot : n, (카드의)10점 패,10달러 지폐,10년의 형
tenstrike : n, (tenpins 게임에서)기둥 10개를 전부 넘어뜨리기,대성공
tent : n,vt,vi, 텐트(에서 자다),천막으로 덮다,주거,pitch(strike) a ~ 텐트를 치다(걷다)
tentacle : n, 촉각,촉수
tentacled : a, 촉수(촉각)가 있는
tentative : a, 시험적인,시험삼아 하는
tent caterpillar : x, 천막 벌레
tenter : n,vt, 재양틀(에 치다)(천을)
tenterhook : n, 재양틀의 갈고리,be on ~s 조바심하다
tenth : n,a, 제 10(의),10째(의),10분의 1(의),(달의) 10일,(시계)운량 단위 기수
tenthrate : a, 최저(질)의
tenuis : n, 무성 파열음
tenuity : n, 가늚,엷음,희박(빈약)(함)
tenuous : a, 가는,얇은,희박한,미미한
tenure : n, (재산,지위 등의)보유,그 기간,조건,~ of life 수명
tenured : a, 보유권이 있는,종신적 지위가 있는
tenuretrack : a, 종신적 지위를 인정받게 될 교직 신분의,종신적 신분으로 연결 될 코스에 있는
tenuto : a, 음을 지속한(하여)
teocalli : n, 구상 신전(고대 멕시코,중앙 아메리카에 Aztec원주민이 쌓은 제단)
teoepayment : n, 텔레페이먼트
tepa : n, 제암제
tepee : n, (아메리카 토인의) 천막집
tepefy : vt,vi, 미지근하게 하다,미지근해지다
tephra : n, 테프라(분화시에 방출되어 공중을 날라 퇴적한 화산재)
tephrite : n, 테프라이트(회색 현무암)
tephrochronology : n, 테프라 연대학(잔존 화산재(tephra)를 분석하여 과거의 분화시기를 추정하는연구)
tepid : a, 미지근한,미온의
tepidarium : n, (고대 로마 목욕탕의)미온 욕실
tepidity : n, 미지근함,열의가 없음(tepidness)
tequila : n, 테킬라(멕시코 산의 증류주)
teracycle : n, 테러사이클
terahertz : n, 테라헤프츠
terahim : n, (고대 헤브라인의)가신상,드라빔
terai : n, 타라이 모자(아열대 지방에서 쓰는 챙 넓은 펠트 모자)
terany : n, 테타니(강직성 경련)
teratism : n, 기형,괴기,취미,괴물 숭배
teratogen : n, 기형 발생 물질
teratogenesis : n, 기형을 발생(생성)
teratogenetic : a, 기형을 발생(생성)하는
teratoid : a, 기형 비슷한,기형종의
teratological : a, 기형학상의
teratology : n, 기형학,괴기담(집)
teravolt : n, 테라볼트
terawatt : n, 테라와트
terbium : n, 테르븀(금속원소)
terce : n, 제3시과(오전 9시의 성무)
tercentenary : n,a, 300년(의),300년제(의)
tercentenary : a, 300년(간)의
tercet : n, 3행(압운)연구,3연음
terdo : n, 좀조개
tereamong : ad, 그것들 사이에서
tereanent : ad, 그것에 대해서(관해서)
terebene : n, 테레빈(도료,방부제용)
terebinth : a, 테레빈(성)의
tergal : a, 등(부분)의(dorsal)
tergiversate : vt, 변절하다,어물쩍거리다,얼버무리다(evade)
tergiversation : n, 핑계,속임,변절
term : n, 기한,기간,학기,(법원의) 개정기,(지불의) 기일,(한정하는) 조건,조항,(계약.지불.값등의)약정,요구액,값,(한정된)개념,말,용어,말투,명사,bring(come) to ~s 항복시키다(하다),절충이 되다,타협하다
term : vt, 이름짓다,부르다
termagancy : n, (여자의)억척스러움,괄괄함,입정 사나움,잔소리가 심함
termagant : a,n, 잔소리가 심한,쨍쨍대는 여자
terminable : a, (계약,연금 등)기한이 있는
terminal : a, 끝의,마지막의,종점의(a ~ station 종착역),정기의,학기의
terminal : n, 말단,종착역,단자,학기말 시험,(컴퓨터) 단말장치
terminal voltage : x, 극전압
terminate : vi,vt, 끝나다,끝내다,다하다,한정하다,...의 한계를 이루다
termination : n, 종결,만기,말단,한계
terminational : a, 어미의
terminative : n, 끝내는 사람(것),(달,별의)명암 경계선
terminatory : a, 말단의,말단(한계)을 이루는
termini : n, terminus의 복수
terminism : n, 은혜 유한설(신이 정한 회개의 시기를 지나면 구원 받을 기회를 잃는 다는),명사론,유명론
terminlolgical : a,n, 술어학(상)의,술어의,용어상
terminology : n, 술어,용법(법)
terminus : n, 종점,종착역,한계,경계,흉상주
termitarium : n, 흰개미의 집
termite : n, 흰개미
Termite : n, 테르밋
termly : ad, 정기적으로
termor : n, 정기 부동산권자,종신 토지 보유자
termtime : n, 학기(법정 개정 기간)중의 시기
tern : n, 제비갈매기
ternary : a, 3의,3원의
terne : n, 턴메탈(주석과 납의 합금)
terneplate : n, 턴플레이트(턴메탈을 씌운 연강판)
terotechnology : n, 보전 공학
terpene : n, 테르펜
terpolymer : n, 3량체
Terpsichore : n, 가무의 여신
terra : n, 땅,토지,대지,지구
terrace : n, 대지,높은지대(에 늘어선 집들),(뜰 따위의) 단,(집에 이어진)테라스,납작한 지붕
terraced : a, 층층단으로 된
terracotta : n,a, 붉은 질그릇(꽃병,기와,상 따위),적갈색(의)
terra firma : x, 육지,견고한 지위
terrain : n, 지대,지세,지형
terra incognita : x, 미지의 땅(영역)
Terramycin : n, 테라마이신(항생물질 약)
terrane : n, 암층,암군
terrapin : n, (북미산) 식용거북
terrarium : n, 동물 사육장
terrazzo : n, 테라조(대리석을 골재로 한 콘크리트)
terrene : a, 지구의,토지의,흙의,현세의,속세의(earthly)
terrestrial : a,n, 지구의,육지의,육상의,육지에 사는,지상의,속세의(worldly),지상에 사는것,인간
terrestrial globe : x, 지구(본)
terrestrial gravitation : x, 지구 인력
terrestrial magnetism : 지자기,
terrestrial planet : x, 태양에서 가까운 행성(수성,금성,지구,화성)
terret : n, (안장의)고삐 꿰는 고리
terrible : a, 무서운,극히 서투른
terrible : ad, 몹시
terribly : ad, 무섭게,무시무시하게,지독하게,몹시(extremely)
terrier : n, 테리어(몸집이 작은 개)
terrific : a, 무서운,대단한,굉장한
terrified : a, 무서워하는,겁먹은,겁에 질린
terrify : vt, 겁나게(놀라게)하다
terrifying : a, 겁나게 하는,놀라게 하는,무서운
terrigenous : a, 지상에(땅에서)서 생긴(earthborn),(해저 퇴적물이)육성의,육원의
terrine : n, (요리를 담은 채 파는)질그릇 단지,단지에 담은 음식물
territorial : a, 영토의,토지의,지역적인,~ waters 영해,~ principle 속지주의
territorial : n, 국방 (의용)군 병사
territorialism : n, 지방주의,지방 수비군(국토 의용군)제도,(교회 제도의)자방 국교주의,유대인 자치구역 획득 운동
territoriality : n, 영토권,영토임,영토의 지위,세력권 의식,텃세,세력권(텃세권)제도
territorialize : vt, 영토로 삼다,(...의)영토를 넓히다,지방화하다
territory : n, 영토,판도,(과학 따위의)분야,지역,비방,(행상인의)담당 구역
terror : n, 공포,무서움(in ~ 무서워서),무서운사람(것),성가신 녀석,the king of ~s 죽음,the Reign of T- 공포시대(프랑스 혁명 중 1793년 5월부터 이듬해 7월 까지)
terrorism : n, 공포정치,테러 행위
terrorist : n, 공포 정치가,폭력(혁명)주의자,테러리스트
terroristic : a, 폭력주의의,테러의
terrorization : n, (공포 수단에 의한)위협,타협
terrorize : vt, 공포의 도가니로 몰아넣다,위협하다,공포 정책으로 지배하다,테러 수단을 쓰다
terrorstricken : a, 겁(공포)에질린
terrqueous : a, 수륙의,육지와 물로 된
terry : n, (cloth) 테리천(보풀을 고리지게 짠 두꺼운 직물)
terry towel : x, 테리 타월
terse : a, (문체가) 간결한(succinct)
tertachloride : n, 4염화물
tertial : n, (칼 깃이)제3열의,제 3열 칼깃
tertian : a,n, 사흘마다 일어나는,격일의
tertiary : a,n, 제 3(위)의,제3기,3차어(구)
tertius : a, 제3의,(학교에서 이름이 같은 3명의 학생 중)가장 나이 어린
tervalent : a, 3가의,3개의 다른 원자가를 가진
Terylene : n, 테릴렌(폴리에스터 섬유)
terzetto : n, 3중창(곡),3중주(곡)
tessellar : a, 모자이크 세공의,모자이크 모양의
tessellate : vt, 조각맞춤세공을 하다,모자이크로 하다
tessellate : a, 모자이크로 한
tessellated : a, 모자이크(식)의,바둑판(격자)모양의(마룻바닥)
tessellation : n, 모자이크 세공
tessera : n, (모자이크용)각석,모난 유리(기와 등),표,패,주사위(뼈,상아,나무 등의)
tesseract : n, 4차원 입방체
tesseral : a, 모자이크의,등축 정계의
tessitura : n, 성역,음역
test : n, 테스트,검사,시험(put to the ~ 시험하다),시험물,시약,시금석,stand the ~ 합격하다,시험에 견디다
test : vt, 검사(시험)하다
testa : n, 종피,종각
testable : a, 시험(검사,분석)할 수 있는,정련할 수 있는
testacean : n, 유각 아메바류(Testacea)의 동물
testaceous : a, 겉 껍질이 있는,겉 껍질 (모양)의,적갈색의
testacy : n, 유언이 있음
testament : n, 성약(서),유언(서)
testamental : a, 유언의
testamentary : a, 유언서의,유언서에 의한
testamur : n, (대학의)시험 합격증
testate : a,n, 유언서를 남긴 (사람),유언자
testation : n, 유언에 의한 유산 처리,유증,입증,증언
testator : n, 유언자
testatrix : n, 여자 유언자
testatum : n, (날인 증서 등의)본문
test ban : x, 핵실험 금지 협정
test bed : x, (항공기 엔진 등의) 시험대
test case : x, 테스트케이스,첫시도,시소
testcross : n,vt, 검정교잡(하다)
testdrive : vt, (자동차에) 시승하다
tested : a, 시험을 거친,경험이 풍부한,시험 (검사)필의
testee : n, (시험 등의) 수험자
tester : n, 시험자,시험기
testfire : vt, (로켓,미사일 등을) 시험 발사하다
testfly : vt, 시험 비행을 하다
testicle : n, 고환
testiculat : a, 고환의
testiculate : a, 고환 모양의
testification : n, 입증,증언,증거(evidence)
testify : vi,vt, 증명(입증)하다,증인이 되다(to),확언하다,~ one's regret 유감의 뜻을 표하다
testimonial : n, 증명서,표창장,기념품,사례
testimony : n, 증거,증명,증언,신앙 성명,항의(against),신의 가르침,성서,십계
testing : a,n, 최대한의 능력(노력)이 요구되는,극히 어려운,테스트(하기),시험,실험
testis : n, =TESTICLE
testmarket : vt, 시험 판매하다
teston : n, 테스톤(16세기 프랑수 은화)
testosterone : n, 테스토스테론 (남성호르몬)
test paper : x, 시험지
test patten : x, 시험 방송용 도형
test pilot : x, (신조기의) 시험 조정사
test tube : x, 시험관
testtube : a, 시험관에서 만들어낸,인공수정의
testtube baby : x, 시험관 아기
testtype : x, 테스트 타이프(시력 검사표의 문자들)
testudinalp : a, 거북의(같은),귀갑의
testudinate : a,n, 귀갑모양의(arched),거북목의 동물
testudo : n, (거북딱지 모양의)공성용 큰 방패,남생이 무리
testy : a, 성미 급한
tetanic : a,n, 파상풍(성)의,강직,경련 유기제(스트리 키니네 등)
tetanize : vt, (근육에)강직 경련을 일으키게 하다
tetanus : n, 파상풍(cf. lockjaw)
tetchy : a, 성미 까다로운
teteatete : ad,a,n, 단둘이서(의),마주보고,마주앉은,비밀 이야기,밀담,마주 앉은 두사람,2인용 의자
tether : n,vt, (소.말의) 매는 사슬(밧줄)(로 매다),한계,범위,at the end of one's ~ 갖은 수가 다하여,궁지에 빠져
tetherball : n, 테더볼(기둥에 매단 공을 가켓으로 치고 받는 게임),그 공
tetra- : x, 넷의 뜻의 결합사
tetracaine : n, 테트라카인(국부마취제)
tetrachord : n, 4도 음계,고대의 4현금의 일종
tetracycline : n, 항생물질의 하나
tetrad : n, 4(개),4개 한 벌,4가 원소,4분자(감수 분열로 생기는 4세포),4분 염색체
tetradactylous : a, 4지를 가진
tetradctyl : n, 4지 동물
tetraethyl lead : x, 테트라에틸연,4에틸연
tetragon : n, 4각형
tetragonal : a, 4각형의,정방정계의
tetragram : n, 4자어
tetrahedral : a, 4면(체)의
tetrahedron : n, 4면체
tetrahydrocannabinol : n, 마리화나의 유효 성분
tetralogy : n, 4부극 (세 비극과 한 풍자극으로 이루어짐)
tetrameter : n, 사보격
tetrapetalous : a, 꽃잎이 넷인,4화판의
tetraploid : a,n, (염색체가)4배성의,4배체
tetrapod : n, (호안공사용의)테트라포드,네발짐승
tetrarch : n, 4분 영주 (한 주의 4분의 1을 다스리는 영주)
tetrastich : n, 4행시,4행절
tetrastichous : a, (꽃이)4열의,(이삭 등이)4열의 꽃이 있는
tetrastyle : n, 4주식의(건물
tetrasyllable : n, 4음절어
tetravalent : a, 4가의
tetrode : n, 4극(진공)관
tetroxide : n, 4산화물
tetrtodotoxin : n, 테트로도 톡신(복어 독의 성분)
tetter : n, 습진,수포진
Teuton : n, 튜튼사람 (영국,독일,네델란드,스칸디나비아 사람 등),독일사람
Texan : a,n, 텍사스의 (사람)
Texas : n, 미국 남서부의 주
Texas leaguer : x, 테사스리거(내야수와 외야수 사이에 떨어지는 안타)
Texas Ranger : x, 테사스 기마경관
Texas tower : x, 해중탑(해저 유정,등대,관측 레이더용)
Text : n, 본문,원문,텍스트,성구(특히 설교 제목으로 인용되는),화제(topic),논제
textbook : n, 교과서
textbookish : a, 교과서 식의
textbookperfect : a, 교과서처럼 완전한
text edltion : x, 교과서판
textile : a,n, 직물의,짠,직물,직물 원료,~ fabrics 직물,~ industry 직물 공업
texttospeech : a, 텍스트를 음성으로 변환한,맹인용 녹음 테이프의
textual : a, 본문(원문)(상)의
textuary : n, 성서 본문에 정통한 사람,(특히 성서의)원문주의자
textural : a, 조직상의,피륙의
texture : n, 천감,직물,(피부의)결,(돌,목재의)결,조직,(문장,그림,악곡의 심리적인)감촉
textured : a, 직물의 짜임이 ...한
Thai : n, 타이 사람,타이 말
Thailand : n, 타이
Thailander : n, 타이 사람
thalamic : a, 시상의
thalamus : n, 시상,화탁,the optie ~ 시신경상
thalassochemistry : n, 해양 화학
thalassocrat : n, 제해권을 쥔 자
thalassography : n, (연안)해양학
thaler : n, 독일의 구은화 이름
Thales : n, 탈레스
Thalian : a, THALIA의,희극의
thalidomide : n, 탈리도마이드(전에 진정,수면제로 쓰이던 약),~ baby 기형아(탈리도마이드계 수면제의 영향에 의한 기형아)
thallic : a, 탈륨의,3가의 탈륨을 함유한
thallium : n, 탈륨(금속 원소;기호 Tl)
thalloid : a, 엽상체의(같은),엽상체로 된
thallophyte : n, 엽상식물(이끼,말,균류 따위)
thallophytic : a,
thallous : n, 엽상체
thallus : n, 엽상체
thalweg : n, 요선,골짜기선,항행 수로의 중앙선(국경선)
Thames : n, (the ~)런던을 흐르는 강,(He will not) set the ~ on FIRE
than : conj, ...보다(도),(rather,sooner등의 다음에서) ...하기보다는(차라리)...,(other,else등의 다음에서)...밖에 딴,...이외에는,...과 다른
than : prep, (than whom 의 꼴로) ...보다
thanage : n, THANE의 신분(영지)
thanatoid : n, 사망학자
thanatology : n, 사망학
thanatophobia : n, 사망 공포(증)
thanatopsis : n, 죽음에 관한 고찰,사관
Thanatos : n, 타나토스(죽음의 의인),죽음의 본능
thane : n, 대향사(귀족의 아래),(스코틀랜드의)(왕령) 영주
thank : vt, 감사하다,I will ~ you to (shut the window), (창문을 닫)아 주시오,No,~ you, 아니오,괜찮습니다(사양),You may ~ yourself for (that), 자업자득일세
thankful : a, 감사하고 있는(to him for it)
thankless : a, 감사하는 마음이 없는,은혜를 모르는(ungrateful),감사를 받지 못하는(a ~ job (task)) 공을 알아 주지 않는 일
thanksgiver : n, 감사하는 사람
thanksgiving : n, 감사,사은
thankworthy : a, 감사해야할,고마운
thankyou : a,n, 감사를 나타내는,사은의,감사의 말,(고맙습니다)라는 말
that : pron, 저것,그것,저 사람,...의 그것,(...하는)바의,and all ~ 및 그런등속,...따위(등등),and ~ 게다가,at ~ 그렇다 치더라도,게다가,그리고 또,이야기는 그쯤하고,~ is (to say) 즉, So ~'s ~, 이것으로 그만(끝)
that : a, 그,저
that : conj, ...이라는 (것),...이므로
that : ad, 그렇게(so),그 정도로
that's : x, that is(has)의 단축
thatch : n,vt, 이엉(을 이다),띠(억새)(로 이다),초가지붕,띠(억새)로 이은 지붕
Thatcher : n, ,Margaret (1925 - ) 영국 보수당의 정치가,수상 (재직 1979-)
thaumatrope : n, 회전 그림판(원반의 일면에 새장을,다른 면에 새를 그려서 돌리면 새가 새장 속에 있는 것처럼 보임)
thaumaturgy : n, 마법(magic)
thaw : n,vi, 해동,눈이(서리가)녹음,(눈,서리가)녹다,날씨가 풀리다,(몸이)차차 녹다,(마음,태도가)누그러지다,풀리다
thawy : a, 눈(서리)이 녹는,녹이는
thckness : n, 두께;굵기;(등 등의)두꺼운 부분,농후;농도,치밀,농밀;(올의)촘촘함;밀집,무성,빈번,머리가 둔함,우둔,혼탁;불명료,(일정한 두께의 물건의)한장
the : ad, ...하면 할수록,~ better 빠르면 빠를수록 좋다,none ~ better for doing ...해도 마찬가지
theandric : a, 신인의,그리스도의,신인 양성을 가진
theanthropic : a, 신인 양성을 갖춘
theanthropism : n, 신인 일체(설),그리스도 신인설,신에게 인성을 부여하기
thearchy : n, 신정,신정국,신들의 계통
theater : n, 극장,(the ~)(연)극,극작품,연극계,(극장의)관객,(계단식)강당,수술교실,활무대(the ~ of war 전쟁터)
theatergoer : n, 자주 연극을 보러가는 사람
theatergoung : n, 연극 구경,관극
theaterintheround : n, 원형극장
theater of the absurd : x, 부조리극
theatric : a, =THEATRICAL
theatrical : a, 극장의,연극(상)의,연극 같은
theatricality : n, 연극적임,부자연스러움
theatricalize : vt, ...을 고장하여(연극조로)하다,극화(각색)하다(dramatize)
theatrics : n, 연극법,연출법,연극조의 언동
Theban : a, THEBES의(사람)
thebe : n, 테베
Thebes : n, 테베(1. 이집트 Nile 강변의 옛 도시, 2.고대 그리스의 도시 국가의 하나)
theca : n, (이끼 식물의)포자낭,(선류의)삭,(피자 식물의)꽃가루 주머니,화분낭,포막
thee : pron, thou의 목적격
theft : n, 도둑질,절도죄
theftproof : a, 도난 방지의
thegn : n, =THANE
thein(e) : n, =CAFFEIN
their : pron, 그들의 것
theism : n, 유신론
theist : n, 유신론자,일신론자
theistic : a, 유신론(자)의,일신교의
Thelma : n, 여자 이름
them : pron, they의 목적격
thematic : n, 주제(논제)의,어간의,주제의,어간 형성 모음(화)
thematization : n, 주제화
theme : n, 논제,화제,테마,과제 작문,주제,주선율,(라디오,TV)주제 음악(signature)
Themis : n, 테미스(법률,질서,정의의 여신),정의
Themistocles : n, 테미스토클레스
themselves : pron, 그들자신(을,이)
then : ad, 그때,그당시,그리고나서,이어서,다음,그러면,그래서,그러므로,and ~ 그리고 나서,그위에,but ~ 그러나 (또 한편으로는), now ~ 그런데,그래서, now ... ~ ...어떤때에는,...또 어떤 때에는
thenar : n,a, 손바닥,발바닥,무지구(엄지손가락 밑부분의 불룩한 부분),손바닥의,발바닥의,무지구의
thence : ad, 그러므로,거기서부터,그때부터
thenceforth : ad, 그때 이래,거기서 부터
theo- : x, 신의 뜻의 결합사
theocentric : a, 신을 중심으로 하는
theocracy : n, 신정(국)
theocrasy : n, 신인 융합,제신 혼합 숭배
theocrat : n, 신권 정치가,신권주의자
theocratic : a, 신정(주의)의
theodicy : n, 여자 이름
theodolite : n, 경위의
theogonic : a, 
theogony : n, 신통계보학
theologian : n, 신학자
theological : a, 신학(상)의,신학적(성질)인,성격에 입각한
theologize : vt,vi, 신학적으로 다루다,신학(문제)를 연구(논)하다
theologue : n, 신학생
theology : n, 신학
theomachy : n, 신들의 전쟁(항쟁),신(들)에 대한 반항(반역),신(들)과의 싸움
theomania : n, 신광증(자기를 신이라고 믿는),종교광
theonomy : n, 신에 의한 통치(지배)신정
theopathy : n, (종교적 묵상에 의한)신인 융합감
theophobia : n, 신공포(증)
theophoric : a, 신의 이름을 받은
theorbo : n, 테오르보(긴 경부가 둘 있는 현악기)
theorem : n, 정리
theoretic : a, 이론(상)의,공론의
theoretical : n,pl, (특정 예술,과학의)이론
theoretician : n, (예술.과학 등의) 이론에 밝은 사람
theorist : n, 이론(공론)가
theorization : n, 이론 구성,이론화
theorize : vi,vt, 이론을 세우다,이론을 붙이다
theory : n, 학설,설,이론,(탁상의)공론
theosophic : a, 정신(론)의,신지학의
theosophist : n, 신지론자,신지학회 회원
theosophize : vi, 신지론적으로생각하다
theosophy : n, 정신론(학),신지학
therapeutic : a, 치료(학)의
therapeutice : n,pl, (단수 취급)치료학(술),요법론
therapeutist : n, =THERAPIST
therapist : n, 치료학자:치료 전문가,요법사;임상의,의사
therapy : n, 치료
there : ad, 그곳에,거기에서(로),저 곳에(서)(으로),그 점에서(는),Are you ~? 여보세요(당신이오). be all ~ 정신 똑바로 차리고 있다,제정신이다,빈틈없다, get ~ 성공하다, T- is(are) ...이 있다
there's : there is(has)의 단축,
thereabout : ad, 그부근(근처)에,(시간.수량.정도 등)그 당시,그 무렵에;대략,그쯤
thereabout(s) : ad, 그 근처에,그 무렵에,대략,...쯤
thereafter : ad, 그 뒤로,그 이후,그것에 의해서
thereagainst : ad, 그에 반해서,그렇기는 커녕 오히려,반대로
thereat : ad, 거기서,그것에 의해서,그 때
thereby : ad, 그것에 의해서,그 때문에
therefor : ad, 그 때문(대신)에
therefore : ad, 그러므로,그 결과
therefrom : ad, 거기서(그것으로)부터
therein : ad, 그 속에,그 점에서
thereinafter : ad, 아래에,아래 글에
thereinbefore : ad, 위에,전문에
thereinto : ad, 그 속에(으로)
thereof : ad, 그것에 관해서,그것의,거기서(그것으로)부터
thereon : ad, 그 위에,그 즉시
thereout : ad, 그것으로부터
Theresa : n, 여자 이름
therethrough : ad, 그것을 통해서 그 결과,그 댜문에
thereto : ad, 거기에,그밖에 다시,거기에 더하여,또
theretofore : ad, 그이전에(는)
thereunder : ad, 그 아래서(에),거기에 따라서
thereunto : ad, =THERETO
thereupon : ad, 그리하여(즉시),그러므로,그위에
therewith : ad, 그것과 함께,그 까닭에,그것으로 써,그리하여,곧
therewithal : ad, 그래서,그것과 함께,그 밖에,또
theriac : n, =THERIACA,만병 통치약
theriaca : n, 테리아카(수십종의 약품에 벌꿀을 섞은 것으로서 항독제로 썼음)
therianthropic : a, 반인 반수의 모습을 한;반인 반수신(숭배)의
theriomorphic : a, (신이)짐승의 모습을 한
therm : n, 섬(열량 단위)
therm(o)- : x, 열의 뜻의 결합사
thermae : n.pl, 온천,(옛 그리스.로마의)공중 목욕탕
thermal : a,n, 열(량)의,열에의한,열렬한,상승 온난 기류
thermaling : n, (스포츠)서멀링(열 상승 기류를 이용한 행글라이더 활공)
thermalize : vt, (중성자를 감속시켜)열중성자화하다
thermal pollution : x, (원자력 발전소의 폐수 따위로 인한) 열공해
thermal spring : x, 온천
thermantidote : n, 실내 냉각기(인도 지방의 일종의 선풍기)
therme : n, =THERM
thermel : n, 열전온도계
thermesthesia : n, 온각,온도감각
thermic : a, =THERMAL
Thermidor : n, 테르미도르,열월(프랑스 혁명력의 제11월;7월19일-8월17일)
thermion : n, 열전자,열이온
thermionic : a, 열이온의,열전자의
thermionics : n, (단수 취급)열이온학
thermistor : n, 서미스터(반도체를 이용한 저항기의 일종)
thermite : n, 테르밋(약 3,000c의 고온을 냄;용접용.소이탄용)
thermobarometer : n, 비점 기압계,온도 기압계
thermochemistry : n, 열화학
thermochemistry : n, 열화학
thermocline : n, (호소)의 수온이 급격히 변하는)변온층,(수온)약층
thermocoagulation : n, (조직의)열응고(법)
thermocouple : n, 열전쌍,열전대;열전지
thermodynamic : a, 열역학의;열량을 동력에 이용하는
thermodynamics : n, 열역학
thermoelectric : a, =THERMOELECTRLC
thermoelectricity : n, 열전기
thermoelectron : n, 열전자
thermoelement : n, (진공)열전대,열전소자
thermoform : n, (플라스틱의)열성형
thermogenic : a, 열발생의;열을 내는
thermogenous : a, =THERMOGENIC
thermogram : n, 온도 기록도,(자기 온도계의)사진 계측 기록,열상
thermograph : n, 온도 기록계,자기 온도계
thermography : n, 온도 기록(법),피부 온도 측정 그래프
thermohaline : a, 열염의(해양에서의 온도와 염분에 의한 작용에 관한)
thermojunction : a, 열불안정(성)의
thermoluminescence : n, 열 루미네선스,열발광
thermolysin : n, 서몰리신(호열성 세균에서 얻어지는 단백질 분해 효소)
thermolysis : n, 체온 발산;열분해
thermomagnetic : a, 열자기의
thermomagnetism : n, 열자기
thermometer : n, 온도계,한란계,체온계
thermometric : a, 온도계상의;온도.측정상의
thermometry : n, 온도 측정
thermonuclear : a, 열핵의
thermonuclear reaction : x, 열핵 반응
thermonuclear weapon : x, 열핵무기
thermoperiod : n, 온도 주기
thermophile : n, 고온균,호열성 생물
thermopile : n, 열전퇴,열전대열
thermoplastic : a,n, 열가소성의(물질)(플라스틱 따위)
Thermopylae : n, 테르모필레(480B.C에 스파르타의 장군 Leonidas가 인솔하는 그리스군이 페르시아군과 싸워 전멸한 그리스의 옛 싸움터)
thermoregulate : vi,vt, (...의)체온을 조절하다
thermoregulation : n, 온도(체온) 조절(유지)(특히 생체내의)
thermoregulator : n, 온도 조절기
thermoregulatory : a, 체온 조절(성)의
thermos : n, 보온병
thermoscope : n, 온도 표시기,오도 측정기(2점간의 온도차를 보는 간단한 장치)
thermoscopic : a, 온도 표시상의
thermosetting : n,a, (가소물의) 열경화(성의)
thermosiphon : n, 열 사이펀
thermosphere : n, 열권,온도권(지구 대기의 80km이상에서 고도에 따른 온도 상승 부분)
thermostat : n, (자동)온도 조절기
thermostatic : a, 자동 온도 조절의
thermostatics : n.pl, (단수 취급)열평형학
thermotherapy : n, 온열 요법,열치료
thermotropism : n, 온도 굴성,굴열성
thermoumin'escent : x, 열루미네선스 연대 측정(법)
theroid : a, 야수 같은,야수성의
Thesaly : n, 테살리아(그리스의 동부 지방)
thesaurus : n, 보고,사전,백과사전
these : a,pron, this의 복수
Theseus : n, 아테네의 영웅(괴물 Minotaur을 퇴치)
thesis : n, 논제,주제,정립,(변증법에서)정,테제,(졸업,학위)논문
Thespian : a,n, 비극의,비극적인,(비극)배우
Thespis : n, 테스피스(기원전 6세기의 그리스의 비극 시인)
Thessalian : a, 그리스 Thessaly(사람)의
Thessalonian : a,n, 그리스(Salonika의 옛 이름)의(사람)
Thessalonians : n, 데살로니가서(데살로니가 사람에의 바울의 편지)
theta : n, 그리스어 알파벳의 여덟째 글자
thetic : a, 독단적(단정적,명령적)으로 말한
Thetis : n, Achilles의 어머니(바다의 신 Nereus의 50명의 딸 중의 하나)
theurgy : n, 신이 이룩한 일,기적;마술(sorcery)
thews : n, 근육,힘줄,근력
they : n, (군 또는 민간의)높은 양반,당국자, T- say that ...이라는 소문이다,...이라고 한다
thiabendazole : n, 티아벤다졸(구충제)
thiamine : n, 티아민(그 염화물이 vitamin B1)
thiazide : n, 티아지드(특히 고혈압 환자용 이뇨제)
Thibet : n, =TIBET
thick : n, 가장 두꺼운(굵은)부분,우거진 수풀,(전쟁 따위의)한창 때,through ~ and thin 좋은 때나 나쁜 때나,만난을 무릅쓰고
thickandthin : a, 물불을 가리지 않는,시종 변함 없는,절조가 굳은
thicken : vt,vi, 두껍게하다,두꺼워지다,굵게 하다,굵어지다,진하게하다,진해지다,빽빽하게 하다,빽빽해지다,흐리게 하다,흐려지다,탁하게 하다,탁해지다,안개를 자욱하게 하다,(이야기 줄거리 따위) 복잡하게 하다,심하게 하다
thickening : n, 두껍게(짙게,굵게,빽빽하게)하는 것,침전(농축)장치
thickening : n, 두껍게(굵게)함(됨);굵게(두껍게)된 부분,농(밀)화,(직물의)풀먹임,농후제(재료)
thicket : n, 덤불,잡목숲
thickhead : n, 바보
thickheaded : a, 머리가 둔한
thickish : a, 좀두꺼운(굵은,짙은)
thickly : ad, 두껍게;진하게;빽빽하게;울창하게,많이;빈번하게,잔뜩,(말 등을)불명료하게,탁한 목소리로
thickset : a,n, 울창한,빽빽한,땅딸막한,수풀,우거진,(울창한) 산울타리
thickskinned : a, (살)가죽이 두꺼운,두꺼운,철면피한,둔감한
thickskulled : a, =THICKHEADED
thickwitted : a, 우둔한
thief : n, 도둑
thieftaker : n, 도둑 잡는 포리
thieve : vt,vi, 훔치다,도둑질하다
thieveless : a, 냉담한,기운이 없는,의지가 약한
thievery : n, 도둑질
thieves : n, thief의 복수형
thieving : n, =THIEVEVERY
thievish : a, 도벽이 있는,도둑의,도둑 같은,남몰래 하는
thigh : n, 넓적다리,가랑이
thighbone : n, 대퇴골
thigmotaxis : n, 접촉 주성,주촉성
thill : n, (수레의) 채,끌채
thiller : 끌채에 맨 말,뒷말
thimble : n, (재봉용) 골무,끼움쇠테(밧줄의 마찰 예방용)
thimbleful : n, (술 등의)극소량,(아주)조금
thimblerig : n, 골무 모양의 작은 잔 세 개와 작은 구슬 (또는 콩) 한 개로 하는 도박
thimblewit : n, 얼간이,팔푼이
Thimbu : n, 팀부(Bhutan의 수도)
thimerosal : n, 티메로살(소독액)
thin : a, 얇은,가는,야윈,(청중이)드문드문한,얼마 안되는,희박한(rare),묽은,(목소리가)가는,가냘픈,힘 없는,깊이(충실감,강도)없는,(변명 따위)빤히 들여다 보이는,천박한,빈약한
thin : vt,vi, 얇게(가늘게,드문드문하게)하다(되다),야위(게 하)다,약하게 하다,약해지다,~ down 가늘게 하다(되다),~ out (식물을) 솎다,(청중이) 드문드문해지다
thinclad : n, (육상 경기의)트랙 선수
thine : pron, 너의 것
Thing : n, (스칸디나비아 여러 나라의) 공공 집회,의회,법정
thing : n, (유형,무형의)물건,무생물,일,사정,사태,말하는것,말,행위,작품,곡,생물,동물,사항,소지품,도구,재산,know a ~ or two 빈틈없다,익숙하다,make a good ~ of ...으로 이익을 보다
thingamabob : n, =THINGAMAJIG
thingamjig : n, 뭐라던가 하는 것(사람)
thinginitself : n, (칸트 철학에서의)물자체
thingism : n, (문학.예술에 있어서)사물 주의(물질이나 세부를 강조 또는 관심의 대상으로 함)
thingness : n, (사물의)객관적 실재성,객관적 사물성
thingumbob : n, =THINGAMAJIN
thingy : a, 물건의,물질적인,현실의,실제적인
think : vt, 생각하다,...라고 여기다,믿다,(...으로)생각하다,간주하다,상상하다,...하려고 하다(to),예기하다,생각하여 ...하다(into)
thinkable : a, 생각(상상)할 수 있는;믿을 수 있는
thinkbox : n, 머리,두뇌
thinker : n, 생각하는 사람,사상가,사색가
think factory : x, =THINK TANK
thinking : a, 생각하는,사고력 있는,사상이 있는
thinking cap : x, 마음의 반성(집중) 상태
thinkingly : ad, 잘 생각하여;궁리 끝에
think piece : x, (신문의) 시사해설(기사)
think tank : x, 두뇌집단
thinktanker : n, 싱크탱크의 일원
thinly : ad, 얇게,가늘게;얇게 옷을 입고,희박하게,성기게,여위어서;약하게
thinner : n, 얇게 하는 사람(것)희석제(액)제초하는(가지 치는)사람
thinnish : a, 좀 얇은,가느다란,좀 성긴,좀 약한,여윈 편인
thinskinned : a, (살)가죽이 얇은,민감한,성마른
thioacetic acid : x, 티오초산
Thiokol : n, 티오콜,인조 고무의 일종
thionic : a, 유황의,티온산의
thiopental : x, 티오펜탈(마취제)
thioridazine : n, 티오리다진(강력한 정신 안정제)
thiosulfate : n, 티오황산염
third : n,a, 제3(의),세번째(의),3분의 1(의),3루,남편 유산의 3분의1(미망인에게의),제3음,3도(음정)
third-class : a,ad, 3등의(으로)
thirdbest : a, 세번째로 좋은,제3위의
third degree : x, (경찰의) 고문
thirddegree : a, (화상이)제3도의,(범죄가)제3급의
third estate : x, 제3계급
third force : x, 제3세력
Thirdgeneration : a, 제 3세대의,직접회로 컴퓨터의
thirdhand : a, (정보 등이)두 사람의 매개자를 거쳐 입수한,(고서 등이)두 사람의 소유자를 거친,재중고의(특히 상태가 심한 경우);재웅고품 장사를 하는
Third International : x, the 제3인터내셔날
thirdly : ad, 제3으로,세번째로
third market : x, 상장주의 장외 직접거래시장
third party : x, 제3자
third person : x, 제3자,제3인칭
third rail : x, (송전용의) 제3레일
third rate : a, 3등의,열등한
thirdrate : a, 3등의,3류의;하등의,열등한
thirdrater : n, 3류급 인사;3등품
Third Reich : x, the 제3제국(Hitler 치하의 독일 (1933-45))
third sex : x, 동성애자
third stream : x, 재즈 수법의 클래식 음악
thirdstream : a, 서드스트림의,재즈와 클래식을 혼합한
third word : x, 제3세계
thirst : n, 목마름,갈증,갈망(after,for,of),have a ~ 목이 마르다,한잔 마시고 싶다
thirst : vi, 갈망하다 (after,for)
thirstily : ad, 목말라서,목마르게,갈망하여,열망하여
thirsty : a, 목마른,술을 좋아하는,건조한,갈망하는(for)
thirteen : n,a, 13(의)
thirteenth : a, 제13의,열세번째의,13분의1의
thirtieth : n,a, 제30(의)
thirty : n,a, 30(의)
Thirtynine Articles : x, 영국 국교의 신조
thirtysecond note : x, 32분 음표
thirtythree : n, 33회전반(331/3 회전의 레코드:보통 33이라고 씀)
thirtytwomo : n, 32절판(의 책(종이,페이지))
this : pron, 이것,이 물건(사람),지금,오늘,여기,(that에 대해서)후자,at ~ 여기에 있어서,by ~ 이 때까지에
this : a, 이것의,지금의,~ day week 지난 주(내주)의 오늘. ~ much 이만큼(은),이 정도(는)
this : ad, 이 정도까지,이만큼
thisaway : ad, 이렇게,이런식으로;이쪽으로
Thisbe : n, 티스베(PYRAMUS와 서로 사랑한 여자;Thisbe가 사자에게 잡혀먹힌 것으로 알고 자살한 Pyramus의 뒤를 따름)
thisness : n, 개성원리 개성의 특성
thistle : n, 엉겅퀴의 갓털
thistle : n, 엉겅퀴(스코틀랜드의 상징으로 국화)
thistledown : n, 엉겅퀴의 갓털
thistly : a, 엉컹퀴가 무성한,엉겅퀴가 무성한,엉겅퀴 캉은,가시가 있는
thisworldly : a, 세속사에 대한 관심(집착)이 강한,세속적인
thither : ad,a, 저쪽에(으로),저기에(로),저쪽의,~-ward(s),저쪽으로
thither : ad, 저쪽으로,그쪽에
thole : n, (뱃전의) 놋좆,노받이
tholepin : =THOLE
thols : n, (고대 그리스.로마의)원형 건축물,둥근 천장식 지하 분묘
Thomas : n, 도마(예수 12사도의 한 사람)
Thomism : n, Thomas Aquinas (1225~-75)의 신학,철학설
Thompson submachine gun : x, 톰슨식 소형 자동 기관총
thong : n, 가죽끈,회초리끈
Thor : n, 뇌신
thoracic : a, 가슴(휴부)의
thoracoplasty : n, 휴곽 성형술
thoracotomy : n, 개흉(술)
thorax : n, 가슴,흉부
Thoreau : n, Henry David (1817-62) 미국의 철인
thorianite : n, 토리아나이트(방사성을 가진 광석)
thorite : n, 토라이트,규토륨광
thorium : n, 토륨(방사성 금속 원소,기호 Th)
thorn : n, (식물의)가시,가시 잇는 식물,산사나무,고통(고민)거리,a ~ in the flesh (one's side) 고생거리,crown of ~s (예수의) 가시 면류관
thorn apple : x, 산사나무(의 열매),흰독말풀
thornback : n, 홍어,(영국산)게의 일종
thornbush : n, 가시 돋친 과목;가시나무 덤불
Thorndike : n, 손다이크(미국의 심리학자.사서 편찬자)
thorned : a, 가시가 많은,가시가 돋친,가시 같은,어려운,곤란한,고통스러운,괴로운
thoro : a, =THOROUGH
thoron : n, 토론(radon의 방사성 동위원소,기호 Tn)
thorough : n, 완전한,충분한,철저한,순전한
thoroughbass : n, 통주저음;숫자가 붙은 저음
thoroughbred : a,n, 순종의(말,동물),출신이 좋은(사람),교양 있는
thoroughfare : n, 통로,가로,본도,왕래,통행(No ~,통행금지)
thoroughgoing : a, 철저한
thoroughly : ad, ㅁㅇ완전히,철저히,순전히
thoroughpaced : a, (말이) 모든 보조에 익숙한,잘 조련된,순전한(out-and-out)
those : a,pron, that의 복수
thou : pron, 너는,네가 (현재는 신에 기도할때,또는 퀘이커 교도간에 쓰이며,일반적으로는 you을 씀)
though : conj, ...에도 불구하고,...이지만,설사 ...라도,...라 하더라도
though : ad, (문미에서) 그래도
thoughness : n, 완전,철저함;순전함
thought : v, think의 과거(분사)
thought : n, 사고(력),사색,(어떤 시대,계급의)사상,사조,생각,착상,사려,배려,고려,의향,(..할)작정,기대,의견,(a ~)좀,약간. at the ~ of ...을 생각하면, quick as ~ 즉시, take ~ for ...을 걱정하다, upon (with) a ~ 즉시
thought control : x, 사상통제
thoughtful : a, 사려 깊은,주의 깊은,인정있는(of),생각에 잠긴
thoughtfully : ad, 생각에 잠겨,생각 깊게;인정 있게,친절히
thoughtless : a, 사려가 없는,경솔한(of),인정 없는
thoughtout : a, 곰곰이 생각한 뒤의,주도한
thoughtprovoking : a, 생각하게하는,시사하는 바가 많은
thoughtread : vt, 표정으로(텔레파시)으로 진의를 읽다(알아차리다)
thought reading : x, 독심술
thought transference : x, 정신감응(현상),천리안
thoughtwave : n, 심파(사상의 감응 파동)
thoughtway : n, (특정 집단.시대.문화의 특정적인)사고 방식(양식)
thousand : n,a, 천(의),무수(한),a ~ to one 거의 절대적인, one in a ~ 희귀한(뛰어난)것
thousandfold : a,ad, 천배의(로)
thousandth : a, 천번째의,천분의 1의
thowless : a, (스코)기운(활기)없는,의지가 약한
Thrace : n, 트라키아(Balkan 반도의 에게해 북동안 지방)
Thracian : n,a, 트라키아 사람(말)(의)
thrall : n, 노예(of,to)
thralldom : n, 노예의 신분(상태);속박
thrash : vt, 때리다,채찍질하다,도리깨질하다
thrash : vi, 도리깨질하다,(고통으로)뒹굴다(about), ~ out (안을)충분히 검토하다, ~over 되풀이하다
thrash : n, (회초리로)때리기,도리깨질
thrasher : n, 채찍질하는 사람;타작하는 사람,탈곡기,환도상어,개똥지빠귀속(북미산)
thrashing : n, 타작,탈곡,도리깨질
thrasonical : a, 자랑하는,허풍치는
thraw : vt, 비틀다,가로지르다,방해하다
thrawart : a, (스코)고집이 센,완고한,비틀어진,찌그러진,비뚤어진
thrawn : a, (스코)비틀어진,굽은,성마른,괴팍한
thread : n, 실,섬유,재봉실,끈 실,가는 것,줄,섬조,(이야기의)줄거리,연속,(인간의) 수명. cut one's mortal ~ 죽다, hang by (on,upon) a ~ 위기 일발이다, ~ and thrum 옥석 혼효
thread : vt, (바늘에) 실을 꿰다,(구술 따위를) 실에 꿰다,누비듯이(헤치며)지나가다,나삿니를 내다
threadbare : a, 해어져서 실이 드러난,입어서 다 떨어진,누더기를 걸친,진부한,케케 묵은
threader : n, 실 꿰는 도구,나사깎개(기계)
threadlike : a, ㅁ실 같은,가늘고 긴
threadneedle : n, 어린이 놀이의 일종(한 줄로 손 잡고 서서 끝의 아이가 다른 끝의 두 사람 사이를 차례로 빠져나감
Threadneedle Street : x, 런던의 거리 이름(은행이 많음)
threadworm : n, 요충
thready : a, 실 같은,가느다란,실의,섬유질의,(액체 등이)가는 실처럼 늘어지는,진득진득한,(맥박,목소리 등이)약한,가냘픈,힘없는
threat : n, 위협,협박,흉조
threaten : vt,vi, 위협하다(with,to do),...할 듯하다,...의 우려가 있다,닥치고 있다
threatening : a, 위협(협박)적인,(나쁜 일이)일너날 듯이,임박한;흉조의,(날씨등이)험악한
three : n,a, 3(의),세 사람(개)(의)
three-D : a, 입체 영화의
threebagger : n, =THREE BASE HIT
threebase hit : x, 3루타
threecolo(u)r : a, 3색의, ~ process 3색판
threecornered : a, 삼각의
threedecker : n, 3층 갑판의 군함
threedimemsional : a, 3차원의,입체(영화)의,육해공군 입체 작전의
threeevent : a, 3종목의:a ~ skier 3종목에 출전한 스키 선수
threefigure : a, (수가)세자리의(100-999)
threefold : a,n, 3배의,3중(겹)의,3부분(요소)이 있는,(무대 배경의)삼면 장치
threefour : x, 4분에 3박자
threegaited : a, (말이 상보.속보.구보의)세가지 보조 훈련을 받은
threehalfpence : n, 1펜스 반(구화폐)
threehanded : a, 세개의 손이 달린,(유희 등)셋이 하는
threelegged : a, 다리가 셋인(a ~ stool)
threemasted : a, 돛대가 셋인
threemaster : n, 세대박이 돛배
threemile limit : x, 해안에서 3마일 이내의 한계(영해)
three minutes silence : x, (사자의 영에 드리는) 묵도 (시간의 장단은 관계 없음)
threepair : a, 3부의,3부로 된
threepence : n, 3펜스(동전)
threepenny : a, 3펜스의,시시한,싸구려의
threepercent : a, 3%의,3푼 이자의
threepiece : a, (으복 등이)3개 한벌의,스리피스의;(가구가)3개(점)1세트의
threeply : a, 세겹의,(밧줄 따위) 세 겹으로 꼰
threepointer : n, 절대 확실한(정확한) 것
threepoint landing : x, 3점 착륙 (세 바퀴가 동시에 땅에 닿다, 이상적인 착륙법)
threequarter : a, 3/4:3/4 가죽 장정,7분신의;얼굴3/4을 나타내는(full과 profile의 중간)
threequarterbund : a, (가죽)장정의
three R's : x, 읽기 쓰기,셈하기
threescore : n,a, 60(의),60세(의), ~ (years) and ten (사람의 수명) 70세
threesome : n, 3인조,3인경기(자)
threespeed : a, (전축이)세가지 속도로 바뀔수 있는
threespeed changer : x, (전축의) 스리스피드 전환 자동장치
threesquare : a, (줄.송곳 등이)동등한 3면을 가지는,단면이 정삼각형을 이루는
three unities : x, (때,장소,행동의)삼일치
threevalued : a, 삼치적인진.위의 2치 이외에 제3의 진리치를 인정하는)
threeway : a, 세가지 방법의;세 방향의;세 가지로 작용하는;3자간의
threewheeler : n, 3륜차
thremmatology : n, 동식물 육성학,사육학
threnetic : a, 비탄의,애도의;비가(만가)의
threnodic : a, 비가의,애가의
threnodist : n, 비가의작자
threnody : n, 비가,애(도)가
threonine : n, 트레오닌(필수 아미노산의 일종)
thresh : vt,vi, 매질하는 사람(것),타작하는 사람(것),탈곡기
thresher : n, 탈곡기,탈곡자,환도상어의 일종
threshing floor : x, (보리,밀 등의)타작마당
threshing machine : x, 탈곡기
threshold : n, 문지방,문간,입구,출발점,시초,역,at (on) the ~ of ...의 시초에
thretened : a, (야생 동물의 종이)멸종할 위기에 직면한
threw : v, throw의 과거
thrice : ad, 세번,3배로,매우
thrift : n, 검약(의 습관),아르메리아
thriftless : a, 돈을 헤피 쓰는,낭비하는
thrifty : a, 절약하는,검소한,알뜰한,무성하는,번영하는
thrill : n, (공포,쾌감의) 오싹(자릿자릿)하는 느낌,전율,스릴,몸떨림
thrill : vt,vi, 오싹(자릿자릿)하(게 하)다(with),떨리(게 하)다,몸에 사무치다(along,in,over,through),스릴러
thriller : n, 스릴을 주는 것(사람),오싹(자릿자릿)하게 하는 사람(것)스릴물,스릴러,(특히)괴기 영화(극,소설)
thrilling : a, 오싹(자릿자릿,두근두근)하게 하는,소름이 끼치는;피를 끊게 하는,장렬한,스릴 만점의
thrippence : n, =THREEPENCE
thrips : n, 삽주벌레(식물의 해충)
thrive : vi, 번영하다,성공하다,부자가 되다,(동,식물이)성장하다
thriven : v, thriv의 과거분사
thriving : a, 번성(번영)하는,번화한;성대한
throat : n, 목,기관,목소리,좁은 통로,in one's (the) ~. clear one's ~ 헛기침하다. cut one another's ~s 서로 망할 짓을 하다, cut one's (own) ~ 자멸할 짓을 하다
throated : a, (복합어를 이루어)한 목을 가진,...한 소리가 나는:목이 하얀 새
throatlatch : n, (말고삐의)아래턱 끈
throat microphone : x, 목에 대는 마이크로폰(결후에서 음성을 직접 전함)
throaty : a, 목구멍 소리의,(목소리가)목 안쪽에서 나오는,묵직한,목쉰,목살이 처진(동물)
throb : n, (빠른,심한) 동계,(빠르게,심하게)두근거리다(with),고동(치다),(맥 따위가)뛰다(뜀),떨림,떨리다
throbbing : a, 두근거리는,고동치는;약동하는
throe : n, 격통,산고,고민,사투
thrombin : n, 트롬빈(혈액의 응혈작용을 하는 효소)
thrombocyte : n, 혈소판,전구
thromboembolism : n, 혈전색전증
thrombokinase : n, 트롬보키나제(혈액의 응고에 관계잇는 혈액 또는 조직 안의 인자)
thrombose : vi, 혈전증에 걸리다
thrombosis : n, 혈전(증)
thrombosis : n, 혈전증
thrombosthenin : n, 트롬보스테닌(혈소판에 함유된 수축성 단백질)
thromboxane : n, 트롬복세인(혈소판 함유되어 있는 혈 응고에 관계되는 물질)
thrombus : n, 혈전
throne : n, 왕좌,옥좌,왕위,왕권,교황(감독,주교)의 자리
throng : n, 군중,혼잡,쇄도하다
throstle : n, 노래지
throttle : n, 목,at full ~ =with the ~ against the stop 전속력으로
throttle : vt, 목을 조르다,질식시키다,억압하다,(조절판을)죄다,감속시키다
throttleable : a, (로켓 엔진이)(비행중에)추력을 바꿀 수 있는
throttlehold : n, 억압,조르기,(신문 등의)탄압
throttle valve : x, 조절판
through : prep, ...을 통하여,...을 지나서,처음부터 끝까지,...동안,도처에,...때문에,...에 의하여,...을 끝내고
through : ad, 통해서,처음부터 끝까지,쭉 계속하여,...동안,완전히,철저히,시종일관,~ and ~ 철두철미,철저히
through : a, 쭉통한,직통의,끝난
throughly : ad, =THOROUGHLY
throughout : prep,ad, 도처에, ...동안,통해서
throughput : n, (공장의) 생산(고),(컴퓨터)처리량
throughstone : n, =BONDSTONE
throughway : n, =THROUGHSTREET
throve : v, thrive의 과거
throw : vt, 던지다,내동댕이치다,(말이)흔들어 떨어뜨리다,(배를 암초 등에)얹히게 하다,급히(몸에)걸치다,벗다,(어떤 상태로) 빠뜨리다,갑자기 움직이다,(스위치,클러치 등의 레버를)움직이다,(생사를) 끄다
throw : n, 던지기,던지면 닿을거리,(스위치,클러치의) 연결,분리,스카프,가벼운 두르개,(크랭크,피스톤 등의)행정
throwaway : n, (광고) 삐라,전단
throwback : n, 되던지기,역전,(동,식물의) 귀선 유전
throwdiwn : n, 거절,(레슬링 등의)폴;패배,스로다운(심판이 공을 양 팀 사이에 떨어뜨려 게임을 재개시키는 일)
thrower : n, 던지는 사람(것);폭뢰 발사 장치,명주실을 꼬는 사람(도자기의)녹로공
throwin : n, 덤,공짜로 주는 것,던져진 공;스로인
throwmoney : n, (미)잔돈
thrown : v, throw의 과거분사
throwoff : n, (사냥,경주의) 개시
throwout : n, 내던짐,내던져진 사람(물건),불합격품,찌꺼기,부상을 가장한 거지
throwster : n, 명주실 꼬는 직공,주사위 던지는 사람
thrum : vi,vt, (현악기를) 뜯다(타다,퉁겨 소리내다),그소리,(책상 따위를 손가락으로)똑똑 두드리다(두드리는 소리)
thrummy : a, 부스러기 실의(로 만든);(표면에)보풀이 선)
thrump : n, 윙윙,쿵쿵,쾅쾅
thruout : ad,prep, =THROUGHOUT
thruppence : n, =THREEPENCE
thruput : n, =THROUGHPUT,해결 도중에 있는 문제의 상태,그때그때의 상황
thrush : n, 개똥지빠귀
thrush : n, 개똥지빠귀,(미)여자 팝송 가수
thrust : vt, 밀다,찌르다,찔러넣다(into,through),무리하게 ...시키다(into)
thruster : n, 미는(찌르는)사람,나서기 좋아하는 사람,(우주선의) 자세 제어 로케트
thrustful : a, 억지가 셴;공격적인,적극적인
thrusting : a, 자기 주장이 강한;공격적인;몹시 뽐내는
thruway : n, 고속도로(expressway)
Thucydides : n, 투키디데스(그리스의 역사)
thud : n, 털썩(떨어지다),꽝(쿵) (울리다)
thug : n, (옛 인도의 종교적) 암살단원,자객,흉한
thuggee : n, THUG에 의한 살인 강도,(인도의)폭력 행위(조직
thuggery : n, 폭력행위
Thule : n, (옛날 사람이 상상하였던) 극북의 땅
thulium : n, 툴륨(희금속 원소,기호 Tm)
thumb : n, (손.장갑의)엄지손가락,fingers are all ~s 손재주가 없다,bite one's ~ at 모욕하다,Thumb down (up)! 안된다(좋다)
thumbhole : n, 엄지손가락을 넣는 구멍(관악기의)엄지로 막는 구멍
thumb index : x, (페이지 가장자리의) 반달색인
thumbmark : n, (책장에 남은) (엄지) 손가락 자국
thumbnail : n,a, 엄지손톱,극히 작은(것),스케치,소논문(따위)
thumbpot : n, (한송이를 꽂는) 꽃병
thumbprint : n, 엄지손가락의 지문
thumbscrew : n, 나비나사,엄지손가락을 죄는 형틀
thumbsdiwn : n, 거절,불찬성,비난
thumbstall : n, 엄지손가락 색;골무(구두 깁는 사람의)
thumbsucking : n, (아기가) 엄지손가락을 빠는 버릇
thumbsup : n, 승인,찬성,격겨
thumbtack : n, 압정
Thummim : n, Urim and Thummim
thump : n, 탁(쿵) (때리다(부딪히다)),심하게 때리다
thumper : n, 탁(쾅)치는 사람(것)거대한 것,터무니없는 거짓말
thumping : a, 거대한,놀랄만한,터무니 없는
thumping : ad, 엄청나게
thunder : n, 우레,천둥(같은 소리),요란한 울림,위협,호통,비난,steal a person's ~ 아무의 생각(방법)을 도용하다,장기를 가로채다
thunderandlightning : a, (옷이)아주 대조적인 색채의;화사한 색채의
thunderation : n, (의무사를 강조하여)도대체
thunderbird : n, 천둥새(천둥을 일으킨다고 북미 인디언들이 생각한 거대한 새)
thunderboat : n, (모터보트 경주에서)무제한급 수상 활주정
thunderbolt : n, 뇌전,벼락,청천 병력
thunderbox : n, (땅에 판 구멍에 설치하는)상자형 변기;휴대 변기
Thunderchief : n, F-105전투 폭격기
thunderclap : n, 우뢰 소리,청천 벽력
thundercloud : n, 뇌운
thunder egg : x, 옥수가 구형으로 굳은것(닦아 장식품으로 씀)
thunderer : n, 벼락 같은 소리를 지르는 사람,고함치는 사람
thunderhead : n, 소나기 구름(의 한 덩어리)(이것이 모이면 뇌운)
thundering : a, 우뢰(뇌성)같은,뇌성같이 울리는
thunderless : a, 천둥이 따르지 않는
thunderous : a, 우뢰같이,울리는,벽력같이고함 지르는
thundershower : n, 뇌우
thundersquall : n, 천둥치며 오는 스쿨
thunderstone : n, 뇌석(번개의 화살이라고 흔히 여겼던 가늘고 긴 각종 고대 석기.화석.운석),번개의 화살
thunderstorm : n, 천둥치는 폭풍우
thunderstrike : vt, 벼락치다,낙뢰하다,깜짝 놀라계 하다
thunderstroke : n, 낙뢰
thunderstruck : a, 벼락 맞은,깜짝 놀란
thundery : a, 천둥같은,천둥 치는,(날씨가) 고약한,(얼굴이) 험상궂은
thurible : n, 향로
thuriferous : n, (의식 때)향로를 드는 복사
thuriferous : a, 유향이 나는
thurification : n, 향을 피움,분향
Thursday : n, 목요일
Thursdays : ad, 목요일에,목요일마다
Thurston : n, 남자 이름
thus : ad, 이와 같이,이런식으로,따라서,그러므로,이정도까지,~ and ~ 이러이러하게,~ far 여기(지금)까지는,~ much 이것만은
thusly : ad, =THUS
thusness : n, 이러함:왜 이러한가
thwack : vt,n, (막대 따위로) 찰싹 때리다(때림)
thwaite : n, (살림을 개간해서 만든)농경(목축)용 토지
thwart : vt, (계획 등을)방해하다,반대하다,좌절시키다
thwart : n, 보트나 카누의 가로장(노젓는 사람이 앉음),카누의 창막이
thwart : ad,a, 가로질러,가로지른
thwartship : a, 배를 가로지르는,뱃전에서 뱃전에 이르는
thwartships : ad, =ATHWARTSHIPS
thy : pron,a, 너(thou)의 소유격
thylacine : n, 태즈메니아 늑대(육식성의 유대 동물)
thyme : n, 백리향
thymectomy : n, 휴선 적출(술)
thymey : a, =THYMY
thymic : a, 백리향의(에서 채취한)
thymic : a, 휴선의
thymine : n, 티민(DNA를 구성하는 염기의 하나;기호T)
thymol : n, 티몰 (방부제)
thymosin : n, 티모신(흉선에서 분비되는 호르몬)
thymus : n,a, 흉선(의)
thymy : a, 백리향의,백리향이 많은;백리향 냄새가 나는
Thyratron : n, 사이러트론(열음극 방전관)
thyristor : n, 사이리스터(교류를 직류로 바꾸는 반도체 이용의 장치)
thyroid : n,a, 갑상선(삽상 연골)(의),갑상선제,방패모양의 (무늬의),~ cartilage (gland,body)갑상 연골(선)
thyroidectomy : n, 갑상선 적출(절개)(술)
thyroiditis : n, 갑상선염
thyroxin : n, ,-ine 티록신,갑상선 호르몬
thyrsus : n, Dionysus의 지팡이
thyself : pron, 너 자신
ti : n, 시(음계의 제7음)
Tianjin : n, 톈진(중공 헤베이성의 도시)
tiara : n, 로마 교황의 삼중관,(금,보석,꽃 따위를 단 부인용의)장식관,고대 페르시아남자의 관
tiaraed : a, TIARA를 쓴
Tiber : n, 로마를 흐르는 강
Tiberius : n, 티베리우스(제2대 로마 황제(A.D14-37);Augustus의 사위)
Tibet : n, 티베트
Tibetan : a, 티베트의;티베트 사람(말)의
tibia : n, 경골,(옛날의)플루트
Tibione : n, 티비원(결핵 치료제)
tic : n, 안면,경련
tical : n, 티칼(타이의 옛 형량;약 14.2그램)티칼(타이의 옛 은화)
tick : n, 똑딱(소리),순간,대조(체크)의 표
tick : vi, (시계가) 똑딱거리다
tick : vt, 재깍재깍 가다(시계가),체크를 하다,꺽자치다(off), ~ out (전신기가 전신을)똑똑 쳐내다
tick : n, 진드기
tick : n, 이불잇,베갯잇
tick : n,vi, 신용 대부(하다),외상(으로 사다)
ticker : n, 똑딱거리는 물건,체크하는 사람(것),전신 수신 인자기,증권 시세 표시기,시계,심장
ticker tape : x, (통신 시세가 찍혀) ticker에서 자동적으로 나오는 수신용 테이프,(환영을 위해 건물에서 던지는)색종이 테이프
ticket : n, 표,승차(입장)권,게시표,정찰,셋집 표찰(따위),(교통 위반의)소환장,딱지,(정당의)공천 후보자 명부,(the ~) 적당한 물건(일),안성맞춤인 일
ticket : vt, 표찰을 달다,표를 팔다
ticket inspector : x, (열차 안의)검표 승무원
ticket office : x, 매표소,출찰소
ticket of leave : x, (예전의) 가출옥 허가서
ticketofleave man : x, (예전의) 가출옥자
ticket window : x, 출찰구,매표구
ticketyboo : a, 그저 그런,괜찮은,충분한
ticking : n, 똑딱(재깍)거림(소리),(새.동물 등의)2색 이상의 줄무늬
tickle : vt, 간질이다,즐겁게 하다,재미나게하다,가볍게 대다(움직이다),(송어 따위를) 손으로 잡다
tickle : vi, 간질거리다
tickle : n, 간지러움,간질이기
tickler : n, 간질이는 사람(것);추켜올리는 사람,(미)비망록,수첩,어려운 문제,난문;난처한 일,재생코일
ticklish : a, 간지럼을 타는,신경질적인,까다로운,화 잘 내는;다루기 힘든(문제)불안정한(날씨 등),(배가)잘 뒤집히는
tickly : a, =TICKLISH
tickover : n, (엔진의)공전,아이들링
tickseed : n, 씨가 옷에 붙는 식물의 총칭,기생초
ticktack : n, (시계의) 똑딱똑딱
ticktacktoe : n, (오목 비슷한)세목 놓기 게임
ticktacktoo : n, 3목 놓기
ticktick : n, 시계
ticktock : n, (큰 시계의) 똑딱똑딱(하는 소리)
tickytack : a, 달라진 것 없는,무미건조한,따분한
tickytack : n, 흔해빠진 싸구려 건재 (특히,팔려고 짓는 주택용)
tidal : a, 조수의(작용에 의한),간만이 있는
tidal current : x, 조류
tidal river : x, 조수 간만이 상류까지 미치는 강
tidal wave : x, 큰파도,(지진에 의한)해일,조수의 물결,(인심의) 대동요
tidbit : n, (맛 있는 것의) 한입,재미있는 뉴스
tidbit : n, 맛있는 가벼운 음식,(맛있는 것의)한 입,재미있는 이야기,토막 뉴스
tiddl(e)y : a, 얼근히 취한
tiddledywinks : n, 채색한작은 원반을 종지에 튕겨 넣는 유희
tiddler : n, 작은 물고기,(특히)가시고기
tiddly : a, 거나하게 취한,일류의,고급의,스마트한,조그마한
tiddlywinks : n, =tiddledywinks
tide : n, 조수,조류,흐름,풍조,경향,성쇠,계절,때,turn the ~ 형세를 일변시키다
tide : vi, 조수를 타고가다,극복하다
tide : vt, (조수에 태워)나르다,(곤란 따위를) 헤어나게 하다,(어떻게 해서든지) 견뎌내게 하다
tidebound : a, (배가)썰물로 움직이지 못하는
tideland : n, 간석지,개펄
tideless : a, 조수의 간만이 없는
tidemark : n, 조수표;(욕조의)수위,(부. 행복 등의)최고 도달점
tide rip(s) : x, (조류의 충돌로 생기는) 거센파도
tidewaiter : n, (옛날 세관의) 감시원,기회 주의자
tidewater : n,a, 조수,해안(의)
tideway : n, 조로,조류
tidings : n,pl, 통지,소식
tidy : a, 단정한,깨끗한 것을 좋아하는,(금액이)상당한,꽤 좋은
tidy : vt,vi, 정돈하다(up)
tidy : n, 의지의 등씌우개,자질구레한 것을 넣는 그릇
tie : vt, 매다,붙들어 매다(to),...의 끈을 매다,결합(접합)하다,결혼시키다,속박하다,(경기에서)동점이 되다,(음표를)연결하다
tie : vi, 매이다,동점이(타이로)되다, be much ~d 조금도 틈이 없다, ~ down 제한하다,구속하다. ~ up 단단히 묶다,싸다,방해하다,못하게 하다,짜다,연합하다(to,with),구속하다,(재산 따위를)자유로 사용(처분) 못하게 하다
tie : n, 매듭,끈,구두끈,줄,쇠사슬(따위),끈으로 매는 단화의 일종,넥타이,연분,기반,속박,거추장스러운 것,귀찮은 사람,동점(의 시합),버팀목, play (shoot) off the ~ 결승 시합을 하다
tie beam : x, 이음보,지붕들보
tied house : x, (어느 특정 회사의 술만 파는) 주점
tiedye : n,vt, 흘치기 염색(하다),그 옷
tiein : a, 함께 끼어 파는
tiepin : n, 넥타이 핀
tier : n, (관람석 따위의) 1단,열
tier : vt,vi, 층층으로 포개어 (이)다
tiercel : n, (매사냥에 사용하는)
tiered : n, =TERCET
tiered : a, 층층의,단을 이룬
tieup : n, (스트라이크,사고 등에 의한) 교통 두절,업무 정지,(철도 종업원의) 준법 투쟁,제휴,타이업,협력
tiff : n,vi, 말다툼(을 하다),기분이 언짢음(언짢다),기분을 상하다
tiffany : n, 티파니(사의 일종)
tiffin : n, 점심
tiger : n, 범,호랑이,포악한 사람,(경기 따위의) 강적
tiger('s)-eye : n, 호안석
tiger cat : x, 살꽹이
tigereye : n, 호안석(황갈색,장식용)
tigerish : a, 범(호랑이)같은;사나운,잔인한
tiger lily : x, 중나리
tigerwood : n, 얼룩 무늬가든 아름다운 가구 용재(남미산)
tight : a, 탄탄한,단단히 맨,꽉 채운,팽팽하게 켕긴,(옷 따위)꼭 맞는,갑갑한,아담한,말쑥한,빈틈없는,발이 촘촘한,(물.공기 따위가)새지 않는,다루기 어려운,옴짝딸싹할 수 없는,거의 막상 막하의,접전의,핍박한,돈이 잘 안 도는
tight : ad, 단단히,굳게,푹, sit ~ 버티다,주장을 굽히지 않다
tight : n, 몸에 꼭 끼는 속옷,타이츠
tighten : vt,vi, 바싹 죄(어지)다,탄탄하게 하다(되다)
tightfisted : a, 인색한,구두쇠의
tightfitting : a, 딱 맞는,꼭 끼는
tightknit : a, (올을)쫀쫀하게 짠,조직이 탄탄한,단단하게 조립된
tightlaced : a, 꼭 끼는 코르셋을 입은,틀에 박힌,융통성 없는
tightlipped : a, 입을 꼭 다문,말이 적은
tightly : ad, 단단히,팽팽하게,꾀
tightmouthed : a, =TIGHTLIPPED
tightness : n, 견고,긴장,옹색항;금융 핍박
tightrope : n, 팽팽한 줄, ~ dancer (walker) 줄타기 곡예사
tights : n,pl, (댄서.곡예사 등이 입는)몸에 꽉 끼는 옷,티이츠
tightwad : n, 구두쇠
tiglon : n, =TIGON
tigon : n, 범사자(수펌과 암사자와의 트기)
tigress : n, 암펌
Tigrinya : n, 티그리냐 말(에티오피아 북부,셈계의 언어)
Tigris : n, (에소포타미아 동부의)티그리스강
tike : n, =TYKE
tiki : n, (폴리네시ㅏ 티키(인류를 창조한 신)티키의 상(나무.돌로 만들어 몸에 지님)
tikkie : n, =TICKY
tilapia : n, 틸라피아(아프리카 동부.남부 원산의 민물고기)
tilbury : n, 지붕이 없는 2륜마차(19세기 초에 유행)
Tilda : n, 여자이름
tilde : n, 스페인 말의 위에 붙이는 파선 부호
tile : n, 기와,타일,하수 토관,실크해트, on the ~s 방탕하여(밤을 보내다)
tile : vt, 기와를 이다,타일을 붙이다
tiler : n, 기와 제조인;기와 이는 사람,타일 일하는 사람,집회소 문지기
tilery : n, 기와 공장,타일 제조소
tiling : n, 기와 이기,타일 깔기,(집합적)기와,타일,기와 지붕,타일을 깐 면
till : prep,conj, ...까지,(...할때)까지
till : vt,vi, 갈다
till : n, 돈궤,귀중품함,서랍
tillable : a, 갈 수 잇는,경작하기에 알맞은
tillage : n, 경작;경지;농작물
tiller : n, 키의 손잡이
Tillie : n, 여자 이름
tilt : vi, 기울다,창으로 찌르다(at),마상 창 시합을 하다
tilt : vt, 기울이다(up),(창으로)찌르다,공격하다,(카메라를)상하로 움직이다,~ at windmills 가상의 적과 싸우다
tilt : n, 기울기,경사,기울임,(창의) (한 번)찌르기,마상 창 시합,논쟁 (at) full ~ 전 속력으로,전력을 다하여, have a ~ at (against) ...을 공격하다, on the ~ 기울어
tilt : n, (배.수레 등의)포장,차일(을 치다)
tilth : n, 경작,경지
tilttop : a, (외다리 탁자의)위판을 수직으로 눕힐 수 있는
tiltyard : n, 마상 창 시합장
timbal : n, =TIMPANI
timbale : n, 탱발(틀에 넣어 만드는 고기 찜,고기 파이)
timber : n, 재목,용재,큰 재목,선재,(재목용의) 수목,삼림,인품,소질
timber : vt, 재목으로 건축하다(버티다)
timber-frame(d) : a, 목골조의
timbered : a, 목조의,수목이 울창한,숲이 많은,(보통 복합어를 이루어)구조가...한,체격이...한
timberframe : a, 골조가 나무가 된
timberhead : n, 팀버헤드(뱃전에서 위로 내민 늑재늬 위 끝)
timberheaded : a, 멍청한,투미한,미련한
timber hitch : x, 원재따위에 밧줄을 매는 방법
timbering : n, (집합적)건축 용재,목재,목조
timberland : n, 삼림지
timber line : x, (높은 산이나 극지의) 수목 한계선
timberline : n, 수목 한계선(높은산.극지의)
timberwark : n, 나무짜기,나무틀,목재 공장,제재소
timber wolf : x, (북미산의)회색의 (얼룩진) 큰 이리
timberyard : n, 재목두는 곳
timbre : n, 음색
timbrel : n, =TAMBOURINE
Timbuktu : n, 팀북투,(일반적으로)멀리 떨어진 곳,원격지
time : n, 시간,때,세월,기간,시각,시,생애,시기,(복무)연한,근무시간,경험,시세,여가,번,박자,at the same ~ 동시에. at ~s 때때로, behind the ~s 구식의, for a ~ 한때,잠시, for the ~ being 당분간
time : vt, 시간을 재다,박자를 맞추다,좋은 시기에 맞추다,...의 시간을 정하다
time : vi, 박자를 맞추다,장단이 맞다(with)
time : a, 때의,시한의,후불의
time base : x, 시간축
time belt : x, =time zone
time bill : x, 정기불 약속 어음
timebinding : n, (자손들에 대한)인간의 경험 전달(능력)
time bomb : x, 시한폭탄
time capsule : x, 타임캡슐(그 시대를 대표하는 기물,기록을 미래에 남기기 위해서 넣어둔 그릇)
time card : x, 집무 시간 카드,기차 시간표
time charter : x, 정기 용선 계약
timeconsuming : a, 시간이 걸리는,시간을 낭비하는
timed : a, 일정 시간후 작동하도록 장치한,(보통 복합어를 이루어)때에 알맞은
time deposit : x, 정기 예금
time draft : x, 일람불 정기 어음
timeexpired : a, 제대 만기가 된,만기 제대의
time exposure : x, 타임 노출(의 사진)
timeful : a, 시기(때)에 알맞은
timehono(u)red : a, 옛날 그대로의,유서 깊은
timekeeper : n, 계시기(인),시계
time killer : x, 심심풀이가 되는것
time lag : x, 시간의 어긋남,지체(량)
timelapse : a, 계시노출(촬영)의 (식물의 성장처럼 더딘 경과의 촬영법)
time limit : x, 시한
timeline : n, 우주 비행중의 스케줄
timeliness : n, 적시,시기 적절함
timely : a, 때에 알맞은,시기적절한,적시의(충고 등)
time machine : x, 타임머신 (과거나 미래를 여행하기 위한 상상상의 기계)
time note : x, 약속어음
timeoff : n, 일을 쉰 시간
timeous : a, =TIMELY
timeout : n, (시합중 작전 협의 등을 위해 요구되는)타임,(중간) 휴식 (시간)
timepani : n,pl, 팀파니(바닥이 둥근 북)
timepiece : n, 시계
timeproof : a, 내구성이 있는,낡지 않는,쇠퇴하지 않는
timer : n, 시간 기록계,계시기(인),(내연 기관의)점화 조정 장치
timer : n, 시간 기록기;계시원(경기 등의),기초 시계,스톱워치,시간제 노동자,(내연 기관의)점화 시기 조절 장치,타임스위치,타이머
time recorder : x, 타임 레코더
Times : n, 타임스(신문 이름)세칭(런던 타임스)
timesaver : n, 시간을 절약하는 것
timesaving : a, 시간 절약의
timeserver : n, 기회주의자,시대에 영합하는 사람
timeserving : n,a, 사대적인,기회주의(의)
timeshare : vi, (시스템.프로그램)시분할하다
time sharing : x, (컴퓨터) 타임 셰어링,시배분(방식)
timesharing : n, 시분할(방식)(하나의 컴퓨터를 멀리 떨어져 있는 많은 사용자가 동시에 이용하기)
time signal : x, 시보
time signature : x, 박자기호
time sprit : x, 시대정신
Time Square : x, New York 시의극장가
timesymmetric : a, 시간 대칭의(팽창과 수축을 번갈아 되풀이하는 진동 우주 모델에 대해 말함)
timetable : n, 시간표(특히 탈것의)
timetested : a, 시간의 시련을 겪은,오랜 사용으로 보증이 된
timetravel : n, (추리소설 등의) 타임터널 여행
timework : n, 시간제일
timeworker : n, 시간급 노동자
timeworn : a, 낡은
timezone : x, (지방) 표준 시간대낡은
timid : a, 겁많은,수줍어하는
timing : n, 타이밍(음악,경기 등에서 최대의 효과를 얻기 위한 스피드 조절)
timocracy : n, 금권,정치,명예 정치
Timor : n, 말레이군도의 한 섬
Timorese : a,n, 티모르의(사람)
timorous : a, =TIMID
timothy : n, 디모데(마을의 제자),디모데서
timothy : n, 큰조아재비
Timour : n,pl, 티무르(1336-1405)(아시아 서반을 정복한 몽고 왕)
timpani : n,pl, (종종 단수 취급)
timpanist : n, 팀파니 연주자
tin : n, 주석,양철,주석 그릇,양철 깡통
tin : a, 주석으로(양철로) 만든
tin : vt, 주석을 입히다,통조림하다
tin-pan alley : x, 음악가,유행가 작사가(출판자) 등이 모이는 지역
tinamou : n, 티나무(중남미산의 메추라기 비슷한 새)
tincal : n, 천연붕사
tin can : x, 양철깡통,구축함
tinct : n, 빛깔
tinctorial : a, 빛깔의:착색(염색)의
tincture : n, 색,색조,기미,...한 티(기, 기미),정기제
tincture : vt, 착색하다,물들이다,풍미를 곁들이다,...의 기미(색조)를 띠게 하다(with)
tindal : n, (인도의)수부장
tinder : n, 부싯깃
tinderbox : n, 부싯깃통,타기 쉬운것,성마른 사람
tinderdry : a, 바싹 마른
tindery : a, 부싯깃 같은;불타기 쉬운,격하기 쉬운
tine : n, (포크 따위의)가지,(빛 따위의) 살,(사슴뿔의) 가지
tin foil : x, 주석박,은종이
ting : n,vt,vi, 딸랑딸랑(울리다)
tingaling : n, 방울 소리;딸랑딸랑,따르릉
tinge : n, 엷은 색(조),기미,...기,...티
tinge : vt, 엷게 착색하다,물들이다,가미하다,...에 기미를 띠게 하다(with),조금바꾸다(변질시키다)
tingle : vi,n, 따끔따끔 아프다(아픔),쑤시다,쑤심,마음 졸이다,조마조마함,흥분(하다),딸랑딸랑 울리다(tinkle)
tingly : a, 따금따금한,얼얼한;설레는,들먹들먹하는,설레게(들먹거리게)하는
tinhorn : n,a, 허풍쟁이,겉뿐인 (사람)
tinidity : n, 겁많음,소심,수줍음
tinker : n, 땜장이,서투른 일(장색)
tinkle : vt,vi, 땜장이 노릇을 하다,서투른 수선을 하다(away,at,with),만지작거리다
tinklebox : n, (미)피아노
tinkler : n, 딸랑딸랑 울리는 사람,(작은)방울
tinkling : n, 딸랑딸랑(울리는)
tin lizzie : x, 소형의 싸구려 자동차,중고 자동차
tinman : n, 양철장이
tinned : a, 통조림의(으로 한),주석(양철)을 입힌
tinner : n, 주석 광부,양철장이,통조림공(업자)
tinnitus : n, 귀울음,이명
tinny : a, 주석(tin)의 (을 함유한),양철 같은(소리의)
tin opener : x, 깡통따개
tinpan : a, 시끄러운 소리를 내는, 양철 같은 소리를 내는
tinpate : n, 양철
tin plate : x, 양철
tinplate : vt, (철판 등에)주석 도금 하다
tinpot : a, 값싼,열등한;보잘것 없는
tinsel : n,vt, 번쩍번쩍하는 장식물,금(은)실을 넣은 얇은 천
tinselly : a, 깝싸고 번지르르한
tinsmith : n, 양철장이
tinstone : n, 주석 광석
tint : n, 엷은빛깔,(푸른 기,붉은 기 따위의)...기,백색바림,색의 농담,색채(의 배합),색조,선음영
tint : vt, ...에 색을 칠하다,엷게 물들이다
tintack : n, 주석 도금한 압정
tinting : n, 착색;선을 흐리게 하기
tintinnabulation : n, 딸랑딸랑,방울소리
tintinnabulum : n, 작은 방울
tintinnadular : a, 방울의(같은)딸랑딸랑 울리는
Tintometer : n, 색조계(상표명)
Tintoretto : n, 베니스파의 화가
tintype : n, 에나멜판 인화사진
tinware : n, 양철 세공품
tinwork : n, 주석(양철)제품(세공)(단수.복수 취급)주석(얄철)공장
tiny : a, 아주 작은
tip : n, 끝,선단,정상,끝에 붙이는 것, at the ~s of one's fingers 정통하여, on(at) the ~ of one's tongue (말이) 목구멍까지 나와, to the ~s of one's fingers 모조리,철두철미
tip : vt, ...에 끝을 붙이다,끝에 씌우다
tip : vt, 기울이다,뒤집어 엎다(over,up),(뒤엎어)비우다(off,out),인사하려고 벗다(모자를)
tip : vi, 기울다,뒤집히다
tip-and-run : x, 전격적인
tipandrun : n, (크리켓)타봉에 공이 닿자마자 타자가 뛰기
tipcart : n, (뒤를 기울여 짐을 부리는)덤프카
tipcat : n, 자치기(어린이 놀이)
tipee : n, 티피(주가의 내부 정보를 입수하는 사람)
tipi : n, =teree
Tiplasmid : n, 티아이 플래즈미드(식물의 유전자 조작을 위한 대표적인 벡터로서 쓰이는 것)
tipoff : n, 내보,경고
tipper : n, 팁을 주는 사람,밀고자,쓰레기치는 인부;덤프차
Tipperary : n, 아일랜드 남부의 주(의 도시),(제 1차 대전 티페레리의 당시 유행한)노래
tippet : n, (끝이 앞으로 늘어진 여자용)어깨걸이,목도리,(특히)(성직자,재판관의)검은 스카프,(소매,스카프 등의)길게 늘어진 부분
tipple : vi,vt, (술을)잘(습관적으로) 마시다
tipple : n, (독한)술
tippler : n, 수꾼,술고래,대주가,석탄 선별 작업원
tippy : a, 엎어지기 쉬운,기울어지기 쉬운,불안정한
tippytoe : n,v,a, =TIPTOE
tipstaff : n, (옛날 집달리.순경 등의 끝에 쇠붙이가 붙은)직장,법정 경리,정리,순경
tipster : n, (경마,투기 따위의) 정보제공자
tipsy : a, 기울어진,비틀거리는,거나하게 취한
tiptilted : a, (코 등이)끝이 위를 향한
tiptip : n, 정상,꼭대기,절정,최고
tiptoe : n, 발끝, on ~ 발끝으로 (걸어서),살그머니,열심히
tipup : a, (극장 좌석 등이)세웠다 접었다 핫 수 있는
tipup seat : x, (극장 따위의)등받이를 세웠다 접었다하는 의자
tirade : n, 긴 열변,긴 비난 연설
tire : vt,vi, 피로하게하다,지치다(with,by),넌더리나게 하다(with),물리다(of), ~ out,or ~ to death 녹초가 되게 하다
tire : n,vt, (쇠,고무의) 타이어 (를 달다)
tired : a, 피곤한,지친,싫증난,물린,지겨운:듣는데 신물나다,세상이 싫어져서,(농담 등이)진부한,케케묵은,(물건이)낡아빠진
tiredly : ad, 지쳐서,물려서
tiredness : n, (물건은 사지 않고)보고만 다니는 사람
tireless : a, (사람이)지칠 줄 모르는,정력적인;근면한,(행동 등이)피로의 기색을 보이지 않는,꾸준한,(자동차가)타이어가 없는)
Tiresias : n, 티레시아스(Thebes의 장님 예언자)
tiresome : a, 귀찮은,성가신,지루한,따분한,진저리 나는
tirewoman : n, 몸종,시녀;(극장의)의상실,분장실
Tiro : n, =TYRO
Tirol : n, 티롤(오스트리아 서부와 이탈리아 북부의 알프스 산맥 지방)
Tirolese : a, =TYROLEAN
Tirolese : n,a, =TYROLESE
Tiros : n, 미국의 기상관측 위성의 하나
tirrivee : n, (스코)감정의 격발;격동,동요
tisane : n, 약탕
tissue : n, 조직,얇은 직물,(거짓말 따위의)뒤범벅,연속,탄소 인화지
tissular : a, 생체 조직의(에 관한,에 영향을 미치는)
tit : n, 작은새
tit : n, 젖꼭지
tit : n, 경타, ~ for tat 되받아 쏘아 붙이기,대음
Titan : n, 타이탄(olympus 의 신들보다 서 세계를 지배하고 있던 거인족의 한 사람),거인,위인,태양신,미국의 대륙간 탄도탄(ICBM)의 일종
Titan : a, 타이탄의(같은),거대한,힘센
titanate : n, 티탄산염
Titaness : n, 타이탄 여신,힘이 장사인 여인,덩치 큰 여자
Titania : n, 요정의 여왕
titanic : a, 타이탄 신의(같은),(종종t~)거대한,강력 무쌍한
titaniferous : n, 티타노사우루스(남미 백악기의 용각류의 공룡)
titanium : n, 티탄(금속원소,기호 Ti)
titanous : a, 3가 티탄의(을 함유한)
titattoe : n, =TICKACKTOE
titbit : n, =tidbit
titer : n, 역가;적정 농도
titfer : n, 모자
tithe : n, 십일조(1년 수익의 10분의 1을 바치며,교회 유지에 쓰임),작은 부분,소액의 세금
tithe : vt, 십일조를 부과하다(바치다)
tithing : n, 십일조의 징수(납부)십일조,십호반(일종의 반조직)
Tithous : n, 티토누스(새벽의 여신 Eos의 애인;만년에 매미가 됨)
Titian : n, 이탈리아의 화가
titilation : n, 간질임;간지러움,기분 좋은 자극,가흥
titillate : vt, 간질이다,...의 흥을 돋우다
titillating : a, 흥을 돋우는 기분 좋게 자극하는
tititvate : v, =titivate
titivate : vt,vi, 멋부리다,몸치장하다
titlark : n, 아메리카 논종 다리
title : n, 표제,제목,책이름,자막,타이틀,명칭,직함,권리,자격,선수권(a ~ match)
titled : a, 직함(칭호,작위)이 있는
title deed : x, 부동산 권리 증서
titleholder : n, 칭호 소유자;선수권 보유자
title page : x, 타이틀 페이지(책의 속표지)
title part (role) : x, 주제역
titlepiece : n, (책 이름과 같은 작품을 포함한)수필집,작품집
titler : n, 타이틀 촬영 장치
titling : n, (책의 등에)금박으로 제목을 박기;그 글자
titlist : n, 선수권 보유자
titmouse : n, 박새
Titoism : n, 티토주의(비국제 공산주의)
titrant : n, 적정제
titrate : vt,n, 적정하다,피 적정 용액
titration : n, 적정
titsandass : a, 유방과 엉덩이의,누드 사진의
titter : n,vi, 킥킥웃음,킥킥 거리다
tittivate : v, =TITIVATE
tittle : n, 조금,미소,작은점
tittlebat : n, =STIKLEBACK,
tittletattle : n,vi, 객적은 이야기(를 하다)
tittup : vi, 뛰어다니다,뛰놀다,뛰며 걷다,(보트가)흔들리다,(술 마시기 위해)동전을 던져 내기하다
tittuppy : a, 쾌활하게 뛰어다니는;동요하는,흔들흔들하는
titty : n, (여성의)젖꼭지,유방
titubation : n, (소뇌 장애로 인한)비틀 걸음
titular : a, 이름뿐인,직함이있는,표제(제목)의
Titus : n, 로마 황제,디도서(사도 방울이 Titus에게 보낸 편지)
tizz : n, =TIZZY
tizzy : n, 흥분(dither),6펜스
tlbetic : a,n, 척수로의(환자)
tluristy : a, 관광객풍의,관광객용의,관광객에게 인기 있는,관광지화된
Tman : n, 탈세 조사원
TMer : n, (미)초월 명상법의 신봉자(실천자)
tmesis : n, 분어법(복합어 등의 중간에 다른 말을 삽입하는 것)
to : prep, ... 으로,...에,...까지,위해,...에,...으로,...한(하였던)것으로는,...하게도,...에 맞추어,...에 비해서,...에 대해서,...의 ,...을 위하여,...에,...에 대해서,간해서,...(분)전
to : ad, 평상상태로,정지하여,에,으로
to-be : a, 미래의, bride- ~ 미래의 신부
toackclearer : n, (기관차 등의)배장기,제설 장치
toactability : n, 순종,취급하기(다루기)쉬움
toad : n, 두꺼비,지겨운 놈, eat a person's ~s (아무)에게 아첨하다
toadeater : n, 아첨꾼
toadeating : a, 아첨하는
toadfish : n, 아귀의 무리
toadflax : n, 해란초
toadinthehole : n, (영)밀가루.우유.계란 반죽을 입혀 구운 고기요리
toadstone : n, 두꺼비의 몸에서 생긴다고 믿었던 돌(옛 사람의 부적)
toadstool : n, 버섯,독버섯
toady : n,vt,vi, 아첨쟁이,아첨하다
toadyish : a, 아첨하는 비굴한,사대주의적인
toandfro : a, 뒤로움직이는
toast : n, 토스트
toast : vt,vi, (빵을) 토스트하다,굽다,불로 따뜻이 하다(따뜻해지다)
toast : n, 축배를 받는 사람,축배,축사
toast : vt,vi, (...을 위해서) 축배를 들다
toaster : n, 빵 굽는 사람(기구)토스터,여자의 비위를 잘 맞추는 사람
toastmaster : n, 축배를 제창하는 사람,축배의 말을 하는 사람,(연회의)사회자
toasty : a, 토스트의(같은);따뜻하고 쾌적한
tobacco : n, 담배
tobacconist : n, 담배 장수
tobaccophobe : n 혐연가;(특히)혐연권론자
tobacco pipe : x, 파이프,골통대
tobaccopipe : n, 골통대,담뱃대,(살담배)파이프
tobacco plant : x, 담배(나무)
tobaccoplant : n, 담배(가지과)
tobacco pouch : x, 담배쌈지
tobaccopouch : n, 살담배 쌈지
Tobago : n, 토바고섬(서인도제도의 섬)
tobe : a, (보통 복합어를 이루어;명사 뒤에서:신부 될 사람)
Tobit : n, 도빗서(외전의 한 책)
toboggan : n,vi, 바닥이 판판한 썰매(로 달리다),(물가가) 폭락하다
toby : n, 남자 이름,땅딸보 모양의 맥주 조끼(모자 부분으로 마심,가느다란 값싼 엽궐련
toccata : n, 토카타(오르간,하프시코드용의 화려한 환상곡)
Tocharian : a,n, 토카라어(사람)(의)(중앙 아시아에 있었던 인구어족)
tocher : n, (스코.영)신부의 지찬금
toco : n, 징계,체벌
tocology : n, 산과학
tocopherol : n, 토코페롤(비타민 E의 본체)
tocsin : n, 경종,경보
tod : n, (다음 구로) on one's ~ 혼자서,자신이
today : n,ad, 오늘,현재,오늘날
toddle : n,vi, 아장아장 걷기(걷다)
toddler : n, 아장아장 걷는 아이;비틀비틀(뒤뚝뒤뚝)걷는 사람
toddy : n, 야자술(즙),토디(더운 물을 탄 위스키 따위에 설탕을 넣은 음료)
todo : n, 법석(fuss),소동
tody : n, 벌잡이부채,새류의 일종(서인도제도 산)
toe : n, 발가락,발끝,도구의 끝, on one's ~s 활기있는,빈틈없는, turn up one's ~s죽다
toe : vt, 발가락으로 대다,(양말 따위의)부리를 대다
toe : vi, 발끝을 돌리다(in,out)
toed : a, (보통 복합어를 이루어)발가락이 있는,(못을) 비스듬이  박아 놓은
toedance : vi, 토댄스를 추다
toedully : ad, =totally
toehold : n, 발끝 디딜 홈,발 붙일 곳,발판,(조그만한) 거점,(레슬링)발비틀기
toein : n, 토인(자동차의 바퀴를 약간 안쪽으로 향하게 하기
toenail : n, 발톱,비스듬히 박은 못
toerag : n, (속)거지
toeshoe : vt, (발레)토댄스용 신키다
toey : a, 초조한,신경질적인,(말이)달리고 싶어하는,서두르는
toff : n, (속)신사,상류계급의 사람,멋쟁이
toffee : n, 토피(캔디)
toffeenosed : a, (속)콧대 높은,거드름 부리는
toft : n, 가옥과 대지,언덕
tog : n, 옷(을 입히다)
toga : n, 토가(고대 로마인의 헐렁한 겉옷),(재판관 등의)직복
togate : a, =togated
togated : a, 토가(toga)를 입은
together : ad, 함께,공동으로,서로,동시에,일제히,계속하여, ~ with ...와 함께
togetherness : n, 연대성,연대감,일체감,동류 의식
togger : n, =torpid
toggery : n, 의류
toggle : n,vt, 비녀장(으로 고정시키다)
toggle joint : n, 토글 이음쇠
Togo : n, 서아프리카 기니만에 임한 공화국
togoland : n, 아프리카 서부의 (구)영,불 위임통치령(현재 동부는 독립하여 Togo공화국,서부는 Ghan공화국의 일부로 편입
Togolese : n, 토고 사람
toil : n,vi, 수고,힘드는일,수고하다,고생(하다), ~ and moil 뼈빠지게 일하다
toil : n, 올가미(snare),그물
toiler : n, 고생하는 사람,임금 노동자
toilet : n, 화장(품,대),복장,의상,화장실,변소, make one's ~ 몸치장하다
toilet paper : x, (부드러운) 휴지,뒤지
toilet room : x, 화장실,(변소가 붙은)욕실
toiletry : n, 화장품류
toilet set : x, 화장도구
toilet soap : x, 화장비누
toilet table : x, 화장대
toilette : n, =toilet
toilettrain : vt, (어린 아이들에게) 용변을 가리게 하다
toilet training : x, (어린이에 대한)용병훈련
toilet water : x, 화장수
toilful : a, 힘드는,고생스러운
toilless : a, 힘들지 않은,수월한
toilsome : a, 고된
toilworn : a, 지친,야윈
tokamak : n, 토카막(제어열 핵융합 반응 실험 장치
Tokay : n, (헝가리의 도시) Tokay 산 포도(주)
toke : n,vt, 음식물,(특히 한 사람 분의) 빵,마리화나 담배 한 모금,마리화나 담배를 피우다
token : n, 표,증거,전조,기념품,유물,대용화폐,in (as a) ...의 표시(증거)로서,more by ~ of 더 한층,점점
token : a, 명목상의,이름만의(nominal)
token : n, 표,증거,상징,기념품,유물,증거품,대용화폐,토큰,서적 구입권,암호,신호
token coin : x, 대용화폐(버스 요금,자동 판매기에 쓰임)
token import : x, (소액의) 명목수입
tokenism : n, 명색만의 노력 하기,명목상의 인종차별 폐지
token money : x, 명목화폐(보조화폐,지폐 따위)
token payment : x, (채권국에의) 일부지불
token strike : x, (단시간의) 명목상의 스트라이크
token vote : x, (의회의) 가 지출결의
tokology : n, 	 =tocology
Tokyo : n, 도쿄(일본의 수도)
tokyoite : n, 도쿄 시민
tolazoline : n, 톨라조린(말초 혈관 확장제)
tolbooth : n, =tollbooth
tolbutamide : n, 톨부탐미드(내복용 당요병 치료재)
told : v, tell의 과거(분사)
Toledo : n, 톨레도 검(스페인의 Toledo에서 생산되는 질이 좋은 칼
tolerability : n, 참을 수 있음,(건강 상태가) 괜찮음
tolerable : a, 참을수 있는,상당한(passable)
tolerance : n, 관용,아량,내약력,공차,혀용차,여유
tolerant : a, 관대한,아량이 있는,내성이 있는
tolerate : vt, 참다,견디다,관대히 다루다,묵인하다
toleration : n, 관용,묵허,묵인
tolidine : n, 톨리딘(벤지딘계 염료의 중간체)
toll : n,vt,vi, 종(을(이) 천천히 울리다)
toll : n, 사용료,통행세,통행료,교량 통행료,항만세,운임,장거리전화료,사상자
tollage : n, 사용료,통행세
toll bar : x, 차단봉
tollboos : n, (스코)읍의 공회당,교도소,요금 징수소
toll bridge : x, 유료교
toll call : x, 장거리 전화(통화)
toller : n, 통행요금 징수원(기)
tolley : n, (구슬치기의)유리구슬
tollfree : a, (미)  무료장거리 전화의
tollgate : n, 통행료 징수소
toll house : n, 통행료 징수소
tollkeeper : n, 통행료 징수인
toll line : x, 장거리 전화선
tollman : n, =tollkeeper
tollol : a, (속)웬만한,괜찮은
toll road : x, 유료도로
tollway : n, 유료도로
tolly : n, (속)양초
Tolstoi : n, 톨스토이
tolstoy : n, 톨스토이
Toltec : n, 톨텍 사람(10세기경 mexico에서 번영했던 인디언)
toluate : n, 톨루엔산염,에스테르
toluene : n, 톨루엔(물감,폭약용)
toluidin : n, 톨루이딘(물감제조용)
tom : n, 동물의 수컷
tomahawk : n,vt, (북미 토인의)도끼,전부(로 찍다),bury the ~ 화해하다
tomalley : n, lobster의 간(삶으면 녹색이 됨)
toman : n, 토만(폐르시아의 화폐 단위)
tomatine : n, 토마틴
tomato : n, 토마토
tomb : n,vt, 무덤,매장하다
tombac : n, 구리와 아연의 합금
tombak : n, 구리와 아연의 합금
tombolo : n, 육계 사주(섬과 다른 육지를 연결하는 모래톱)
tomboy : n, 말괄량이
tombstone : n, 묘석
tomcat : n, 수코양이
tomcod : n, 대구과의 작은 물고기
tome : n, 큰책(large volume)
tomemturm : n, 솜털,대뇌 혈관망
tomentose : n, 면모(솜털,융모)로 덮인
tomentous : n, 면모(솜털,융모)로 덮인
tomfool : n, 바보,어릿광대
tomfoolery : n, 멍텅구리 짓,광대 짓,시시한 농담,하찮은 것
tomgirl : n, =Tomboy
tomism : n, =Uncle Tomism
Tommy : n, 영국 병정
Tommy gun : x, 경기권총
tommyrot : n, 허튼소리,바보짓
tommyshop : n, 공장 안의 매점,빵집,현물 지급 임금제 공장
tomnoddy : n, 바보
tomogram : n, (x선)단층 사진
tomograph : n, (x선)단층 촬영기
tomography : n, x선 단층 촬영(진단법)
tomorrow : n,ad, 내일
tomtit : n, 곤줄박이(류)
tomtom : n, (인도 등지의) 큰 북(소리)
tomtom : n,vi,vt, (인도,아프리카 등지의 통이 긴)북,덩덩(북소리),단조로운 리듬,덩덩 북소리를 내다,북소리로 신호하다,(리듬을)치다
ton : n, 톤(중량단위),톤(용적단위),다수,다량
tonal : a, 가락(음조,색조)의
tonality : n, 음조,색조
tonally : ad, 음조상,음색(색조)에 있어
toname : n, (주로 동성 동명인을 구별하기 위한)별명,첨가명
tondo : n, 원형 그림,조각이 있는 둥근 금속판
tone : n, 음질,가락,음(조),논조,어조,말투,기풍,품격,온음(정),(몸의)호조,색조
tone : vt,vi, 가락(억양)을 붙이다,가락(억양)이 붙다,조화시키다(하다),~ down 부드럽게 하다,부드러워지다,~ up 강해지다,강하게 하다
tone arm : x, (전축의)음관
tone colo(u)r : x, 음색
toned : a, (보통 복합어를 이루어)...음조의,엷게 물드린
tonedeaf : a, 음치의
tonedeafness : n, 음치
tonegue twister : x, 빠르게하면 혀가 잘 안도는 말
toneless : 음(음조,억양,색조)이 없는,단조로운\a,
tonely : ad,  
toneme : n, 음조소,토님
toneness : n,  
tone quality : x, 음색
toner : n, 조색액,(전자복사의)현상약
tonetic : a, 음조의,억양의,음조언어의
tonetics : n, 음조학
tong : n, 조합,협회,클럽,(미국에 사는 중국인의)비밀결사
Tonga : n, 남태평양의 소왕국
tongan : a, 통가제도(사람,말)의
tongs : n,pl, 부젓가락,집게
tongue : n, 혀,탕(소의 혀),혀 모양의 것,말,국어,coated (furred) ~ 설태,find one's ~ (놀란 뒤 따위) 겨우 말문이 열리다,hold one's ~ 잠자코 있다,long ~ 수다,lose one's ~ (부끄러움 따위로)말문이 막히다
tongue : vt,vi, (플루트 따위를)혀를 사용하여 불다,혀를 사용하다,(혀,화염이) 널름거리다(up)
tongued : a, 혀가 있는,혀(언어)가...한
tonguefish : n, 양서대과의 바다 물고기,참서대
tongueincheek : a, 놀림조의,성실치 못한
tonguetie : n,vt, 혀짤배기임,혀가 돌아가지 않게 하다
Toni : n, 가정용 파마 도구 한벌
Toni : n, 타니 미용 상자
tonic : a, (약이)강장용의,강직성의,음의,으뜸음의,강세가 있는
tonic : n, 강장제,으뜸음
tonicity : n, 음조,(심신의)건강,강장,(근육의)탄력성,긴장 상태
tonic solfa : x, 자음 기보법
tonify : vt, 유행시키다
tonight : n,ad, 오늘밤
toning : n, 가락을 맞추기,조색,도금
tonish : a, 유행의,유행을 쫓는,현대적 감각의
tonite : n, 뇌약(강력 면화약의 일종)
tonk : vt,n, 세게 때리다,강타
tonka bean : 통카콩(열대 아메리카산),
tonkin : n, 통킹대나무(스키 따위에 쓰임)
tonking : n, =Tonkin
tonlit : n, (중세 갑옷의) 쇠스커트
tonmile : n, 톤마일(톤수와 마일수를 곱한 것)
tonnage : n, (배의)용적 톤수,용적량,(한 나라 상선의)총톤수,(배의)톤세,(화물 따위의)톤수,gross(net) ~ (상선의) 총(순)톤수
tonne : n, =Metrlc ton
tonneau : n, (자동차의) 뒷좌석 부분
tonner : n, (보통 복합어를 이루어)...톤(급)의 배
tonometer : n, 음 진동측정기,음차,토노미터,혈압계,안압계
tonsil : n, 편도선
tonsillectomy : n, 편도선 절제(술)
tonsillitis : n, 편도선염
tonsorial : a, 이발(사)의
tonsure : n, 삭발한 부분
tonsure : vt, ...의 머리털을 밀다
tontine : n, Tonti식 연금법(가입자가 죽을 때마다 잔존자의 배당이 늘어 마지막 사람이 전액을 수령함)
Tonto : n, 아파치 지족의 원주민
tonup : a, 오토바이 번개족(시속 100마일로 폭주함)의
tonus : n, (건육 조직의)긴장(도)
Tony : n, 토니상(연극의 연간 우수상)
tony : a, 멋진,멋을 낸,우아한
too : ad, 또한,그위에,너무,지나치게,대단히,all ~ 너무나,none ~ 조금도 ...않은,...는 커녕,only ~ 유감이나,더할나위 없이
too-too : a,ad, 굉장한(하게),지독하게
toodleoo : int, 안녕히
toohlet : n,작은 이,
took : v, take의 과거
tool : n, 도구,공구,연장,공작기계,끄나불,잡이,압형기
tool : vt, ...에 도구를 쓰다,압형기로 무늬(글자)를 박다,(마차를)천천히 몰다
toolbox : n, 연장통
toolhead : n, 툴헤드(공구를 원하는 위치로 이동시키는 기게의 한 부분)
toolholder : n, (선반 등의) 날(바이트)고정기(장치)
toolhouse : n, 공구실
tooling : n, 공구세공,정 자국이 나란히 나게하는 다듬질,(표지의)압형,공작기계 일습
toolmaker : n, 연장 제작공,공구의 제작,수리,조정 전문 기사
toolroom : n,연장실,공구실,
toolshed : n, 도구 창고
toolway : n, =toll road
toom : a,내용이 없는,텅빈,
toon : n,인도 마호가니,
toot : n,vt,vi, 뚜우뚜우(울리다)
tooth : n, 이,이 모양의 물건,(톱의)이,맛,좋아하는 것,armed to the teeth 완전 무장하고,between the teeth 목소리를 죽이고
tooth-brush : n, 칫솔
tooth-comb : n, 참빗(으로 머리를 빚다)
tooth-paste : n, 크림모양의 치약
tooth-pick : n, 이쑤시개
tooth-powder : n, 가루 치약
toothache : n,치통,
toothbrushing : n,칫솔질,
toothed : a,이가 있는,
toothful : n,(브랜디 등의) 한모금,
toothing[t'u:8i7,n,(의치등)이를 해 넣기,톱니바퀴의 맞물림,이,톱니,(건물의)증축용 돌출부,
toothless : a,이가 없는,
toothpaste : n,(크림 모양의)치약,
toothsome : a, 맛있는
toothwort : n,유럽산 개종용의 일종,미나리냉이속의 식물,
toothy : a,상쾌한,이가 보이는,9종이가 거칠거칠한,효력이 있는,
tootle : vi, (피리 따위를) 가볍게 불다
tootle : n, 피리 소리
tootoo : a,몹시 심한,과격한,
toots : n,색시,아가씨,
tootsie : n,발,
tootsy : n,발,
tootsywootsy : n,발,
top : n, 정상,위끝,극점,절정,표면,수위,지붕,뚜껑,머리,(책의)상변,(구두의)상부,털술,장루,at the ~ of 될 수 있는한 ...으로,from ~ to toe(bottom,tail) 머리끝에서 발끝까지,온통,on ~ of it 게다가
top : a, 제일 위의,최고의,수석의
top : vt, ...의 꼭대기를 (표면을)덮다,...의 꼭대기에 있다,...의 위에 올라가다,...을 넘다,...을 능가하다,(식물의) 끝을 자르다,(공의)위쪽을 치다
top : vi, 우뚝 솟다,~ off (up) 완성하다,매듭을 짓다
top : n, 팽이,sleep like a ~ 푹 자다
top-cap : n,vt, (타이어의 표면의) 새로 갈아 붙인 부분,타이어의 표면을 갈아붙이다
top-heavy : a, 머리가 큰
top-notch : a, 일류의,최고의
toparch : n, 소국의 군주
toparchy : n, (몇개 도시로이루어지는 정도의)소국가
topaz : n, 황옥
topaz : n, 황옥,벌새의 일종(남미산)
topazolite : n, 황색(녹색,연두색,밀크색)의 석류석
top boots : x, 승마 구두,장화
topcoat : n, (가벼운) 외투
topcoat : n, 가벼운 외투,스프링코트(topper),(페인트 등의)마감칠,(사진 등의)보호막
topcross : n, 품종 계통간 교잡
topdown : a, 말단까지 잘 조직화된,통제가 잘 되어 있는,상의하달 방식의,모든 것을 커버하는,포괄적인
topdrawer : a, (중요성,특권 등이)가장 높은,최고의,가장 중요한
topdress : vt, (밭에)거름을 주다,시비하다,(도로 등에)자갈을 깔다
topdressing : n, 거름주기,시비,도로의 최상층(자갈,쇄석등)(비유)피상적인 처리
tope : vi,vt, 술을 많이 (습관적으로)마시다
topee,topi : n, 헬멧모자
Topeka : n, 토피카(미국 Krnsas주의 주도)
toper : n, 술고래
toper : n, 술고래
topflight : a, 일류의
topflight : a, 일류의
topful : a, (그릇의 가장자리까지)꽉찬,넘칠 정도의
topgallant : n,a, 윗돛대(의),윗돛대의 돛
topgallant : n,a, 윗 돛대(톱 갤런트 마스트)(의)(아래로부터 3번째의 돛대의),이 돛대에 걸리는 돛(의),최고(의),일류(의)
tophamper : n, 배상부의 돛,밧줄,갑판 위의 무거운 장비(포탑,보트,닻 등)
top hat : x, 실크 해트
tophat : a, 최상층의,톱의
Tophet : n, 도벳,지옥(hell)
Tophet(h) : n, 도벳,지옥
tophole : a, 일류(최고)의
tophole : a, 최고급의(first rate)
tophus : n, 통풍결정
topiary : a,n, 장식적으로 전정한(정원)
Topias : n, 남자 이름
topiaty : a, (정원수 등)장식적으로 다듬은,장식적으로 깎기(깎은 정원)
topic : n, 화제,논제,(연설의)제목
topic : n, 저서명,화제,이야기거리,토픽,논제,주제,제목
topical : a,n, 화제의,문제가 되어 있는,제목에 관한,원칙적인,총론적인,시사문제의,뉴스 영화
topicality : n, 일시적인 관심사,주제별 배열
topkick : n, 선임 하사관,상사(first sergeant),지도자,권력자,보스(boss),권위자
topknot : n, (머리의) 다발,(새의) 도가머리
topknot : n, 나비 매츱의 리본(17-18세기 여자의),(위로 돋아난)다발,술,볏,관모,도가머리,상투,넙치의 일종,머리(head)
topless : a,n, 유방을 드러낸(옷,수영복),매우높은
topless : n, (여성이)유방을드러낸,(옷이)토플리스의,(산 등) 꼭대기가 안보이는,매우 높은,한정이 없는,토플리스의 드레스(옷,수영복)
toplevel : a, 최고(수뇌)의
toplevel : a, 수뇌부의,고위층의,최고의,가장 중요한
topline : a, 가장 중요한,톱레벨의
topliner : n, 제 1인자,인기 배우
toplofty : a, 뽑내는
toplofty : a, 거만한,거드럭거리는
topman : n, 장루원
top management : n, (기업의) 최고경영 관리조직
topmast : a, 중간 돛대,톱마스터
topmast : n, 중간 돛대(아래 돛대 위에 잇댄 돛대)
topminnow : n, 톱미노(수면을 헤엄치는 송사리과 작은 물고기의 총칭)
topmost : a, 최고의,절정의
topmost : a, 최고의,최상(급)의(highest)
topoftheline : a, 최고급품의,최신식의,최신예의
topoggraphic : a, 지형학의
topographer : n, 지형학자,지지학자,지지 작자,풍토기 작자
topographical : a, 지형학의,지지의,지형상의,국소 해부의
topography : n, 지형학,지세,지지
topological : a, 위상적인
topology : n, 지세학,풍토지연구,위상수학
toponomastic : a, 지명의
toponym : n, 지명(에서 나온 이름)
toponymic : a, 
toponymy : n, 지명 연구,(어떤 지역,언어의)지명,(인체의)국소명,국소 명명법
topos : n, 토포스(늘 사용되는 주제,개념,표현)진부한 표현(생각)
topper : n, 위(상층)의것,(과일 따위) 잘 보이려고 위에 얹은 좋은 것,우수한 사람(것),뛰어난 것
topping : a, 우뚝 솟은,뛰어난
topple : vi,vt, 쓰러지다,쓰러뜨리다(down,over),흔들거리다,흔들리게 하다
topranked : a, 최상위의
topranking : a, 최고위의,일류의
tops : pred,a, 최상의
topsail : n, 윗돛대의 돛
top secret : x, 극비의
topseeded : a, 제5ㅣ드의,톱시드의(테니스,착구 등의 토너먼트에서 첫번째로 대진이 조정된 (선수))
topsergeant : n, 상사
top shell : x, 소라
topside : n, 홀수선 위의 현측
topsider : n, (조직의)상층부,수뇌부(의 사람),상갑판 승무원(담당 장교)
topsman : n, =HANGMAN
topsoil : n, 표토,상충토
topspin : n, (공이 회전하며 가도록)빗겨 치기,톱스핀
topsyturvy : n,ad,a, 전도,거꾸로 (된),뒤죽박죽(으로,의)
topwork : n,vt, 유방,젖(퉁이),...에 접목하다
toque : n, 테가 좁은 여성모자
tor : n, (울퉁불퉁한) 바위산
tora : n, 인도의 중량 단위,11,6638g
tora(h) : n, (유대교의) 율법
toralize : vt,vi, 합계하다,총계하다(add up),총력을 모으다,총계액 계산기를 사용하다
toran : n, (인도 등지의)절의 대문,산문
torch : n, 횃불,(연관공이 쓰는) 토치램프,막대 모양의 회중 전등,(지식,문화의)빛
torchbearer : n, 횃불드는 사람
torchier : n, (간접 조명용)플로어 램프
torchlight : n, 횃불빛
torchon : n, 접시 닦는 행주,거친 레이스의 일종
torchwood : n, 횃불용 나무
tore : v, tear의 과거
toreador : n, (말탄) 투우사
torero : n, 투우사
toreutic : a, 금속 세공의
toreutics : n, 금속 세공(술),조금(술)
torgus : n, 이주,이모
toric : a, (안경용)원환체 렌즈의,원환체의
torment : n, 고통,고민(거리),그원인
torment : vt, 괴롭히다,못살게 굴다,나무라다
tormentil : n, 양지꽃의 일종
tormentingly : ad, 몹시 성가시게,아주 귀찮게,못견디게,마음에 걸려
tormentor : n, 괴롭히는 사람(물건),(바퀴 달린)써레,고기 집는 긴 포크(배의 요리사가 씀),반향 방지 스크린(토키 촬영용),무대 양 의 가림막
tormentress : n, 남을 괴롭히는 여자
torn : v, tear의 과거분사
tornadic : a, 폭풍우의,회오리바람 같은
tornado : n, 큰 회오리 바람
Tornado : n, 캐나다의 남동부 Ontario 주의 주도
torose : a, 흑 모양의 돌기로 덮인 표면을 가진,염주 모양의 마디가 많은
torpedo : n, 어뢰,수뢰,(전방의 위험을 알리는,궤도상에 놓인)신호 뇌관,시끈가오리,aerial ~ 공뢰
torpedo : vt, 어뢰(따위)로 파괴하다,좌절시키다
torpedo boat : x, 어뢰정
torpedoboat destroyer : x, (어뢰)구축함
torpedo carrier (plane) : x, 뇌격기
torpedo net(ting) : x, 어뢰 방어망
torpedo tube : x, 어뢰 발사관
Torpex : n, 토펙스(폭뢰용 고성능 폭약)
torpid : a, 마비된,무감각한,(동면 중과 같이) 활발치 않은
torpidity : n, 무기력,무감각,마비 상태,휴면
torpify : vi,vt, 마비되다(시키다)무감각하게 되다(하다)
torpor : n, 마비,활동정지,지둔
torporific : a, 감각을 둔하게 하는,마비성의
torquate : a, (목둘레에)고리 모양의 깃털(빛깔)이 있는,목걸이(torques)가 있는
Torquay : n, 잉글랜드 남서부의 해변 보양 도시
torque : n, 비트는 힘,우력,(고대 사람의)비비꾄 목걸이
torrefaction : n, 건조(시킴),그을림,굽기
torrefy : vt, 말리다,그을리다,굽다
torrent : n, 분류,억수같이 쏟아짐,(질문,욕 따위의)연발
torrential : a, 급류의(같은)
Torricelli : n, 토리첼리(이탈리아 물리학자)
torrid : a, (햇볕에) 탄,염열의,열렬한
torridity : n, 염열
Torrid Zone : x, the 열대
torsel : n, 들보받이
torsi : n, TORREFY의 복수
torsion : n, 비틀림
torsional : a, 비트는,꼬이는
torso : n, 토르소(머리,손발이 없는 조상),허리통
tort : n, 민사범(계약 위반을 제외한)
torte : n, 계란,호도,과일 등으로 만든 고급 과자
torticollis : n, 사경(wryneck)
tortile : a, 비틀린,비틀려 감긴
tortilla : n, (납작한)옥수수빵(멕시코인의 주식)
tortious : a, 사범의,불법 행위의
tortoise : n, 거북,느림보
tortoise-shell : n, 별갑
tortoise-shell : a, 별갑의,별갑으로 만든,별갑 무늬의,삼색의(a ~ cat)
tortoni : n, 토르토니(버찌,아먼드를 넣은 아이스크림)
tortuosity : n, 꼬부라짐,비틀림,비틀린 것,부정
tortuous : a, 꼬불꼬불한,비틀린,마음이 빙퉁그러진,속검은
torture : n, 고문,고통,in ~ 괴로운 나머지(김에)
torture : vt, ...을 고문하다,몹시 괴롭히다,억지로 비틀다,곡해하다,억지로 갖다 붙이다(into,out of)
torturous : a, 고문의,고통 스러운,일그러진,구불구불한
torula : n, 토룰라(효모균의 일종)
torus : n, (두리 기둥 밑의)큰 쇠시리,꽃받기,꽃턱,화탁,융기,원환체
Tory : n, 왕당원,보수당원,영국 왕당원,보수적인 사람
Toryism : n, 왕당(보수)주의
Tosca : n, 토스카(Puccini의 사극)
Toscanini : n, 토스카니니(이탈리아 태생의 미국 오케스트라 지휘자)
tosh : n, 허튼(객적은)소리,(크리켓,테니스)완구
tosher : n, 종합 대학에서 어느 단과 대학에도 속하지 않는 학생
toss : vt, 던져올리다,던지다,아래위로 몹시 흔들다(풍파가 배를)번롱하다,(아무와) 돈던지기를 하여 결정짓다,토스하다,높이 쳐 올리다
toss : vi, 흔들리다,뒹굴다,돈던지기를 하다,~ oars (보트의)노를 세워 경례하다,~ off (말이)흔들어 떨어뜨리다,손쉽게 해 치우다,단숨에 들이켜다
toss : n, 던지기,던져 올리기,던지는(던져 올리는) 거리,상하의 동요,흥분,낙마,돈던지기
tossed green : x, (드레싱을 쳐서 가법게 휘저은)야채 샐러드
tosspot : n, 대주가,주정뱅이
tossup : n, 돈던지기,반반의 가망성
tost : v, toss의 과거(분사)
tot : n, 어린아이
tot : n,vt,vi, 합계(하다)
total : n,a, 전체(의),합계(의),완전한(a ~ failure)
total : vt,vi, 합계하다,합계...이 되다
total abstanince : x, 절대금주
total abstaniner : x, 절대금주가
totalitarian : a,n, 전체주의의,일국 일당주의의,전체주의자
totalitarianism : n, 전체주의,국가 통제주의
totality : n, 전체,합계,in ~ 전체로
totalization : n, 합계함
totalizator : n, 도율표시기,가산기
totalizer : n, 도율 표시기,합계하는 사람(물건)
totaltarian : a,n, 전체주의의,전체주의자
total war (warfare) : x, 총력전
tote : vt,n, 나르다,나르기,짊어지다,짊어지기,나른(짊어진)물건
totem : n, 토템(북아메리카 토인이 종족,가족의 상징으로 숭배하는 동물,자연물),토템상
totemic : a, 토템(신앙)의
totemism : n, 토템 숭배(신앙),토템 조직(제도)
totem pole (post) : x, 토템기둥(토템을 새겨 북미 토인이 집 에 세움)
Tottenham pudding : x, (부엌 찌끼를 처리한)돼지먹이,꿀꿀이 죽
totter : vi,n, 비틀거리다,비틀거림,뒤뚝뒤뚝 걷다(걷기),흔들리다,흔들리기
tottery : a, 비틀거리는,불안정한
touancy : n, 무단 결석,꾀 부리기
toucan : n, 거취조(남미 열대산의 부리 큰 새)
touch : vt, 대다,만지다,접촉(인접)하다,필적하다,(악기의 줄을)가볍게 타다,접하다,접촉시키다,조금 해치다,감동시키다(move),가볍게 쓰다(그리다),색깔을 띠게 하다,가미하다,언급하다,닫다,달하다,사용하다,먹다,마시다
touch : vi, 대다,접하다,...의 감촉이 있다,...에 가깝다,기항하다,~ and go 잠깐 들렀다가 나아가다,~ down 터치다운하다,~ off 정확히(솜씨좋게)나타내다,휘갈겨 쓰다,(그림에) 가필하다,발사하다,개시시키다
touch : n, 대기,접촉,촉진,촉감,정신적 접촉,동감,기미,약간,가벼운 병,성질,수법,돈을 우려냄,그 돈,keep in ~ with ...과 접촉을 유지하다,put (buring) to the ~ 시험하다,~ of nature 자연의 감정,인정
touch-and-go : a,n, 아슬아슬한(상태)
touch-me-not : n, 봉선화,노랑물봉선화(따위)
touch-tone : a, 누름단추식의 (전화기)
TouchaMatic : n, 터처매틱 전화기(30개 이상의 전화번호를 미리 기억 시켜 둘 수 있는 전화기,상표명)
touchback : n, 터치백(골키퍼가 적의 공을 골 선상 또는 후방 지면에 대기)
touchback : n, 터치백(goalkeeper 가 상대방이 던진공을 껴안고 추는 춤)
touchdown : n, 터치다운(의 득점),단시간의 착륙
touche : int,n, (한번)찔렸다,(토론 등에서)손들었다,잘한다,한 번 찌르기,급소를 찌르는 논법,묘답
touched : a, 머리가 약간 돈,감동한
touched : a, 감동된,조금 미친
toucher : n,ad, 만지는 사람(물건,거의,아슬아슬하게
touchhole : n, (구식 총의)점화구
touching : a,prep, 감동시키는,애처로운,...에 관해서
touching : a,prep, 감동시키는,감동적인,애처로운,...에 관하여(concerning)
touchingoal : n, 터치인골(경기장 네구석에 접하고,골라인과 터치라인의 연장으로 둘러싸인 구역)
touchlast : n, 술래잡기
touchline : n, 측선,터치라인
touchline : n, 터치라인,측선
touch paper : x, 도화지
touchsensitive : a, 손가락 등을 대면 감응하는
touchstone : n, 시금석,(시험의)표준
touchtype : vi, (키를 보지 않고)타자하다
touchup : n, (사진,그림 등의)수정,가필,(시공된 설비,건축물 등의)조그마한 변경(수정,부가)(에 의한 처리),마감 손질
touchwood : n, 부싯깃(punk),술래 잡기의 일종
touchy : a, 성마른,성미까다로운,다루기 힘든,인화성의
tough : a, 강인한,구부려도 꺾이지 않는,곤란한,고된,괴로운(hard),난폭한,다루기 힘든
tough-minded : a, 감성적이 아닌,현실적인,굳센
toughen : vt,vi, TOUGH하게 하다(되다)
toughie : n, 불량배,깡패,건달,호전적인 사람,어려운 문제(사태),조합한 책(영화)
touguelash : vi,vt, 호되게 꾸짓다
touguelashing : n, 호된 꾸짖음
tougueless : a, 혀가 없는,말을 안 하는,벙어리의
touguetied : a, 혀가 짧은,(당황해서)말문이 막힌,말을 하지 않는
touguey : a, 잘 지꺼리는,말 하기를 좋아하는
touguing : n, 꾸짖음,혀끝을 놀려 (관악기를)취주하는 단주(법),설상돌기(를 만듦)
toupee : n, 가발,다리
tour : n,vt,vi, 관광(유람) 여행(하다),주유(하다),소풍(가다),go on a ~ 순유(만유)하다,on ~ 만유(순업)하여
touraco : n, (아프리카산)관모가 크고 아름다운 새
tourbillion : n, 회오리바람,(기계,액체의)소용돌이,빙빙 돌며 하늘로 치솟는 불꽃(봉화)
tour de force : x, 힘부림 재주,놀라운 재주
tourer : n, =touring car
touring car : x, 포장형 지동차
touring company : x, 지방순업중인 일행
tourism : n, 관광 여행,관광 사업,관광객
tourist : n, 관광객
tourist bureau (agency) : x, 여행사,관광 안내소
tourist camp : x, 관광객용 캠프
tourist class : x, (기선,비행기의) 2등
tourist court : x, =MOTEL
touriste : n, (프랑스 어권에서의)캐나다 설사
tourist home : x, 민박숙소
touristic : a, (관광)여행의,관광객의
tourist party : x, 관광단
touristry : n, 광광 여행,유람,여행자,관광단
tourist ticket : x, 유람표
tourist trap : x, (관광) 여행자 상대로 폭리를 취하는 장사
tourmalin(e) : n, 전기석
tournament : n, (중세의) 마상시합,시합,경기,승자 진출전,토너먼트
tournedos : n, 투르노도(소의 필레(filet)살의 가운데 부분을 쓴 스테이크)
tourney : n,vi, 에 참가하다
tourniquet : n, 지혈기
tournure : a, (스커트를 펴는)허리 받침(bustle)
tousle : vt,n, 헝클어뜨리다,헝클어진 머리
tousy : a, 흐트러진,임시 변통의
tout : vi, 성가시도록 권유하다,강매하다,(연습중의 경마말의)상태를 몰래 살피다(정보를 제공하다),정보 제공을 업으로 삼다
tout : vt, 끈질기게 요구하다,졸라대다,(말의)상태를 살피다,(상금의 배당에 한몫 끼려고,말의)정보를 제공하다
touvarich : n, 동지,소련 사람
touzle : n, TOUSLE
tow : n,vt, (연안을 따라서) 배를 끌기(끌다),끌려가는 배,(소,개,수레 따위를)밧줄로 끌다(끌기),끄는 밧줄,take in ~ 밧줄로 끌다(끌리다),거느리다,돌보아주다
tow : n,a, 삼 부스러기(로 만든)
towage : n, 예선(료)
toward : prep, ...의 쪽으로,...에 대하여,...으로의,...가까이,무렵,...을 위하여(생각하여)(for)
toward : a, 온순한
towardly : a, =TOWARD
towards : prep, =TOWARD
towaway : n,a, (주차 위반 차량의)견인 철거(의)
towaway zone : x, 주차금지 지대(위반 차량은 끌어감)
towbar' : n,vt, 견인봉,토바(자동차 견인용 철봉),(자동차를)견인봉으로 잡아 끌다
towboat : n, =TUGBOAT
tow car (truck) : x, 구난차(트럭),레커차(wrecker)
towel : n,vt, 수건(으로 닦다),타월,throw (toss) in the ~ (패배의 인정으로)타월을 (링에) 던지다,패배를 인정하다,항복하다
towel horse (r'ack) : x, 타월걸이
toweling : n, 수건천,수건으로 닦음,채찍질
tower : n, 탑,성루,성채,요새
tower : vi, 높이 솟아 오르다,우뚝 솟다
towered : a, 탑이 있는
towering : a, 높이 (치)솟은(lofty),큰 원대한
towerman : n, 신호원,항공 관제관
towery : a, 탑모양의,우뚝 솟은
towhead : n, 옅은 황갈색머리(의 사람)
towhead : n, 아마색 머리털(의 사람)
towingline : n, =TOWLINE
towline : n, (배의)끄는 밧줄
town : n, 읍,소도시,(자기고장)근처의 주요도시,지방의 중심지,번화가,상가,읍민,시민,a man about ~ 놀고 지내는 사람(특히 런던의),go down ~ 상가에 가다,~ and gown 시민측과 대학측
town clerk : x, (읍사무소의)서기
town council : x, 시(읍)의회
town councilor : x, 읍의회 의원
town crier : x, (읍 규칙을) 선포하고 다니는 직원
townee : n, 도시(읍)사람,대학 도시의 사람(대학에 관계없는 사람)
towner : n, 도시 사람
townet : n, (표본채집용의)예망
townet : n, =TOWING NET
town gas : x, 도시 가스
town hall : x, 읍사무소,시청,공회당
town house : x, 도시의 저택(시골에 country house가 있는 사람의)
townie : n, =TOWNEE
townify : vt, 도회식으로 하다,도시화하다
townish : a, 도시(식)의
town meeting : x, 읍민 대회,(New England의)군구 대표자회(의)
town planning : x, 도시계획
townscape : n, 도시풍경(화),도시 조경법
townsfolk : n,pl, 도시주민,읍민
township : n, 읍구,군구,(교구의)분구
townsite : n, 도시 건설 부지
townsman : n, 도회지 사람,읍민,읍내사람
townspeople : n,pl, =TOWNSFOLK
townswoman : n, 도회지 여인,같은 읍내의 여인
town talk : x, 읍내의 소문,소문의 근원
townwear : n, 나들이 옷,외출복(일반적으로 색이 어둡고 점잖은 옷)
towpath : n, 배 끄는 길
towrope : n, 배의끄는 밧줄(=TOWLINE)
towser : n, 몸집이 큰 개,몸집이 크며 억센 바람,정력적으로 일하는 살감
toxaemia : n, 독혈중
toxemia : n, 독혈중
toxic : a, (중)독의
toxicant : n, 옥
toxication : n, 중독
toxicity : n, (유)독성
toxicogenic : a, 독물 발생의,독물로 형성된
toxicoid : n, 독성 화학 물질
toxicologic : a, 독물학(상)의,독소의
toxicology : n, 독물학
toxicology : n, 독물학
toxicosis : n, 중독(증)
toxigenic : a, 독소를 생산하는,독소 발생의
toxin : n, 독소
toxiphobia : n, 독물 공포(증)
toxocariasis : n, 톡소카라증(개에 기생하는 Toxocara회충에 의한 감염증)
toxoid : n, 톡소이드,변성 독소(예방 주사에 쓰는 독소)
toxophilite : n,a, 궁술 애호가,궁술가,궁술(가)의
toxophily : n, 궁술 연구(연습)
toxoplasmosis : n, 주혈 원충병
toy : n, 장난감(같은 물건),하찮은 것,make a ~ of 희롱하다
toyman : a, 장난감 상인,완구 제조인
Toynbee : n, 토인비(영국의 역사가)
toyon : n, 장난감 가게,완구점
toyshop : n, 장난감 가게
trabeation : n, 상인방식 구조
trabecula : n, 주,결체(근육)조직 돌기(비장의 비주,심장의 육주)
trace : n, 발자국,형적,흔적,기미,조금,선,도형,(hot) on the ~s of ...을 추적하여
trace : vt, 추적하다,발견하다,더듬어 가다,...의 유래를 조사하다,(선을)긋다,(그림을)그리다,베끼다,투사하다,(창문에)장식 무늬를 붙이다
trace : vi, 뒤를 밟다,나아가다,~ back 더듬어 올라가다,~ out 행방을 찾다,베끼다,그리다,획책하다
trace : n, (마차 말의)봇줄,in the ~s 봇줄을 매이어,매일의 일에 종사하여,kick over the ~s 말을 안 듣다
traceable : a, TRACE할 수 있는
trace element : x, 미량,원소 (체내의 미네랄 따위)
traceless : a, 흔적이 없는,자국을 남기지 않는
tracer : n, 추적자,투사,용구,유실물 조사계,분실물(행방불명자)수사 연락(조회),예광탄,추적자
tracer atom (element) : x, 추적자,추적 원소
tracer bullet : x, 예광탄
tracery : n, 장식 무늬 창살
trachea : n, 기관
tracheitis : n, 기관염
tracheotomy : n, 기관 절제술
trachoma : n, 트라코마
trachyte : n, 조면암(화산암의 일종)
trachytic : a, 조면암 모양의
tracing : n, 추적,투사,복사,자동 기록 장치의 기록
tracing paper : x, 투사지,복사지
track : n, 지나간 자국,흔적,발자국,통로,궤도,선로,경주로,육상경기,in one's ~s 즉석에서,곧,in the ~ of ...의 예에 따라서
track : vt, ...에 발자국을 남기다,(진흙,눈 따위를) 신발에 묻혀 들이다(into),추적하다(down),찾아내다(out),(배를) 끌다
trackage : n, (어떤 철도의) 전선(로),(다른 회사) 궤도 사용권(료)
track and field : x, 육상경기
tracker : n, 추적자,수색자,경찰견,사냥감을 쫓는 사냥개,(오르간의)트래커
track events : x, 트랙 종목(러닝,허들따위)
tracking : n, 추적,능력(적성)별 학급 편성
tracking station : x, (인공위성) 추적소,관측소
tracklayer : n, 선로 부설 인부,보선공
tracklaying : a,n, 궤도 부설에 쓰이는,(차가)무한 궤도식의,선로 부설
trackless : a, 발자국 없는,길 없는,인적 미답의,무궤도의,자취를 남기지 않는
trackman : n, (철도)보선공,트랙 경기자
track meet : x, 육상 경기회
track system : x, 학력별 반편성
trackway : n, 밟아 다져진 길,(옛 날의)도로
tract : n, 넓은 땅,지역,(하늘,바다의)넓이,기간,관,계통
tract : n, 소논문,소책자,(종교 관계의)팜플렛
tractable : a, 유순한,세공하기 쉬운
tractate : n, (소)논문
tractile : a, 잡아 늘일수 있는
Tractility : n, 연성,신장성
traction : n, 견인(력),(바퀴 따위의) 마찰
traction engine : x, 노면 견인 기관차
tractive : a, 당기는,원하는
tractor : n, 끄는 도구,트랙터,견인차,프로펠러식 비행기
tractorcade : n, (농민의 시위,항의 행동으로서의)트랙터 행렬(행진),트랙터 데모
tractortrailer : n, 트레일러달린 트랙터
Tracy : n, 여자(남자)이름
trad : a, =TRADITIONAL
trad-last : n, 교환을 조건으로의 칭찬의 말
trade : n, 매매,상업,거래,무역,직업,손일,(동)업자들,고객,(정당간의)거래,타협,be good for ~ 살 마음을 일으키게 하다
trade : vi, 장사(거래)하다,사다,교환하다,(정당 등이) 뒷거래하다
trade : vt, 팔다,매매하다,~ away (off) 팔아 버리다,~ in (물품을)대가로 제공하다,~ on ...을 이용하다
trade(s) union : x, (직업별)노동 조합
trade(s) unionism : x, 노동 조합 제도
trade(s) unionist : x, 노동 조합원
trade agreement : x, 노동(무역) 협정
trade balance : x, 무역 수지
trade cycle : x, 경기 순환
tradein : n, 대가의 일부로서 제공하는 물품(중고차 따위)
tradelast : n, 제 3자의 칭찬(좋은 평판)(자기의 평판이 좋음을 전해주는 상대에게 전하는)
trademark : n, (등록)상표
trade mission : x, 무역 사절단
trade name : x, 상표(상품)명,상호
tradeoff : n, 교환,흥정,(동시에 달성할 수 없는 몇개 조건을 취사 선탠하여)균형(평균)을 취하는 일
trade pact : x, 무역 협정
trader : n, 상인,상선
trade route : x, 통상(항)로
trade school : x, 실업 학교
tradesfolk : n, =TRADESPEOPLE
tradesman : n, 소매상인
tradespeople : n, 상인,소매상(가족,계급)
trade wind : x, 무역풍
trading company : x, 상사(商事)회사
trading estate : x, 산업 지구
trading post : x, 미개지의 교역소
trading stamp : x, 경품권(몇 장씩 모아서 경품과 교환함)
tradition : n, 전설,구전,관례,인습,전통,(모세 또는 예수와 그 제자로부터 계승한)성전
tradition : n, 전설,구전,구비,전승
traditional : a, 전설의,전통의,전통적인,(재즈가)전통적인
traditionalism : n, 전통(인습)의 고집,전통주의
traditionalist : n, 전통주의자
traditionalize : vt, 전통에 따르게 하다,...에게 전통을 가르치다(지키게 하다)
traduce : vt, 중상하다
traducian : n, 영혼 전이론자,영혼 전이설
Trafalgar : n, 스페인 남서 해안의 곶(1805년 그 바다에서 Nelson이 프랑스,스페인 연합 함대를 격파하였음)
Trafalgar Square : x, 런던의 광장
traffic : n, (사람,수레,배의)왕래,교통,운수(량),거래,무역,교제,화물(의 양),승객(수)
traffic : vt,vi, 장사(거래)하다,무역하다(in,with),(명예를) 팔다
trafficable : a, (물자 등이)상거래에 알맞은,시장성이 있는,(도로 등이)자유로 왕래(통행)할 수 있는
trafficator : n, (자동차의) 방향 지시기
trafficcast : n, 도로 교통 정보 방송
trafficcaster : n, 도로 교통 정보 아나운서
traffic circle : x, 원형 교차점,로타리
traffic control : x, 교통 정리
traffic cop : x, 교통 순경
traffic court : x, 교통 재판소
traffic island : x, (거리의)안전 지대
traffic jam : x, 교통마비
trafficker : n, 상인,무역업자
traffic policeman : x, 교통 순경
trafficreturns : n, 운수 보고(철도 등의 정기적인)
traffic sign : x, 교툐 표지
traffic singal : x, 교통 신호(기) (신호등)
traffic ticket : x, 교통 위반 딱지
trafficway : n, 도로 용지,차도
tragacanth : n, 트래거캔스 고무(풀,제약용)
tragedian : n, 비극 작가,비극 배우
tragedy : n, 비극,참사
tragic : a, 비극의,비극적인,비참한
tragical : ad, 비극적으로,비참하게
tragicomedy : n, 희비극
tragopan : n, 주계,호로호로새(아시아산 꿩과의 새)
trail : vt, (옷자락 따위를) 질질 끌다,늘어뜨리다,끌며(늘어뜨리며) 가다,...의 뒤를 쫓다(follow),길게 이야기하다,(풀을)밟아서 길을 내다
trail : vi, 질질 끌리다,(머리카락,밧줄 따위가)늘어지다,꼬리를 끌다,(담쟁이,뱀 따위가)기다,으로 뻗치다,발을 끌며 걷다(along),(목소리 따위가)점점 사라지다
trail : n, (발)자국,(사냥 짐승의)냄새 자국,오솔길,늘어진 것,(연기,구름의) 으로 뻗침,단서,off the ~ 냄새 자국을 잃고,길을 잃고,on the ~ of ...을 추적하여
trailblazer : n, (미개지 등에서 길표지가 되도록)길에 표를 하는 사람,개척(선구)자(pinoeer)
trailer : n, 끄는 사람(것),만초,추적자,동력차에 끌리는 차,트레일러,예고편,(필름의) 감은 끝의 공백의 부분
trailerable : a, 트레일러로 이동(운반)할 수 있는
trailer bus : x, 견인차가 달린 대형 버스
trailer coach : x, 이동 주택차
trailerist : n, 이동주택으로 여행하는 사람
trailerite : n, 이동 주택의 주민(거주인)
trailer park : x, 이동 주택 주차지
trailer pump : x, 이동 소방 펌프
trailership : n, 트레일러선(자동차 수송용)
trailhead : n, 자취의 기점
trailing : a, 질질끌리는,길게 나부끼는(연기,구름 등),기는(덩굴 등)
trailing plant : x, 덩굴풀,만초
train : vt, 훈련하다(양성,교육)하다,(말,개 따위를)훈련시키다,길들이다,손질하여 가꾸다,(코를)돌이다(upon),꾀다,유혹하다
train : vi, 훈련(연습)하다,몸을 단련하다,사이좋게 하다,~ down (선수가)단련하여 체중을 줄이다,~ it 기차로 가다
train : n, 뒤에 끄는 것,옷자락,(새,혜성의) 꼬리,열차,기차여행,열,일행,차례,순서,down(up,through) ~ 하행(상행,직통)열차
trainband : n, (16-18세기에 런던 등에 있었던)민병단
trainbearer : n, (의식때)옷자락 들어주는 사람
trained nurse : x, 유자격 간호부
trainee : n, 훈련생,견습공
train ferry : x, (열차를 실은 채 건너는) 열차 연락선
training : n, 훈련,교련,트레이닝,(말의) 조교,(경기의) 컨디션,정지법,가지 다듬기,가꾸기
training college : x, 교원 양성소,교육 대학
training school : x, 양성소,소년원,훈련소
training seat : x, 소아용 서양식 변기
training ship : x, 연습선,연습함
training squadron : x, 연습 함대
trainload : n, 열차 적재량
trainman : n, 열차승무원,(특히) 제동수
trainmaster : n, 열차장(열창 운행 책임자)
train oil : x, 경유,어유
trainsick : a, 기차 멀미하는
traipse : vi, 싸다니다,어정거리다,질질 끌리다(치마 등이)
trait : n, 특색,특징,얼굴 모습
traitor : n, 반역자,매국노,배반자(to)
traitorous : a, 반역의,배반적인,반역죄의
traitress : n, TRAITOR의 여성형
traject : vt, (빛 등을)통하게 하다,전도하다(transmit),(강 등을)건너가다,엄다
trajectory : n, 탄도,(혜성,혹성의)궤도
trala : int, 트랄라(유쾌한,환희 기분을 나타내는 발성으로 트거히 노래에서 사용)
tram : n, 궤도(차),시가전차,석탄차,광차
tramcar : n, 시가전차
tramline : n, 전차 선로
trammel : n, 말의 족쇄(조교용),속박,구속(물),물고기(새)그물,만능 갈고리
trammel : vi, 구속하다,방해하다
trammie : n, 노면(tram)의 운전사(차장)
tramontane : a, 산너머의,산너머에서 오는(원래는 이탈리아 쪽에서 보아서 알프스 저쪽의 뜻),외국의,야만의
tramp : vi, 짖밟다,(무겁게) 쿵쿵걷다,터벅터벅 걷다,도보 여행하다,방랑하다
tramp : vt, ...을 걷다,짓밟다
tramp : n, 무거운 발소리,방랑자,방랑 생활,긴 도보 여행,부정기 화물선,매춘부,on(the) ~ 방랑하여
tramper : n, 도보 여행자,터벅터벅 걷는 사람,떠돌이
trample : vt,vi, 짓밟다,유린하다,심하게 다루다,무시하다
trample : n, 짓밟음,짓밟는 소리
trampolin(e) : n, 트램펄린(쇠틀 안에 스프링을 단 즈크의 탄성을 이용하여 도약하는 운동 용구)
trampolining : n, 트램폴리닝(트램폴린을 이용한 도약 회전 운동)
tramp steamer : x, 부정기 화물선
tramroad : n, (특히 광산 따위의) 궤도,광차도
tramway : n, =TRAMLINE
trance : n,vt, 꿈결,비몽 사몽,황홀(혼수)상태(로 만들다)
tranny : n, 트랜지스터라디오
tranquil : a, 조용한,평온한
tranquility : n, 평온,고요함,평정,(월면의)고요의 바다
tranquilization : n, 안정,진정
tranquilizer : n, 정신 안정제
transact : vt, 취급하다,처리하다,하다(do)
transact : vi, 거래하다
transaction : n, 초악티니드 계열
transactor : n, 취급자,처리하는 사람
transalpine : a,n, (이탈리아쪽에서)알프스 저편의 (사람)
transAmerican : a, 아메리카 횡단의
transatlantic : a,n, (보통 유럽측에서) 대서양 건너의(사람),아메리카의(사람),대서양 횡단의(기선)
transaxle : n, 트랜스 액슬(전치기관,전륜 구동차에서 변속장치와 구동축이 일체가 된 것)
transbus : n, 초대형 개조 버스(노인,신체 장애자를 위한)
transcalent : a, 열을(잘)통하는(전하는),열양도성의
transceiver : n, 라디오 송수신기
transcend : vt,vi, 초월하다,능가하다
transcendence : n, 초월,탁월,(신의)초절성
transcendent : a,n, 탁월한,뛰어난,출중한,초월적인,경험을 초월한,선험적인,초월적인,탁월한 사람(것),선험저거인 것
transcendental : a, 초자연적인,모호한,추상적인,이해할수 없는,
transcendentalism : n, 선험 철학(칸트의),초월론(에머슨의),탁월성,불가해,환상
transcendentalist : n, 선험론자,초월론자
transcendentalize : vt, 우월케 하다,초월시키다,이상화 하다,이상주의적으로 처리(표현)하다
transcontinental : a, 대륙횡단의,대륙 저쪽의
transcribe : vt, 베끼다,전사하다,(다른 악기용 따위로) 편곡하다,녹음(방송)하다
transcriber : n, 필사생,등사자,전사기
transcript : n, 베낀것,사본,등본
transcriptase : n, 전사 효소
transcription : n, 필사,모사,복사,바꿔 씀,전사,바꿔쓴 것
transcurrent : a, 가로 건너는,횡단하는,으로 뻗는
transduce : vt, (에너지 등을)변화하다,(유전자 등을)형질 도입하다
transducer : n, 변환기
transductant : n, 형질 도입주
transduction : n, (에너지 등의)변환,형질 도입
transearth : a, 지구로 향하는
transept : n, (십자형식 교회당의 좌우의) 수랑(의 총칭)
transfect : vt, (분리된 핵산을)세포로 감염 시키다
transfer : n, 전환,이동,전학,전임,(권리의)이전,(명의의)변경,대체,환,갈아타기,갈아타는 표
transfer : vt, 옮기다,나르다,양도하다,전사하다,전임시키다
transfer : vi, 옮다,전입되다,갈아타다
transferase : n, 전이 효소
transfer company : x, 근거리 운송회사(두 터미널 역 구간 등)
transferee : n, 양수인,전임(전속,전학)자
transference : n, 옮김,옮기기,이전,이동,운반,양도,매도,전이
transferential : n, 이전의,양도에 관한,전사
transferor : n, 재산 양도인,재산 이전자
transferrer : n, 양도인,매도인,전사자,전송자
transfer RNA : x, 전이 RNA,운반 RNA
transfer table : x, (지상식)천차대
transfer tax : x, 상속세,양도세
transfiguration : n, 변형,변모,(예수의)변형
transfigure : vt, 변모(변용)시키다,거룩하게 하다,이상화하다
transfix : vt, 꿰뚫다,(못박은 것처럼) 그 자리에서 꼼짝 못하게 하다
transfixion : n, 관통,꼼작 못하게 함,천관 절단
transform : vt, 변형시키다,바꾸다(into),변압하다
transformation : n, 변형,변모,변질
transformational grammar : x, 변형 문법
transformation scene : x, (막을 내리지 않는) 빨리 변하는 장면
transformation theory : x, 변형설
transformative : a, 변화시키는 힘(경향)이 있는
transformer : n, 변화시키는 것(사람),변압기,트랜스
transfuse : vt, 옮겨 붓다,갈아 넣다,스며들게 하다(into),고취하다(instill),수혈하다
transgress : vt, ...의 한계를 넘다,(법을) 범하다
transgress : vi, 법률을 범하다,죄를 범하다
transgressive : a, 위반하기 쉬운,범하기 쉬운
tranship : v, =TRANSSHIP
transhistorical : a, 초역사적인,역사의 테두리를 넘어선,역사는 연대(학)의 제약을 받지않는
transhumance : n, (철 따라 하는)가축이동
transient : a,n, 일시적인,덧없는,단기 체류의(손님)
transiently : ad, 덧없이,일시적으로
transilient : a, (한 점에서 다른 점으로)뛰어 옮는,뛰어 넘는
transillumination : n, 투조(진단하기 위하여 기관에 강한 광선을 투과시킴)
transire : n, (세관 발행의)연안 운송 면장
transistor : n, 트랜지스터(게르마늄 따위의 반도체를 이용한 증폭장치)
transit : n, 통과,통행,운송,통로,자오선 통과,경과,변천
transit : vt, 횡단하다,...을 통과하다
transit circle : x, =TRANSIT IN STRUMENT
transit duty : x, 통행세
transit instrument : x, 자오의,전경의,트랜싯
transition : n, 변천,변이,과도기,(일시적) 전조
transitional : a, 변천하는,과도적인,과도기의
transitive : a,n, 타동의,타동사
transitive verb : x, 타동사
transitivity : n, 타동성,이행성
transitorily : ad, 
transitory : a, 일시의,일시적인,오래가지 않는,덧없는,무상한
transit visa : x, 통과 사증
Transjordan : n, Jordan 왕국의 옛 이름
Transkei : n, 트란스카이(남아공화국 남동부의 Xhosa족의 자치구,1976년 독립 을 선언하였으나 남아 공화국만 승인)
translate : vt, 번역하다,해석하다,(구두 따위를)고쳐 만들다,이동시키다,(행동으로)옮기다
translation : n, 번역,번역물(서),해석,바꾸어 말함,바꾸어 놓음,옮김,물체의 이행
translational : a, 번역(상)의,병진 운동의
translative : a, 재산 양도의,이행(이동 전이,전임)의,번역의,번역에 도움이 되는
translator : n, 역자,번역자,통역,수리인,자동 중계기,번역 루틴
transliterate : vt, 자역하다,음역하다
transliteration : n, 이동,전위,전좌
translucent : a, 반투명의
translucid : a, 반투명의
transmarine : a, 해외의(로부터의),바다를 횡단하는
transmigrant : a,n, 이주하는,윤회하는,이주민
transmigrate : vi, 이주하다,다시 태어나다
transmigration : n, 이주,전생,윤회
transmigrator : n, 이민,윤회한 사람
transmigratory : a, 이주(이전)하는,윤회하는,다시태어나는
transmissible : a, 전할(옮길) 수 있는,전달되는,보내지는
transmission : n, 전달,전송,전염,전도,(전차등의)송파,송신,발신,전동 장치(자동차의)변속
transmissive : a, 보내는,전하는,보낼수 있는,전달(전도)되는
transmissivity : n, 투과율
transmit : vt, 보내다,회송하다,전달(매개)하다,(빛,열을) 전도하다,송신하다,방송하다,(재산을)전해 물리다,(못된 병을)유전하다
transmitter : n, 송달자,전달자,양도자,유전자,전승자,송신기,송화기,발신기
transmogrify : vt, 모습을 병하게 하다,변형시키다
transmutable : a, 변화(변질,변형)시킬 수 있는
transmutation : n, 변화,변형,변질,변성,변성,변이,변종,소유권의 양도(이전)
transmute : vt, 변화(변질) 시키다
transnational : n, 초국저거의,다국적 기업
transnatural : a, 초 자연적인
transoceanic : a, 해외의,대양 횡단의
transom : n, 상인방,가로대
transonic : a, 음속에 가까운
transpacific : a, 태평양 횡단의,태평양 건너편의
transpadane : a, Po강 저편(북쪽)의(로마에서 보아)
transparence : n, 투명,투명성(도),명백,명료,(종이 속에 비치는)투명 도안,(자기의)투명 무늬,투명도,투명화,슬라이드
transparent : a, 투명한,(문체등이) 명료한,솔직한,(변명이) 빤히 들여다뵈는
transparentize : vt, 투명하게 하다
transpersonal : a, 개인의 한계(이해)를 초월한
transpicuous : a, 투명한,명백한
transpierce : vt, 꿰뚫다,관통하다
transpiration : n, 증발(물),발산,땀,누설
transpire : vi,vt, 증발(발산)하다(시키다),배출하다,(비밀이)새다,(일이)일어나다
transplant : vt, (식물,피부등을)이식하다,이주시키다
transplantability : n, (조직의)이식 가능성
transplantate : n, 이식 기관(조직),(특히 사람에게서 사람으로)이식된 기관(조직)
transplantation : n, 이식(한 것),이식법,이주,이민
transpolar : a, 남극(북극)을 넘어가는,극지 횡단의
transponder : n, 트랜스폰더,자동 무선(레이더)
transpontine : n, (London에서)Thames강 남쪽의,저속한(연극)(이전에 이 구역에서 유행)
transport : vt, 수송하다,도취(열중)케 하다,유형에 처하다,죽이다
transport : n, 수송(기,선,기관),황홀,도취,열중,유형수
transportation : n, 수송,수송료,수송 기관,유형
transport House : x, 노동당 본부
transport ship : x, 운송선
transportship : n, 수송선
transpose : vt, 바꾸어놓다,전치하다,이항하다,이조하다
transposition : n, 바꾸어 놓음,전위,이항,이조,전위,전환법,전치법,전환법
transposon : n, 트랜스포슨(하나의 replicon에서 다른 replicon으로 전이될 수 있는 유전자군)
transracial : a, 인종을 초월한,이 인종간의
transrection : n, 트랜스펙션(분리된 핵산의 세포에의 감염,완전한 바이러스가 복제됨)
transsexual : a,n, 성전환의,성전환자,성불명자
transship : vt, 다른 배(차)로 옮기다
transSiberian : a, 시베리아 횡단의
transsonic : a, 음속에 가까운(시속 700-780마일)
transtage : n, 고켓의 제 3단(최종단)
transubstantiate : vt, 변질 시키다,화체(성체화)하다(성찬의 빵과 포도주를 그리스도의 살과 피로 변화시키다)
transubstantiation : n, 변질,화체
transubstantiation : n, 변질,화체설
transudation : n, 배어(스며)나옴(나오는 것)
transudatory : a, 배어나오는,스며나오는,침투하는
transude : vi, 스며나오다(막 따위를 통하여)
transuranic : a, 초우란의,the ~ elements 초우란 원소
Transvaal : n, 트란스발 남아프리카 공화국 북동부의 주,세계 제1의 금산지
transvalue : vt, 다른 가치 기준으로 평가하다,재평가하다
transversal : a,n, 횡단하는,절단선(의)
transverse : a,n, 가로의,횡단하는,교차하는,횡근,가로축
transves(ti)tism : n, 복장 도착(이성의 복장을 하는 성도착)
transvestism : n, 복장 도착(이성의 옷을 입기 좋아하는 변태적 경향)
transvestite : n, 복장 도착자,이성의 복장을 하는 사람
transvestitism : n, =TRANSESTISM
trap : n, 덫(에 걸리게 하다),계략(에 빠뜨리다),(사격 연습용)표적 날리는 장치,방취 U자관,뚜껑문(을 달다),2륜 마차,타악기류,(옷(감)따위가)못에 걸려 찢긴 곳,순경,입
trap : vi, 덫을 놓다,덫 사냥을 직업으로 하다
trap : n, 휴대품,수하물
trapball : n, 공놀이의 일종
trapcellar : n, 무대 마루 밑 지하실
trap door : x, (지붕, 마루의)뚜껑문
trapdoor : n, (마루,지붕,천장,무대의)뚜껑문,함정문,통풍구
trapeze : n, (체조,곡예용) 대형그네
trapezial : a, 승모근의
trapeziform : a, 부등변 4각형의,사다리꼴의
trapezist : n, (서커스의) 그네 곡예사
trapezium : n, 사다리꼴,부등변 사각형
trapezoid : n,a, 부등변 사각형(의),사다리꼴(의)
trapnest : n,vt, 트랩네스트(입구에 경첩이 있어 산란수를 측정할 수 있게 만든 닭장),(개개 닭의)산란수를 트랩네스트로 측정하다
trapper : n, 덫을 놓는 사람,(모피를 얻기 위해) 덫으로 새,짐승을 잡는 사냥꾼
trappings : n, 장식,장신구,말 장식
trappist : n, 트래피스트회의 수사
trappy : a, 함정이 있는,방심할 수 없는(tricky)
trapshooter : n, 트랩 사격자
trapshooting : n, =TRAP
trash : n, 쓰레기,잡동사니,객담
trash can : x, 쓰레기통
trasher : n, (반항의 표시로서)닥치는 대로 파괴 행위를 하는 사람,길에 버려진 가구를 주워오는 사람
trashformation : n, 버려진 쓸모없는 잡동사니로 유용한 예술적 작품을 만들어 내기
trashman : n, 넝마주이
trashy : a, 쓰레기의,시시한
trass : n, 트래스(화산암의 부스러기,수경의 시멘트의 재료)
trauma : n, 외상(성 증상)
traumatic : a,n, 외상성의,외상치료의,외상약
traumatize : vt, ...에 상처를 입히다,외상을 입히다,...에(영속적인 영향을 남길)충격을 주다
traumaturge : n, 마술(마법)사(magician)
travail : n, 산고,진통,고생,노고
travail : vi, 고생하다,진통으로 괴로와하다
travel : vi, 여행하다,이동하다,팔고다니다,(피스톤이) 움직이다,(생각이)미치다
travel : vt, ...을 걷다,지나가다,...을 여행하다
travel agency : x, 여행사,여행안내소
travelator : n, 움직이는 보도(평면적으로 움직이는 에스컬레이터)
traveler : n, 여행자,나그네,여행가,순회 판매인,외판원,이동 기중기,...하게 진행하는 것(말,차 등)
traveler's check : x, 여행자용 수표
traveler's tale : x, 허풍
traveling : n, 여행(의),이동(하는)
traveling : a,n, 여행용의,여행의,여행하는,순회하는,움직이는,움직일 수 있는,활주하는,여행,순력,순회 흥행,이동
traveling library : x, 순회 도서관,이동 도서관
traveling post office : x, 이동 우체국
traveling salesman : x, 순회 판매원,주문 받는 사람
travelog(ue) : n, (환등,영화 등을 이용하는)여행담,관광 영화
travelogue : n, (슬라이드,영화를 사용하여 하는)여행담,기행 영화
travelsick : a, 멀미한,멀미의
travel sickness : x, 멀미
travel trailer : x, 여행용 이동 주택
travelworn : a, 여행으로 여윈(지친)
traversable : a, 횡단 할 (넘을)수 있는,통과할 수 있는
traverse : vt, 가로지르다,횡단하다,방해하다
traverse : vi, 가로지르다,(산에)지그재그 모양으로 오르다
traverse : n, 횡단(거리),가로장,방해(물),(돛배의) 지그재그 항로,지그재그 등산(길)
traverse : a,ad, 횡단의,횡단해서
traverser : n, 횡단자,부인자,천차대
traverse rod : x, (활차 달린) 커튼 레일
traverse table : x, 천차대(차를 다른 선로로 옮기는 데 쓰임)
traversoiled : a, 여행으로 꾀죄죄한(travel stained)
travertine : n, 석회화
travesty : n,vt, 익살화(하다,한 작품)
travois : n, (북미 평원 지방 인디언의)두 개의 장대를 틀에 붙들어 매어 개,말이 끌게 하는 운반 용구
Travolator : n, 트레벌레이터 음직이는 보도(상표명)
trawl : n,vi,vt, 트롤망(으로 잡다),트롤어업을 하다
trawlboat : n, 트롤선
trawler : n, 트롤 어부(어선)
trawlerman : n, 트롤 어업을 하는 사람
trawl line : x, 주낙
trawlnet : n, 트로망,저인망
tray : n, 쟁반,얕은 접시(상자)
tray agriculture : x, 수경법
trayful : n, 한 쟁반(가득)
traymobile : n, =TROLLEY
trberculize : vt, ...에게 투베르쿨린 접종을 하다,결핵(성)으로 하다
trberosity : n, 결절(형성)성,결절(모양),괴경 상태,(뼈의)융기,조면
treacherous : a, 배반하는,반역하는,기대에 어긋나는,믿을 수 없는,의지가 안되는
treachery : n, 배신,배반,반역
treacle : n, 당밀
treacly : a, 당밀같은,(말 따위가)달콤한,찐득거리는
tread : vi,vt, 밟다,걷다,짓밟다,밟아 뭉개다,(수새가)교미하다,~ down 밟아 다지다,짓밟다,(감정,상대를)억누르다,~ in a person's steps 아무의 본을 받다,아무의 전철을 밟다,~ lightly (미묘한 문제 따위를)교묘하게 다르다
tread : n, 밟기,밟는 소리,발걸음,걸음걸이,(계단의)디딤판,(사닥다리의) 가로장,(바퀴,타이어의)레일(지면)접촉부,(자동차의)(좌우)바퀴거리
treadboard : n, 디딤판(계단 등의)
treadle : n,vi,vt, 발판(페달)(을 밟다),발판을 밟아 움직이다(재봉틀 따위를)
treadmill : n, (옛날,죄수에게 밟게 한) 답차,단조로운일(생활)
treadwheel : a, 밟아 돌리는 바퀴,쳇바퀴(다람쥐가 돌리는 것 같은)
treason : n, 반역(죄),배신,high ~ 반역죄
treasonable : a, 반역의,대역의,국사범의,배신의(traitorous)
treasure : n, 보배,보물,재보,spend blood and ~ 생명,재산을 던지다
treasure : vt, 비장하다,진중히 여기다,명기하다(up)
treasure house : x, 보고
treasure hunt : x, 보물찾기(놀이)
treasurer : n, 회계원,출납관(원)
treasuretrove : n, (소유자 불명의) 발굴재
treasury : n, 보고,보물,국고,기금,자금
treasury : n, 보고,보물광,국고(공공 단체의)금고,자금,기금,재무성,(지식의)보전,사화집,산 사전(사람)
treasury bill : x, 재무성 증권
Treasury Board : x, 국가 재정 위원회
Treasury Department : x, 재무성
treasury note : x, 1파운드 지폐,10 실링 지폐,재무성 증권
treat : vt,vi, 취급하다,다루다,대우하다,대접하다,한턱내다,(매수의 목적으로)향응하다,논하다(of,upon),...라고 생각하다,간주하다,(약품 따위로)처리하다,상담(교섭)하다
treat : n, 향음,한턱(낼 차례),즐거운 일 (소풍 따위)
treatability : n, (사건 등의)처리(방법)
treatable : a, 처리할 수 있는,치료할 수 있는,다루기 쉬운,온순한
treatise : x, 논설,(학설)논문
treatment : n, 처리,가공,대우,대접,(의사의)치료(법),치료제
treaty : n, 조약,맹약,계약,교섭
treaty port : x, 조약항,개항장
treble : n,a, 3배(의),세 겹(의),최고음부(의),소프라노(의),새된 (목소리,음)
treble : vt,vi, 3배로 하다,3배가 되다
treble clef : x, 음자리표
trebly : ad, 3배로,세 겹으로,세 가지 모양으로,고음으로
trebuchet : n, 중세기의 투석기,소형 저울,작은 천칭(화확 실험용)
trebucket : n, =TREBUCHET 1
trecentist : n, 14세기의 이탈리아 문학가(미술가)
tree : n, 나무,수목,목제품,계통수,가꼐도,~ of heaven 가죽나무,~ of knowledge (of good and evil) 비혜의 나무,~ of lige 생명의 나무,up a ~ 진퇴 양난에 빠져
tree : vt, (짐승을)나무 위로 쫓다,궁지에 몰아 넣다,(구두에) 골을 끼다,나무(가로대,자루)를 달다
treed : n, 나무가 심어져(나)있는,나무 가죽
treedozer : n, 벌채용 불도저
tree fern : x, 목생 양치류
tree frog (toad) : x, 청개구리
treelane : a, (도로가)3차선의
treeless : a 수목이 없는
treelined : a, 나무가 늘어진
treen : n, 목제 가정용품(도구)(접시,대접 등)
tree nail : n, 나무못
treenail : n, 나무못(조선용)
treenware : n, =TREE
tree peony : x, 모란(꽃)
tree ring : x, 나이테
treeseater : n, 3인승자동차(비행기(등))
tree surgery : x, 수목 관리
treetop : n, 우듬지
trefoil : n, 클로버,토끼풀속의 풀,세 잎 장식
trefoiled : a, 삼엽(삼판)형의,세 잎이 있는
trek : n,vi,vt, 여행(을 하다),(달구지 여행의) 한 구간
trellis : n,vt, 격자(로 만들다),격자 시렁(으로 버티다)
trellis work : n, 격자 세공
trematode : n, 흡충류(간디스토마 따위)
tremblant : a, 용수철 장치로 진동하는
tremble : vi,vt,n, 떨(게)하다,진동(하다,시키다),흔들리다,전율하다,조바심하다
trembling : n,a, 떨림,전율,떨리는,전율하는
trembly : a, 덜덜 떠는
tremendous : a, 무서운,무시무시한,대단한,굉장한,멋진,have a ~ time아주 멋지게 지내다
tremendously : n, 무시무시하게,굉장히,아주
tremolo : n, 전음,트레몰로
tremor : n, 떨림,전율,떨리는 목소리(음),오싹오싹하는 흥분(thrill)
tremulant : a, =TREMULOUS
tremulous : a, 떨리는,전율하는,겁많은
trenail : n, =TREENAIL
trench : n, 도랑,참호
trench : vt, (홈을)새기다,(논밭을)파헤치다,...에 도랑을(참호를) 파다
trench : vi, 참호를 만들다,잠식(접근)하다
trenchancy : n, 예리,통렬
trenchant : a, 찌르는 듯한,통렬한,효과적인,강력한,가차없는,뚜렷한
trench coat : x, 참호용 방수 외투,그 모양의 비옷
trenched : a, 참호가 있는,배수구가 있는,참호로 방비된
trencher : n, 도랑을 파는 사람,참호병
trencher : n, 나무접시,(빵,고기를)써는 데 쓰는 목판
trencherfed : n, 사냥꾼이 손수 기른(사냥개)
trencherman : n, 대식가,식객
trench gun : x, 박격포
trench mouth : x, (참호성)구강염
trend : n,vi, 향,경향(이 있다),향하다
trendsetter : n, 유행을 만드는 사람
trendsetting : n, 새 유행을 정착시키는(만드는)사람
trendy : a,n, 최신유행(의),유행의 첨단을 가는 (사람)
trental : n, (죽은 자에 대한)30일 간의 미사
treorizer : n, 이론가
trepan : n,vt, 둥근 톱(으로 수술하다(두개골을)),둥글게 도려 내다
trepan : vt, 함정에 빠뜨리다,꾀다,유인하다
trepang : n, 해삼,광삼,갈미(식용)
trephination : n, 천공(술),두개개구(술)
trephine : n,vt, 자루 달린 둥근 톱(으로 수술하다)
trephocyte : a, 주뼛주뼛하는,벌벌떠는
trepid : a, 소심한,떨고 있는,벌벌떠는
trepidant : a, 주뼛주뼛 하는,벌벌 떠는
trepidation : n, 공포,전율
treponema : n, 트레포네마균(회귀열,매독 등의 병원체를 포함하는 미생물)
trespass : n,vi, 침입(하다),침해(하다),방해(하다)(남의 시간 따위를),(호의에)편승하다(기화삼다),~ on a person's preserves 아무의 영역을 침범하다,주제넘게 굴다
trespasser : n, 불법 침입자,위법(위반)자
tress : n, (머리털의) 한 다발,곱슬털,땋은 머리,삼단 같은 머리
tressed : a, 머리를 땋은,...머리의
trestle : n, 가대,버팀다리,구각
trestle bridge : x, 구각교
trestletree : n, 장두 종재,시렁 가래
trestlework : n, 트레슬,구각의 뼈대(구조)
tret : n, 예전에 운송중의 감손을 고려한 초과 적재량
trews : n,pl, 꼭 끼는 창살 무늬의 나사제 바지
trey : n, (주사위,카드 등의) 3
trfainer : n, 훈련자,길들이는 사람,조련사,조마사,트레이너,연습용 기구(장치),(비행사)연습기,조준수,민병대원
triable : a, 시험 할 수 있는,공판에 회부할 수 있는
triac : n, 트라이액(3극관 교류 스위치)
triacetate : n, 트리아세테이트,삼초산 섬유소 섬유
triad : x, 3개 한벌,세폭짜리,3부작
triage : n, 품질이 최하인 커피 원두,종류(품질)별 분류,(전상자 치료 우선 순위 등의)선별,선택,구분
triagulate : vt, 삼각형으로 하다(가르다),삼각 측량을 하다
triagulate : a, 삼각의(무늬있는),삼각형으로 된
trial : n, 시도,시험,시련,곤란,재난,귀찮은 사람(것),재판,심리,bring to (put on) ~ 공판에 부치다,make ~ of ...을 시험해 보다,on ~ 시험적으로,시험의 결과(로),취조를 받고,~ and error 시행 착오
trial balance : x, 시산표
trial balloon : x, 기류 탐측기구,(여론을 알기위한)시안,조금씩내는 발표(따위)
trial horse : x, 연습상대(주로 연습 시합이나 시범 시합에서 상대역을 맡은 선수)
trial jury : x, 소배심
trial marriage : x, 시험 결혼(남녀가 합의하에 일정기간 동서하는 관계)
trialogue : n, 3자 회담
trial run : x, 시운전,시승
triangle : n, 삼각(형),3개 한벌,3인조,삼각자,트라이앵글,삼각자리,eternal ~ 삼각 관계
triangular : a, 삼각(형)의
triangularity : n, 삼각형(을 이룸)
triangulate : a, 3각으로	만들다,삼각형으로 나누다,3각 측량을 하다,삼각(형)의,3각 무늬가 있는,삼각형으로 이루어진
triangulation : n, 삼각형으로 분할하기,3각 측량
triarchy : n, 삼두 정치(국)
Trias : n, 삼첩기(층)
Triassic : a, 삼첩기의
triathlete : n, 트라이애슬리트(트라이애슬론(triathlon)의선수
tribade : n, 여성 동성애자(특히)남자역
tribadism : n, 여성간의 동성애(lesbianism)
tribal : a, 부족의,종족의
tribasic : a, 삼염기의
tribe : n, 부족,종족,패거리,3부족의 하나,이스라엘 12지파의 하나,족,the scribbling ~ 문인들
triboelectric : a, 마찰 전기의
triboelectricity : n, 마찰전기
tribology : n, 마찰공학
triboluminescence : n, 마찰 발광
tribometer : n, 마찰계
tribrach : n, 3단절음보,단단단격
tribulate : vt, 억압(박해)하다,괴롭히다
tribulation : n, 고난,시련
tribunal : n, 법관석,법정
tribunate : n, 호민관(trivune)의 직(임기),호민관
tribune : n, 단,연단,설교단
tribune : n, (평민에서 선출된)호민관,국민의 옹호자
tributary : a, 공물을 바치는,종속하는,보조의,지류의
tribute : n, 공물(을 바칠 의무),선물,감사의 말(표시),찬사
tricar : n, 오토 삼륜차
trice : vt, 끌어올리다,끌어 올려서 묶다
trice : n, 순간 (in a ~ 순식간에)
tricentenary : n, =TERCENTENARY
tricentennial : a,n, =TERCENTENARY
triceps : n, 삼두근
triceratops : n, 트리케라톱스(3각의 뿔을 가진 초식성 4각 보행의 공룡,백악기의 북미산)
trichiasis : n, 첩모 난생(중) (속눈썹이 안구쪽을 향함)
trichina : n, 선모충(장,근육에 기생)
trichina : n, 선모충(돼지,인체,쥐 등에 기생)
trichinize : vt, ...에 선모충을 기생시키다
trichinopoly : n, (인도산)엽궐련의 일종
trichinosis : n, 선모충병
trichinous : a, 선모충병의,선모충병에 걸린
trichogenous : a, 발모의,털이 나는
trichoid : a, 털(모발)모양의
trichologist : n, 양모학자,미용(이발)의 전문가
trichomonad : n, 트리코모나스(편모충류 트리코모나스속의 원충)
trichomoniasis : n, 트리코모나스증
trichord : n,a, 3현악기,3현의
trichosis : n, 이소 발모(증),다모 증
trichothecenr : n, 트리코테센(진균류에 의해 만들어지는 독소)
trichotomize : a, 셋으로 나누는,셋으로 갈라진,삼차의
trichotomy : n, 3분(법),인성 3분법(육체,정신,영혼의 3성)
trichroic : a, 3색성의
trichroism : n, 3색성(다른 세 방향에서 보면 세가지 다른 색을 나타내는 성질)
trick : n, 계략,계교,속임수,요술,요령,비결,(나쁜)장난,(독특한)버릇,장난감,1교대 근무 시간,소녀,do (turn) the ~ 목적을 달성하다,know a ~ worth two of that 그것보다 훨씬 좋은 방법을 알고 있다
trick : vt, 속이다,...의 기대를 저버리다,모양내다
trick : vi, 요술부리다,장난하다,~ a person into (out of) 속여서 ...시키다(...을 빼앗다)
trickle : vi,vt, 똑똑 떨어지다(떨어뜨리다),(비밀 따위)조금씩 누설되다(하다)
trickle : n, 뚝뚝 떨어짐,실개천,소량
trickledown theory : x, 트리클다운 이론(대기업에의 재정적 우대는 중소기업이나 소비자에게 파급효과를 준다는 설
trickster : n, 사기꾼
tricksy : a, 장난치는,다루기 어려운,교활한
tricky : a, 교활한,속이는,복잡한,까다로운,다루기 어려운
tricolor : a, 삼색의,삼색기
tricot : n, 손으로 짠 털실 편물,그 모조품,트리코(골이 진 직물의 일종)
tricotine : n, (능직)모직물의 일종
tricuspid : a,n, 세개의 뽀족한 끝이 있는 (이)
tricycle : n, 세발자전거,삼륜오토바이
trident : a,n, 삼지창,세 갈래진
tridentate : a, 이가 셋 있는,세 갈래진
tried : v, try의 과거(분사)
tried : a, 시험이 끝난,확실한
triennial : a,n, 3년 계속되는,3년마다의(축제),3년생의(식물)
trier : n, 실험자,시험관(물),심문자,판사
Trieste : n, 트리에스테(아드리아해 북쪽 끝,트리에스 테만에 임한 항구,이탈리아와 유고 슬라비아가 양분 영유)
trifle : n, 하찮은(시시한)일(물건),사소한일,소량,트라이플,a ~ 좀,약간
trifle : vi, 실떡거리다,실없는 짓(말)을 하다,소홀히 하다,가지고 장난하다,만지작 거리다
trifle : vt, (돈이나 시간을) 낭비하다
trifler : n, 농담(장난)하는 사람
trifling : a, 사소한,하찮은,시시한,경박한
trifoliate : a, 세 잎의,잎이 세 갈래로 갈라진,삼엽 쇠시리의
triforium : n, 교회의 회중석 및 성가대석 측벽의 아치와 clerestory와의 사이의 부분
trig : a, 말쑥한,스마트한,건강한
trig : vt, 꾸미다,모양내다
trig : n, =TRUGONOMETRY
trig : x, trigonometric(al),trigonometry
trigamous : a, 세 사람의 처(남편)가 있는,3중혼의,(수꽃,암꽃,암수 양꽃)세 꽃이 있는
trigamy : n, 1부 3처,1처 3부,3중혼
trigeminal : n,a, 삼차 신경(의),3중의
trigger : n, 방아쇠,quick on the ~ 사격이 빠른,재빠른,빈틈없는
trigger finger : x, 오른손의 집게 손가락
triggerfish : n, 쥐치무리(열대어)
trigger happy : a, 권총쏘기 좋아하는,호전(공격)적인
triggerhappy : a, (마구)권총을 쏘고 싶어하는,대단히 호전적(공격적)인,남의 약점 들추기를 좋아하는
triggerman : n, (범죄단 소속의)암살자
triglot : a, 3개국 말로 쓴(을 하는)
triglyph : n, 트리글리프(세로 세줄기 홈이 진 무늬)
trigon : n, 삼각형,(옛그리스의)삼각금
trigoneutic : a, 3세대 성의(1년에 3세대가 생기는)
trigonometer : n, 직각 삼각계
trigonometric : n,a, 삼각법(에 의한)
trigonometry : n, 삼각법
trigonous : a, 3개의 각이 있는,(단면이)삼각형인
trigram : n, 삼자명,3선형,괘
trigraph : n, 세 글자 한소리,3중음자
trihedron : n, 삼면각
trihybrid : n, 3유전자 잡종
triiodothyronine : n, 트리요도사이로닌(티로닌)(갑상선 호르몬의 일종)
trijet : n, 3발 제트기
trike : n,vi, 세발 자전거(를 타다)
trilabiate : a, 3개의 순판을 가진
trilaminar : a, 3층의
trilateral : a,n, 세 변이 있는,삼각형
trilateralism : n, 삼변 측량(술)
trilby : n, 펠트 모자의 일종
trilemma : n, 삼도 논법,3자 택일해야 하는 궁지
trilingual : a, 3개국어의)를 말하는
trill : n,vt,vi, 떨리는 목소리(로 말하다,노래하다),지저귐,지저귀다,전음(으로 발음하다)
trillion : n,a, 백만의 3제곱(의),백만의 제곱(의),1조의
trillium : n, 연령초(의 무리)
trilobate : n, 삼엽충(화석으로 남은 고생대의 동물)
trilobed : a, (잎이)세 갈래로 찢어진
trilobite : n, (고생대의)삼엽충(최고의 화석 동물)
trilogy : n, 3부작,3부곡
trim : a, 말쑥한,정연한,정돈된
trim : n, 정된(된 상태),정비,준비,복장,장식,(배의)장비,(배,항공기의)균형,건강상태,기분,손질,깎아 다듬기,(건물 내부의)목조부,in (good) ~ 상태가 좋아,균형이 잘 잡히어,into ~ 적당한 상태로,in traveling ~ 여장하여
trim : vt, 말쑥하게 하다,정돈하다,장식하다,깎아 다듬다,깎아 버리다,(화물,승객의 위치를 정리하여)균형을 잡다,(돛을) 조절하다,지우다,야단치다
trim : vi, (두 세력의)균형을 잡다,기회주의적 입장을 취하다,균형이 잡히다,돛을 조절하다,~ a person's jacket 때리다,~ in (목재를) 잘라 맞추다,~ one's course 돛을 조절하며 나아가다
trimaran : b, 3동선
trimer : n, 삼량체
trimester : n, 3개월간,(3학기 제의)1학기
trimeter : a,n, 삼보격의(시구)
trimetrogon : n, 3각점 부감 촬영법(다른 각도에서 3대의 카메라로 동시 활영하는 항공 사진 방식
trimmer : n, 정돈(손질,장식)하는 사람,낫,자귀,가위,식칼,주머니 칼,종이 자르는 칼,심지 자르는 기구,기회주의자,꾸지람 하는 사람,만만치 않은 사람,장선받이,틀장선,화물창 안의 짐을 알맞게 되싣거나 쌓는 기구(사람),낚시찌(pike를 낚는)
trimming : n, 정돈,손질,깎아 다듬기,장식,꾸지람,매질,패배,(배의)균형 잡기
trimonthly : a, 3개월 마다의
trimotor : n, 3발기
trimthoprim : n, 트리메소프림(살균제,항말라리아제)
trinal : a, 셋으로(3부로),3중(배)의
trine : a, 3배(중)의,3층의
Trinidad and Tobago : x, 서인도 제도에 있는 영연방내의 독립국
Trinitarian : a,n, 삼위 일체(설)의,그 신봉자
trinitrobenzene : n, 트리니트로벤젠(폭약원료,생략 T.N.B)
trinitrotoluene : n, 트리니트로톨루엔(강력폭약,생략 T.N.T)
trinity : n, 삼위 일체(성부,성자,성신)
Trinity College : x, 케임브리지 대학 최대의 학료
Trinity House : x, (런던의) 도선사 조합
Trinity Sunday : x, 삼위 일체의 축일
trinket : n, 작은 장신구,방울,시시한 것
trinocular : a, 3안 현미경의
trinomial : n,a, 삼항식(의),삼명법(의)
trio : n, 3인조,3개 한 벌,세폭 한 짝,삼중주,삼중창,piano ~ 피아노 삼중주(피아노,바이올린,첼로)
triode : n,a, 3극 진공관(의)
triolet : n, 2운각 8행의 시,트리올렛
trior : n, 
trioxide : n, 삼산화물
trip : n, 여행,소풍,짧은 항해,경쾌한 발걸음,실족,과실,실언,딴죽걸기,벗기는 장치
trip : vi, 가볍게 걷다(춤추다),실족하다,걸려서 넘어지다,헛디디다,실수하다
tripack : n, 트라이팩(감색성의 다른 세가지 필름을 겹친 컬러 필름)
triparted : a, 세부분으로 나누어진
tripartite : a, 3부로 나누어진,3자간의,세 개 한벌의,세 폭짜리의
tripartition : a, 셋으로 나누어진,3부로 이루어지는,(잎이)세 갈래로 깊이 찢어진,3자간의,(문서 등이)3부로 작성된
tripe : n, (식용으로 하는)반추동물의 위벽,창자,하찮은 것,졸작
tripedal : a, 발이 셋 있는,3각의
tripersonality : n, (신의)3위격성
triphammer : n, (건축용 따위의) 스프링 해머,동력 장치에 의해 아래위로 움직이게 된 해머
triphasic : n, 트리페이식(경구 피임약의 일종)
triphenylmethane : n, 트리페닐메탄(물감 원료)
triphibian : a,n, 입체전에 능한(지휘관)
triphibious : a, 육.해.공군 공동 작전의,입체전의
triphosphate : n, 3인산염
triphthong : n, 삼중 모음(our의 발음 따위)
triplane : n, 삼엽 비행기
triple : a,n, 3배의 (수,양),세겹의,세 부분으로 된,3루타
triplecheck : vt, 3중으로 체크하다,세번 확인하다
tripledigit : a, 세 자리의
tripleexpansion : a,n, 3단 팽창식의(기관)
tripleheader : n, 트리플헤더(농구 따위의 동일 경기장에서의 1일3시합)
triple jump : x, 삼단 뛰기
triple measure : x, = triple time
triple play : x, 3병살
triplet : n, 3개 한벌,세 폭한짝,3연음표,세쌍동이 중의 하나
triple threat : x, 세 분야에 고루 능숙한 명선수,차기,패스,달리기에 고루 능숙한 명선수
triple time : x, 3박자
triplicate : a,n, 3배의,세겹의,3제곱의,3부로 된,3통의 (하나),3통
triplicate : vt, 3배로 하다,3중으로 하다,3통으로 작성하다
triplication : n, 3배,3중,3통 작성,3배한 것,3통 중의 하나
triplicity : n, 3배(중)성,3개 한벌
triploid : a, (염색체가) 3배수의
triploid : n, 3배체
triply : ad, 3배(겹)으로
tripod : n, 삼각,삼각 걸상
tripodal : a, 3각형의,3각의
tripodic : a, 3각의
tripody : n, 3보격의 시구
tripolar : a, 3극의
Tripoli : n, 트리폴리(리비아의 수도)
tripos : n, 우등 시험,우등 급제자 명부
tripper : n, trip하는 사람(것),(톱니바퀴의)시동기
trippery : a, (단기간의)여행자가 많이 찾아오는
tripping : a, 경쾌한
trippy : a, 몽롱한(마약 등으로),기분이 좋아진
triptane : n, 트립탄(무색,액상의 탄수화물)
triptych : n, (그림,조각 따위의)석 장 연속된 것,세 폭짜리
triptyque : n, (세관이 발행하는)자동차 입국 허가증
triquetrous : a, 3각(변)의,(줄기 등이)절단면이 3각형인
trireme : n, 3단,노의 군선
trisect : vt, 삼(등)분하다
trisection : n, 3(등)분
triservice : a, 육해공 3군의
triskelion : n, 삼각소용돌이 무늬,가랑이로 연결된 삼각도
trisoctahedron : n, 24면체
trisyllabic : a, 3음절의
trisyllable : n, 3음절어
tritagonist : n, 제 3배우(세번째로 중요한 배역을 맡은 배우)
trite : a, 진부한
tritheism : n, 삼신론,삼위 이체론
tritium : n, 트리튬,삼중수소
triton : n, 반인반어의 바다의 신
triturate : vt, 가루로 만들다,빻다
trituration : n, 분쇄,마쇄,씹음,저작,가루약
triturator : n, 찧는(빻는)사람,약연,분쇄기
triumph : vi, 승리를 자랑하다,이기다,성공하다(over),승리를(성공을) 기뻐하다
triumphal : a, 승리(개선)의
triumphal arch : x, 개선문
triumphalism : n, 승리주의(특정한 교의가 다른 그 어느 종교보다도 뛰어나다고 여기는)
triumphant : a, 승리를 거둔,의기양양한
triumphantly : ad, 기고 만장하여,의기 양양하여
triumvir : n, 3집정관의 한 사람
triumvirate : n, 삼두정치,3인 관리제,3인조
triune : a, 삼위 일체의
triunity : n, 3개조,3인조(triad),3중성
trivalence : n, 3가
trivalent : a, 3가의
trivalize : vt, 평범화하다
trivet : n, 삼발이,삼각대
trivia : n,pl, 하찮은 일(것)
trivial : a, 하찮은,보잘것 없는,보통의,평범한
trivialist : n, 잡학자
triviality : n, 하찮은(평범한) 일(말,것)
trivium : n, (중세 학교에 있어서 7개 교양과목 중 하위의)삼학문법,논리학,수사학
triweekly : ad,a,n, 3주마다,3주 1회(의),1주 3회(의),그 간행물
Trizone : n, (제2차 대전 후의) 서부 독일의 미국,영국,프랑스 3국의 점령 지구,3국지구
trngle : n, 모난 쇠시리
trochaic : n, 투관침
trochal : a, 윤상의,윤형의
trochanter : n, 전자(대퇴골 상부의 돌기),전절(다리의 제2관절)
troche : n, 정제
trochee : n, 강약격,장단격
trochlea : n, 활자,연골륜
trochlear : a, 활차의,활차 신경의,활차 모양의
trochoid : n, 트로코이드,여파선
trochometer : n, (자동차의)주행 거리계
trod : v, tread의 과거(분사)
trodden : v, tread의 과거분사
trode : v, tread의 과거
troglobite : n, 동굴성 동물(눈,몸의 색소를 잃고 감각기가 발달)
troglodyte : n, 혈거인,은자,유인원,굴뚝새
trogon : n, 트로곤(열대,아열대산의 깃털이 화려한 새)
troika : n, 3두 마차,으로 늘어선 세 마리의말,삼두제,(국제 정치의)트로이카 방식(공산권,서유럽.중립권의 3자 협조)
troilism : n, 세 사람이 하는 성행위
Trojan : a, Troy의 (사람),용사,정력가
Trojan horse : x, =WOODEN HORSE,선적 공작대,제 5열
Trojan War : x, ,the 트로이 전쟁 (그리스와 트로이의 전쟁)
troll : vt,vi, 윤창하다,(일하면서) 노래하다,견지질하다,굴리다,굴러다니다
troll : n, 윤창,견지,제물낚시
troll : n, 트롤도깨비(땅속굴에 사는 거인,난쟁이)
trolley : n, 손수레,광차,(시가 전차의 폴 끝의) 촉륜
trolley bus : x, 무궤도 전차
trolley car : x, (폴식) 시가 전차
trolley line : x, 전차 선로
trolleyman : n, (시내)전차 승무원
trollop : n, 윤락 여성,매춘부
trollybobs : n,pl, 바지
trombenik : n, 자만하는 사람,허풍떠는 사람,게으름 뱅이,쓸모 없는 사람
trombidiasis : n, 양충병
trombone : n, 트롬본(신축식 저음 나팔)
trombonist : n, 트롬본 취주자
trommel : n, (광석,석탄 등을 거르는)회전식 원통의 체
troop : n, 떼,일단 무리,군대
troop : vi, 모이다,몰리다,떼지어 나가다,사귀다
troop : vt, 편성하다,(대를)수송하다,~ing the colo(u)r(s) 군기 경례 분열식
troop carrier : x, 군대 수송기(차)
trooper : n, 기병(의 말),기마 순경,주 경찰관,낙하산병,군대 수송선
troophorse : n, 기병의 말,기마
troopie : n, (짐바브웨,남아프리카 공화국의)최하위 병사
troopship : n, (군대)수송선
tropacocaine : n, 트로코카인(국부 마취제,상표명)
tropaeolum : n, 금련화
trope : n, 비유(적 용법)
trophic : a, 영양(작용)에 관한
trophied : n, 전리품(기념품)으로 저장
tropholasm : n, (세포의) 영양 원형질
trophology : n, 영양학
trophy : n, 전리품,전승기념물(적의 군기,무기 따위),상품,상배
trophy : n, 전리품,전승(성공,사냥)기념물(적의 연대기,사자 가죽,사슴의뿔,짐승의 머리 등),트로피(기,컵,방패등),(경기의)우승 기념품,상품,(옛 그리스,로마)전승 기념비
tropic : n, 회귀선,열대(지방)(의),the ~ of Cancer 북희귀선
tropical : a, 열대의,열대적인,열대적인,일정적인,비유의,비유적인
tropical aquarium : x, 열대 수족관
tropical fish : x, 열대어
tropicalize : vt, 열대 (지방)에서 사용하기 알맞게 하다(방습,방열 처리 등을 하여)
tropical year : x, 회귀년,태양년
tropism : n, (자극에 대한)향성,굴곡 운동
tropologic : a, 비유적인
tropological : a, 비유적인,교훈적인
tropology : n, 비유의 사용,(성서의)비유적 해석
troponin : n, 트로포닌(근육을 조절하는 단백질)
tropopause : n, 권계면(성층권과 대류권의 경계면)
troposcatter : n, 
troposphere : n, 대류권(지구 표면의 대기층)
tropospheric : a, 대류권의,고층 기상의
troppo : ad, 너무,ma non ~ 그러나 너무 ...하지 않게
Trosky : n, 트로츠키(러시아의 혁명가,저술가)
trot : n, (말의)속보,(사람의)총총걸음,빠른운동,자습서,자습용 번역서,아장아장 걷는 어린애
trot : vi,vt, 속보로 달기(게 하)다,총총걸음으로 걷다,서두르며 가다,빠른 걸음으로 안내하다,자습서로 공부하다,~ about 분주히 뛰어다니다,~ out (말을)끌어내어 걸려 보이다,(물건을)꺼내어 자랑해 보이다
troth : n, 성실,충절,약속,약혼
troth : vt, 약속(약혼)하다
trotline : n, 주낙의 일종
Trotsky : n, 러시아의 혁명가,저술가
Trotskyite : a, 트로츠키 파의(사람)
trotter : n, 걸음이 빠른 사람(말),수레 경마용으로 훈련을 받은 말,이리저리 뛰어다니는 사람,활동가,(양,돼지 등의)족,(아들이나 젊은 여자의)발
troubadour : n, (11-13세기의 남프랑스,북이탈리아 등지의)서정 시인
trouble : n, 걱정(거리),고생,어려움,귀찮음,귀찮은 일(사람),분쟁,소동,고장,get into ~ 문제를 일으키다,벌을 받다,in ~ 곤란해서,욕을 먹어,벌을 받고,검거되어,It is too much ~ 달갑지 않은 친절이다,take ~ 수고하다
trouble : vi, 애먹다,애쓰다,걱정하다
troublefree : a, 고장이 없는
troublemaker : n, 말썽꾸러기
troubleproof : a, 고장이 없는
troubleshoot : v,vi,vt, 고장 수리원(조정자)의 역할을 하다,고장 수리원(조정자)으로서 처리(조사)하다
troubleshooter : n, (기계 따위를)수선하는 사람,분쟁 해결자
troubleshooting : n, 고장의 수리,분쟁 조정
troublesome : a, 귀찮은,골치 아픈,다루기 힘든
troublous : a, 소란한
troudeloup : n, 함정
trough : n, (단면이 V자형의 긴)구유,반죽 그릇,여물통,골,기압골
trounce : vt, 호되게 때리다,벌주다,(시합 등에서)압도적으로 이기다
troupe : n, (배우,곡예사 등의)그 일원
trouper : n, 노련한 배우
trouser : a, 바지(용)의,바지의 한쪽 가랑이,바지를 입은,남자의
trousering : n, 바지감
trousers : n, 바지,a pair of ~ 바지 한 벌
trouser stretcher : x, 바지 주름을 펴는 기구
trouserstretcher : n, 바지 주름 펴는 기구
trousseau : n, 혼수 옷가지,혼수감
trout : n,vi, 송어(를 잡다)
troutcolored : n, 흰바탕에 검정(적갈,황갈)색의 반점이 있는(말)
troutlet : n, 새끼 송어(1년 미만의)
troutperch : n, 연어,송어류의 담수어(미국 동,중부산)
trouty : a, 송어가 많은,송어 같은
trouvere : n, 트루베르
trow : vi,vt, 믿다,생각하다
trowel : n, 흙손,모종삽,lay it on with a ~ 흙손으로 바르다,극구 칭찬하다
trowel : vt, 흙손으로 바르다
Troy : n, 소아시아 북서부의 옛도시
troy : n, 트로이 형,금형 (보석,귀금속의 형량)
trs. transpose : x, 거꾸로(으로)된 자를 바로 세울것
truant : n,a, 농뗑이,무단 결석하는 (사람,학생),play ~ 무단 결석하다
truce : n, 휴전,중지
truck : vt,vi, 물물 교환하다(barter),거래하다
truck : n, 물물교환,현물 지급(제),거래,교제(with),시장에 낼 야채,하찮은 물건,잡동사니
truck : n, 손수레,광차,화물자동차,트럭,무개화차
truckage : n, 트럭 운반,트럭 운임(사용료)
truckdriver : n, 트럭 운전사
truck farm : x, (g'arden) 시판용 야채의 재배농원
truckie : n, 트럭 운전사
truckle : n,vi, 작은 바퀴(로 움직이다)
truckle : vi, 굴종하다,아첨하다(to)
truckle bed : x, 바퀴 달린 낮은 침대(안 쓸 때는 보통 침대 밑에 밀어넣음)
truckline : n, 트럭에 의한 화물 수송로
truckload : n, 트럭1대분의 화물
truckman : n, 트럭 운전사(운송업자)
truckoing : a, 알랑거리는,굽실거리는
truck system : x, (임금의) 현물 지급제
truculence : n, 흉포,야만,잔인
truculent : a, 야만스런,모질고 사나운,잔인한
trudge : vi, 무겁게 터벅터벅 걷다,~ it 터벅터벅 걷다
trudge : n, 무거운 걸음
trudgen : n, 팔은 크롤식 발은 횡영식의 헤엄
true : a, 참다운,틀림없는,성실(충실)한,정확한,바른,(기계가)정밀한,진짜의,순종의,합법의,(가능성 기대 따위를)믿을 수 있는,(방향.힘 등이)일정한,번치 않는,come ~ 정말이 되다,(희망이)실현되다,hold ~ 유효하다,들어맞다
true : ad, 진실로,정확히
true : n, (the ~) 진실,정확한 상태
true : vt, 바르게 맞추다
trueblue : n,a, (퇴색 않는)남빛(의),(주의에)충실한(사람)
trueborn : a, 적출의,순수한
truebred : a, 순종의,뱀뱀이가 좋은
truebreed : n, 순종,우량종
truefalse test : x, 정오 문제
truehearted : a, 성실한
truelife : a, 실생활의,현실의,실화의
truelove : n, 애인
trueness : n, 충실,성의,의리 있음,진실,순수,정확
truepenny : n, 정직한 사람,성실한 사람,진국
truetolife : a, 박진의,진짜에 가까운,진짜를 정확히 모방한
truffle : n, 송로 무리의 버섯
truffled : a, 송로가 든,송로로 맛들인
trug : n, (야채.과일 등을 담는) 직사각형의 운두 낮은 나무 그릇
truism : n, 자명한 이치,진부한(판에 박은) 문구
trull : n, 매춘부
truly : ad, 참으로,성실(충실)히,바르게,정확히
Truman : n, 트루먼(미국 제 33대 대통령)
trump : n, (트럼프의)으뜸패(의 한벌),비법,비방,믿음직한 사람,play a ~ 으뜸패를(비방을) 내놓다,turn up ~s 예상외로(순조롭게) 잘 되어가다
trump : vt,vi, 으뜸패를 내놓(고 따)다,비방을 쓰다,...보다 낫다,지우다,날조하다,조작하다(up)
trump : n, 나팔
trump card : x, 으뜸패,비법,비방
trumpedup : a, 날조한(사건.범죄 등)
trumpery : a,n, 겉만 번드르르한 (물건),굴퉁이,한찮은(물건),허튼소리,잠꼬대
trumpet : n, 트럼펫,나팔(소리),나팔 모양의 물건,나팔형 확성기,blow one's own ~ 제 자랑하다
trumpet : vi, 나팔 불다,(코끼리 따위가)나팔 같은 (목)소리를 내다
trumpet call : x, 소집나팔,긴급 명령
trumpeter : n, 트럼펫 부는 사람,나팔수,(이야기를 치켜세우는 사람,나팔새,트럼펫(울음소리를 목족으로 개량된 비둘기)
trumpetlike : a, (모양,소리가 트럼펫 비슷한
truncal : a, (나무)줄기의,몸통의
truncate : vt, (원뿔,나무 따위의) 머리를 (끝을) 자르다,(긴인용구 따위를) 잘라 줄이다
truncate : a, 끝을(두부를)자른,잘라 줄인,~ cone (pyramid) 원(각)뿔대
truncated : a, 잘라버린,끝을 자른,사절두의,(문장 등)몹시 생략된,불완전한
truncation : n, 끝을 잘라냄,절두,절단
truncheon : n, 경찰봉,권표,지휘봉
truncheon : vt, 곤봉으로 때리다
trundle : n, 작은 바퀴,각륜,바퀴 달린 침대(손수레)
trundle : vt,vi, 굴리다,구르다,밀고가다(along)
trundle bed : x, =TRUCKLE BED
trunk : n, 줄기,몸통,(대형)트렁크,본체,주요부,(전화의)중계선,(철도 따위의)간선,(코끼리의)코
trunk : a, 주요한
trunk call : x, 장거리 전화 호출
trunked : a, ...한 줄기(몸통)를 가진,(동물이)긴 코를 가진
trunkfish : n, 거북복(boxfish)
trunkful : n, 트렁크 하나 가득,다량,다수,풍부
trunk hose : x, (16-17세기의)반바지
trunk line : x, 간선
trunkroad : n, 간선 도로
trunnion : n, 포이(포신을 포가에 받쳐 놓는 원통형 동출부),통이
truss : n, 가(형)구,트러스,탈장대,다발,건초의 다발,보릿짚 단,하활대 중앙부를 돛대에 고정시키는 쇠붙이
truss : vt, 새의 날개를 몸통에 붙들어 매다,두 팔을 몸통에 동여 매다,(교량 따위를)형구로 버티다,다발짓다
trussing : n, 묶음,트러스재,트러스 부
trust : n, 신임,신뢰,신용(in),믿는사람(것),희망,확신,신용 대부,외상 판매,책임,보관,위탁,신탁,신탁물,기업 활동,in ~ 위탁하여,on ~ 외상으로,남의 말대로
trust : a, 신탁의
trust : vt, 신뢰(신용)하다,의지하다,맡기다,위탁하다,(비밀을) 털어놓다(with),희망(기대)하다,믿다
trustbuster : n, (독점금지법에 의해) 트러스트를 해산하는 사람(특히 연방정부의 관리)
trustbusting : n, 반트러스트의 공소(정치 운동)
trust company : x, 신탁 회사,신탁 은행
trust deed : x, 신탁 증서
trustee : n, 피신탁인,보관인,관재인
trusteeship : n, 신탁 통치,신탁 통치령(지역)
truster : n, 신뢰(신용)하는 사람,트러스트 창시자
trustful : a, (사람을)신용하는,믿음직하게 여기는
trustify : vt, 기업 합동으로 하다,트러스트하다
trustily : ad, 충실히,성실히
trusting : a, 믿(고 있)는,(신뢰하여)사람을 의심하지 않는
trustless : a, 신용이 없는,믿을 수 없는,남을 믿지 않는
trustmoney : n, 위탁금
trust territory : x, (국제 연합의) 신탁 통치 지역
trustworthiness : n, 신뢰(신용)할 수 있음,믿음직함,신용 상태
trustworthiness : n, 신뢰(신용)할 수 있음,믿음직함,신용 상태
trustworthy : a, 신뢰할 수 있는,확실한
trusty : a, 믿을 수 있는(충실한)(사람),모범수
truth : n, 진리,진실,사실,성실,정직,in ~ 실제,사실은,of a ~ 참으로,to tell the ~,or ~ to tell 실은,사실을 말하면
truthful : a, 정직한,성실한,진실의
truthfunction : n, 진리 함수
truthless : a, 허위의,정직하지 않은,믿을 수 없는
truth serum : x, 진심 토로약 (먹으면 진심을 털어놓는다는 약)
truthvalre : n, 진리치
try : vt, (시험삼아)해보다,노력하다,시험해보다,심리하다,괴롭히다,시련을 겪게 하다,정련(정제)하다
try : vi, 시도해보다,노력하다,~ on (옷을)입어보다,시험해 보다,~ one's hand at ...을 해보다,~ out ...을 철저히 해보다,엄밀히 시험하다,자기 적성을 시험해 보다(for)
try : n, 시도,시험,노력
trying : a, 견딜 수 없는,괴로운,쓰라린,지치는,화나는,약오르는(prowoking)
tryon : n, (속이려는)시도,(가봉된 옷을)입어보기,가봉
tryout : n, 적성 검사
trypanosome : n, 편모충의 일종(혈액내에 기생함)
trypsin : n, 트립신(췌액 중의 소화 효소)
tryptic : a, 트립신(작용)의,트립신에 의해 생긴
tryptophan : n, 트립토판(동물의 생육에 필요한 아미노산의 일종)
trysail : n, 작은 세로 돛
try square : x, 곱자,곡척
tryst : n,vt, 만날 약속(을 하다),(약속산) 회합(장소),회합(시간,장소를)정하다
trysting place : x, 데이트(회합)장소
tryworks : n,pl, 경유 정제소
tsar : x, czar,czarevitch
Tschaika : n, 차이카(소련제 요인용 리무진형 대형 승용차)
tsetse : n, (fly) 체체파리(남아프리카산,수면병의 매개체)
Tshiluba : n, 칠루바 말
Tsinghai : n, 칭하이성(중국 북부의 성),칭하이호(칭하이성 북동부에 있는 중국 최대의 담수호)
Tsingtao : n, 칭따오(중국 동부의 항구)
tsk : int,vt, 쯧(혀 차는 소리,불승인,비난을 나타냄),쯧쯧 혀를 차다,못마땅해하다
T square : x, T 자
tsuris : n, 괴로움,고민,곤란,불운(의 연속)
Ttatar : n,a, =TARTAR
tuan : n, 말레이 사람 경칭
tub : n, 통,동이,목욕통,목욕,뚱보,한통의 분량,느리고 모양 없는 매
tub : vt,vi, 통에 넣다,목욕시키다(하다)
tuba : n, 저음의 (큰)나팔통
tubal : a, 관(모양)의,난관의,나팔관의,기관지의
tubate : a, 관을 가진,관 모양의
tubber : n, 통 만드는 사람,통을써서 일하는 사람
tubbing : n, 목욕,보트 연습,통 만들기,통 만드는 재목
tubbish : a, 통 같은,뚱뚱한
tubby : a, 통 모양의,땅딸막한
tube : n, 관(pipe),통(cylinder),관(통) 모양의 물건(기관),(치약,그림물감 등이 든)튜브,(특히 런던의)지하철,진공관
tubebaby : n, 시험관 아기
tubectomy : n, 난관 절제(술)
tubed : a, (말이)(기관을 절개하여)금속제 호흡관을 댄
tubeless tire : x, 튜브 없는 타이어
tubelike : a, 관상의
tuber : n, 괴경,결절
tubercle : n, 작은 결절,혹 모양의 작은 돌기,결절,결핵(결절),작은 괴경,괴근
tubercle bacillus : x, 결핵균
tubercualr : a, 결절(모양)의,결절이 있는,결핵(성)의,결핵에 걸린
tuberculation : n, 결절(결핵)현상
tuberculin : n, 투베르쿨린 주사액
tuberculin test : x, 투베르쿨린 반응 검사
tuberculintested : a, 투베르쿨린 반응이 음성인 소에서 짠(우유)
tuberculoid : a, (결절이 있는 점에서)결핵과 유사한,유결핵의
tuberculosis : n, (폐)결핵
tuberculous : a, 결핵성의,(폐)결핵에 걸린
tuberose : a, =TUBEROUS
tuberose : n, 양수선
tuberous : n, 괴경(tuber)이 있는
tubful : a, 한 통(대야)가득의(양)
tubing : n, 배관,관재료,파이프(집합적으로도)
tubthumper : n, 탁자를 치며 열변을 토하는 사람,홍보관,대변인
tubthumping : a, 열변,대연설,거창한 선전,열변을 토하는
tubular : a, 관 모양의,파이프의
tubular furniture : x, 파이프식 가구
tubulate : a,vt, 관 모양의,관이 달린,관(모양)으로 하다,...에 관을 설치하다
tubulation : n, 관의 제작(설치,배역),관상부
tubule : n, 가느다란(작은)관,(동,식물의)세관
tubulous : a, 관모양의(tubular),관이 있는,관으로 된,관상화가 있는
tuck : vt, (옷단을) 징그다,(주름을 접어) 호다,(소매,옷자락을) 걷어 올리다,말다,싸다,포근하게 감싸다,(좁은 곳으로) 밀어넣다,틀어박다(in,into,away),잔뜩 멀다
tuck : vi, 징그다,주름을 잡다,(음식을) 긁어 넣듯이 처먹다(in),~ the sheets in 시트끝을 요 밑으로 접어 넣다
tuck : n, (큰 옷을 줄이어)징그기,(접어 넣은)단,기력,정력,먹을 것,과자
tuckahoe : n, 복령(Indian bread),터커호
tuckbox : n, (기숙학교의 국민학교생이 잘 가지고 다니는) 과자 상자
tucked : a, 걷어지른,걷어 올린,접어 넣은,호아 올린,가두어 넣은,비좁고 답답한
tucker : n, (옷단을) 징그는사람,(재봉틀의) 주름잡는 기계,(17-18세기의 여성용의) 깃에대는 천,=CHEMISETTE,음식물,one's best bid and ~ 나들이옷
tucker : vt, 피로케 하다(out)
tuckerbag : n, (오지 여행자가 휴대하는)식량 주머니
tuckin : n, 많은 음식,굉장한 진수 성찬
tuckshop : n, (교내의)과자점,매점
Tudor : a,n, (영국의) 튜더 왕가(왕조)의(사람),튜더양식(의)
Tuesday : n, 화요일
tufa : n, 석회화
tuff : n, 응회암
tuft : n, (머리털,실 따위의)술,타래,덤불,꽃(잎)의 송이(덩이)
tuft : vt,vi, 술을 달다,송이져 나다
tufted : a, 술을 단,술로 장식한,술을 이룬,군생하고 있는
tufthunter : n, 권문에 아첨하는 사람,알랑쇠
tufty : a, 술이 많은,술 모양의,술로 장식된,술을 이루는,군생하는
Tu Fu : n, (712-770)두보 (중국 당대의 시인)
tug : vt,n, (힘껏) 잡아 당기다(당기기),(배를) 끌다
tugboat : n, 예인선
tuifu : n, 어찌할 수 없는 얼간이
tuille : n, (갑옷의)넓적다리받이
tuition : n, 교수,수업료
tuitional : n, 교수 (지도)(용)의,수업료
tularemia : n, 야토병(때로는 사람에게도 감염함)
tulip : n, 튤립
tulip tree : x, (북미산) 튤립 나무
tulipwood : n, 튤립 나무의 재목
tulle : n, 툴(베인용의 얇은 비단 방사)
tulwar : n, (칼날이)휜 칼
tum : n, (밴조 따위의) 소리
tum : n, 배
tumble : vi, 구르다,넘어지다,전략하다,폭락하다,뒹굴다,좌우로 흔들리다,공중제비를 하다,구르다시피 달려오다(달려나오다),부닥치다,딱 마주치다
tumblebug : n, 뿔풍뎅이 류
tumbledown : a, (집이) 찌부러질 듯한,황페한
tumbledry : vt,vi, 회전식 건조기로 말리다(마르다)
tumbler : n, 곡예사,오뚝이(장난감),큰 컵(하나 그득)(전에는 밑이 튀어나와서 탁자에 놓을 수 없었음),공중제비하는 비둘기
tumblerful : n, 큰 컵 한 잔(의 양)
tumbleweed : n, (미국 서부산의) 비름속의 풀(가을에,밑동에서 부러져 바람에 날림)
tumbling : n, 텀블링(매트에서 하는 공중제지 등)
tumbrel : n, 비료차,(프랑스 혁명 때의) 사형수 호송차,두 바퀴의 탄약차
tumefacient : a, (몹시)부어오른,종창성의,부어오르게 하는
tumefaction : n, 부어오름,종창,종기
tumefy : vi,vt, 부어(부풀어) 오르(게 하)다
Tumen : n, 두만강
tumesce : vi, 발기하다
tumescence : n, 팽창,비대,부어오름,통화 팽창,성행위 전의 심신의 흥분 상태,팽창 (비대)한 부분
tumescent : a, 부어 오르는,종창성의
tumid : a, 부은,과장된
tumidity : n, 부어오름,종창,과장
tummy : n, 배
tummyache : n, 배앓이,복통(stomachache)
tumor : n, 종창,부기,종기
tumorigenesis : n, 종양 형성
tumorigenic : a, 종양 형성(성)의,발암성의
tumorous : a, 종양의(같은)
tump : n, 작은 산,작은 언덕,덤불
tumpline : n, (등짐을 질때)이마(가슴)에 거는 멜빵
tumult : n, (크게) 떠들썩함,소동,혼란,흥분
tumultuary : a, 규율(질서)없는,(군대가)오합지졸의,지리멸렬한
tumultuous : a, 떠들썩한,흥분한,혼란한
tumulus : n, 고분
tun : n,vt, 큰 술통(에 넣다),턴(액량의 단위)
tuna : n, 다랑어
tunable : a, =TUNE
tundra : n, (북시베리아 등의)툰드라,동토대
tune : n, 곡조,(노래)곡,장단이 맞음,조화,협조,(마음의)상태,기본,in (out of) ~ 장단이 맞아서,사이좋게(with),sing another (a different) ~ 논조(태도)를 바꾸다,갑자기 겸손해지다
tune : vt, (악기의)음조를 맞추다,조율하다,조화시키다(to),노래하다,~ to (라디오 등)파장을 맞추다,~ out (라디오 따위를)끄다,~ up (악기의) 음조를 정조하다,노래하기(연주하기)시작하다,울기 시작하다
tunedin : a, 새로운 감각에 통한,새것을 좋아하는,선
tuneful : n,vi, 청취자를 불쾌하게 하여 프로를 듣지 않게 하는 요소,방송 청취를 그만두다,다이얼을 딴데로 돌리다
tuner : n, 조율사,(라디오,TV) 파장 조정기,튜너
tunesmith : n, (대중음악의)작곡가
tung : n, =TUNG TREE
tung oil : x, 동유
tungstate : n, 텅스텐산염
tungsten : n, 텅스텐
tungstic : a, 텅스텐의(을 함유한)
tungstous : a, (저원자가)텅스텐의
tung tree : x, 유동나무
Tungus : n,a, 퉁구스사람,퉁구스어(의),퉁구스족의
tunic : n, (고대 그리스,로마인의) 소매 짧은 윗도리,허리에 착달라붙는 여자 저고리,(군인,경관의)윗옷의 일종,피막,종피
tunicate : a, 피막이 있는
tunicle : n, 주교가 제복 밑에 입는 얇은 명주옷
tuning : n, 정조,조율
tuning fork : x, 소리굽쇠,음차
Tunisia : n, 북아프리카의 공화국
tunnage : n, =TONNAGE
tunnel : n,vt,vi, 터널(을 파다),지하도
tunnel diode : x, 터널 다이오드(터널 효과를 이용한 다이오드)
tunnel effect : x, 터널 효과
tunnelvisioned : a, 시야가 매우 좁은
tunny : n, 다랑어
tuny : a, 음조가 좋은
tup : n, 숫양,(말뚝박는) 증기 해머의 머리부분
tupelo : n, (북미산) 충충나무과의 큰 나무,그 목재(단단함)
TupiGuarani : n, (브라질의) 투피(과라니) 토인(말)
tuppence : n, =TWOPENCE
tuppenny : a,n, =TWOPENNY
tuque : n, 긴 양말 모양의 털방한모
turban : n, (회교도의) 터번,터번형의 부인 모자
turbary : n, 토탄 채굴장,이탄전,(공유지 또는 타인의 소유지의)토탄 채굴권
turbid : a, 흐린,흙탕물의,어지러운
turbidimeter : n, (액체용)탁도계
turbidite : n, 심해,퇴적물(혼탁류로 운반된)
turbidity : n, 흐림,혼란(상태),혼탁도,탁도
turbinate : a,n, 나선형의,소용돌이 모양의,갑개골(의)
turbination : n, 거꾸로 세운 원뿔 모양,소용돌이 모양(spiral)
turbine : n, 터빈
turbit : n, 집비둘기의 일종
turbocharged : n, 터보헬리콥터(가스 터빈을 동력으로 함)
turboelectric : a, 터빈(터보)전기의
turbofab : n, 터보팬엔진(팬으로 가속 추진되는 터보 제트 엔진),터보 송풍기
turbogenerator : n, 터빈 발전기
turbojet : n, 터보 제트기
turbojet engine : x, 터빈식 분사 추진기관
turboliner : n, 터빈 열차(가스 터빈 엔진을 동력으로 하는 고속 열차)
turbopause : n, 난류권 계면
turboprop : n, 터보프롭 엔진
turbopump : n, 터보펌프(추진약을 공급)
turboshaft : n, 터보샤프트(전도 장치가 붙은 가스 터빈 엔진)
turbot : n, 가자미 류
turbulence : n, (바람,물결 등의)휘몰아침,거칡,(사회적)소란,불온,동란,(대기의)난류,난기류,교류
turbulent : a, (파도,바람이)거친,광포한,소란 스러운
turd : n, 똥(덩어리),똥 같은 놈,비천한 인간
tureen : n, (뚜껑 달린)수프 그릇
turf : n, 잔디,떼,한 장의 뗏장,토탄,경마(장),on the ~ 경마를 업으로 하여
turf : vt, 잔디로 덮다
turgid : a, 부은(swollen),과장된
Turk : n, 터키인,난폭자,개구쟁이
turkestan : n, 중앙 아시아의 한 지방
Turkey : n, 터키(공화국)
turkey : n, 칠면조(의 고기),실패,(영화,영극의) 실패작,talk (cold) ~ 입바른 소리를 하다
turkey buzzard : x, (중.남미산의) 독수리의 일종(머리가 붉음)
turkey cock : x, 수칠면조,젠체하는 사람
Turkey stone : x, 터키 숫돌의 일종=TURQUOISE
Turkish : a,n, 터키(인,식)의,터키어(의)
Turkish bath : x, 터키탕
Turkish Empire : x, 오토만 제국
turkish towel : x, 보풀이 긴 타월(천)
Turkoman : n, 투르코만 사람(말)
turmeric : n, (인도산)심황,심황 뿌리(의 가루) (조미료,물감용)
turmoil : n, 혼란,소동
turn : vt, 돌리다,(고동을)틀다,...을 돌아가다(~ the corner),뒤집다,(책장을)넘기다,뒤집어 엎다,뒤겨 보내다,향하게 하다,바꾸다,번역하다,나쁘게 하다,돌게 만들다,(선반,녹로 따위로)갈리다,형을 만들다,생각해(짜)내다
turn : vi, 돌다,회전하다,구르다,뒹굴다,굼틀대다,방향을 바꾸다,돌다,기울다,변하다,...으로 변하다,(머리가)어찔어찔하다,핑 돌다,(속이)메스껍다,선반을 돌리다
turn : a, 회전,전향,말투,변화,순번,경향,모양,한 바탕의 일,(새끼 등의)한 사리,놀람,복자,경도,회음,at every ~ 어는 곳에나,by ~s 교대로,번갈아,give (a person) a ~ 놀라게 하다,in ~ 차례로,on the ~ 변하기 시작하여
turn : v,n, 돌리다,돌다,뒤집다,(모퉁이를)돌다,향하게 하다,방향을 바꾸다,변화시키다,바뀌다,...이 되다
turnabout : n, 방향 전환,변절,전향,회전 목마
turnaboutface : n, 180도의 전환
turnaround time : x, 총처리 시간,회송 시간
turnbuckle : n, 나사 조이개,턴버클
turncap : n, (굴뚝의)회전식 불똥마개
turncoat : n, 변절자
turncock : n, (수도 등의)고동,수도 급수전 담당자
turndown : a, 접어 젖힌 깃의
turned : a, 녹로로 세공한
turnedoff : a, 마약 기운이 떨어진,마음 내키지 않는,지겨운
turner : n, 선반공,갈이장이
turnery : n, 선반 작업(기술),선반(녹로)세공(법),선반(녹로)세공 공장
turning : n, 회전,선회,변절,변화,굴곡,녹로(선반)세공
turning point : x, 변환점,전(환)기,위기
turnip : n, 순무
turniptops : n, 순무의 잎
turnipy : a, 순무같은(맛이 나는)
turnkey : n, 교도관
turnoff : n, (간선 도로의)지선 도로,(고속 도로의)램프웨이,완성품,시장에서 거래된 가축의 수(중량)
turnon : n, 흥미를 돋우는(자극적인)사람(것),흥분,도취
turnout : n, (구경,행렬 따위에) 나온 사람들,출석자,대피선,생산액,산출고,동맹 파업(자),마차와 구종,채비
turnover : n,a, 전복,접은 것,(노동자의) 인사 이동,배치전환,투하 자본 회전(율),(일기의)총매상고,접어 젖힌 (칼라 따위)
turnpike : n, 유료 도로,통행료를 받는 문(길)
turnplate : n, =TURNTABLE
turnround : n, 반환 지점,안팎 겸용 옷
turnscrew : n, 나사돌리개,드라이버
turnsole : n, 향일성 식물,해바라기,리트머스,보랏빛 물감
turnspit : n, 산적 꼬챙이를 돌리는 사람,턴스피트종의 개
turnstile : n, 회전식 문
turnstone : n, 꼬마물떼새
turntable : n, 전차대,(축음기의) 회전반
turnup : n,a, 뜻밖에 나타난사람,돌발 사건,격투,(바지 따위의)접어 올린 (부분)
turnverein : n, 체조 협회
turpentine : n,vt, 테레빈,테레빈유(를 바르다)
turpeth : n, 얄랍(jalap),얄랍의 뿌리(동인도산,그 뿌리는 하제)
turpitude : n, 비열,배덕
turquoise : n, 터키옥(보석),청록색(의)
turret : n, 작은 탑,망루,(선회) 포탑,(전투기의) 조종석
turreted : a, 작은 탑(망루)이 있는,포탑이 있는
turrethead : n, (선반의)터릿(turret)
turtle : n, 바다거북,호도애,turn ~ (배 따위가) 뒤집히다
turtleback : n, 거북의 등딱지,귀갑,갑판
turtledove : n, 호도애,연인
turtlehead : n, 나도사향나무(북미산)
turtleneck : n, (스웨터 따위의) 자라목깃,자라목 스웨터
turtle shell : x, 대모갑
turtlesoup : n, 바다거북 수프(green turtle의 고기로 만듦)
turves : n, TURF의 복수
Tuscan : a,n, (이탈리아 중부의) Tuscany의 (사람,언어),(기둥이) 토스카나식인
Tuscan : a, 터스커니(사람,말)의
Tuscany : n, 터스커니(이탈리아 중부의 지방)
Tuscarora : n, 투스카로라족(북미 인디언 Iroquois의 한 지족),투스카로라 말
tush : int,n,vi, 체!(하다)
tushery : n, 고어를 많이 써서 멋부린 문체
tusk : n,vt, (긴) 엄니(로 찌르다)
tussah : n, 멧누에(고치),멧누에 명주(실)
tussah silk : x, 멧누에 실,(그것으로 짠)비단
tussive : a, 기침의,기침에 의한
tussle : n,vi, 격투(하다)
tussock : n, 풀숲,덤불,더부룩한 털
tussocky : a, TUSSOCK이 많은
tussore : n, =TUSSAH
tut : int, 체~
tut : vi, 혀를 차다
Tutankhamen : n, 투탕카멘(기원전 14세개 이집트 제 18왕조의 왕,1992년에 그 분묘가 발견되었음)
tutee : n, TUTOR의 지도를 받고 있는 사람,학생
tutelage : n, 보호(감독)(받음),후견,교육,지도,피후견
tutelar : a,n, 보호하는,후견인의,수호신
tutelary : a, 수호의,후견상의,후견인의
tutor : n, 가정 교사,(대학,고교의)개인 지도 교사,강사,후견인
tutor : vt,vi, 가정 교사로서 가르치다,(학생을)지도하다,개인 지도 교사 노릇을 하다,억제하다,개인 교수를 받다
tutorial : a,n, 가정교사의,(영국 대학의)(개별)지도의,후견인의,(영국 대학의 지도 교수의)(개인)지도 시간
tutorship : n, TUTOR의 지위(직무,지도)
tutti : n, 전체 합주,제창,전주효과
tuttifrutti : n, 설탕에 절인 과일(을 넣은 아이스크림)
tutty : n, 불순 산화 아연(마분용)
tutu : n, 튀튀(허리에서 수평으로 펼쳐진 발레용짧은 스커트)
tuxedo : n, 턱시도(남자의 약식 야회복)
tuyere : n, (용광로의)송풍구
TV : n, 텔레비전,terminal velocity 최종(최고)가속도
twa : n, TWO
twaddle : n,vi, 객적은 소리(하다)
twain : n,a, =TWO
Twain : n, Mark (1835-1910) 미국의 소설가
twang : n,vt,vi, 현의 소리,팅(울리게 하다,울리다),콧소리(로 말하다)
twas : x, =it was
twat : n, 여자의 음부,엉덩이,섹스의 대상으로서의 여자,보기 싫은 사람(여자)
tweak : n,vt, 비틀기,꼬집다,왈칵(홱) 당김(당기다),명안
tweaker : n, (어린 아이의)고무줄 새총
twee : a, 귀여운
tweed : n, 트위트(스카치나사),트위드 옷
tweedle : vi,vt,n, (가수,새,악기 등이)강약 변확 풍부한 높은 (목)소리를 내다,악기를 만지다,음악으로 꾀다,달콤한 말로 꾀다,(바이올린 등의)깽깽하는 소리
tweedy : a, 트위드의(같은),트위드를 즐겨 입는,옥외 생활을 즐기는 타입의,격식을 차리지 않는,느긋한
tween : prep, =BETWEEN
tweeny : n, 잡일 맡아 보는 하녀
tweet : n,int,vi, 짹짹(울다),지저귀는 소리
tweeterp : n, 트위터
tweeze : vt, 족집게로 뽑다
tweezers : n,pl, 족집게,핀셋
twelfth : n,a, 제12(의),12분의 1(의)
Twelfth-night : n, 주현절의 전야제
Twelfthday : n, 주현절
twelve : n,a, 12(의),(예수의)12사도,12배
twelvefold : a,ad, 12부분(면)을 가진,12배의,12배로
twelvemo : n, =DUODECIMO
twelvemonth : n, 12개월
twelvepenny : a, 12펜스의
twelvetone : a, 12음(조직)의
twentieth : n, 제20(의),스무번째(의),20분의 1(의)
twenty : n,a, 20(의)
twentyfive : n, 25야드선(내)(골에서)
twentyone : n, 21(개)의,21명의,21점 놀이
twere : x, =it were
twerp : n, 너절한 놈
twibil : n, 양날 곡괭이,양날 전부
twice : ad, 두번,2회,2배로(만큼),think ~ 재고(숙고)하다
twiceborn : a, 두번 태어난,화신의,(정신적으로)재생한,거듭난,화신의,(정신적으로)재생한,재생족의(카스트 중 상위의 3계급,특히 브라만을 이름)
twicelaid : a, (밧줄이)다시 꼰,재생의,대용의
twicer : n, 나쁜놈,배신자
twicetold : a, 두번 이야기한,구문의,진부한
twiddle : vt,vi,n, 만지작거리다,가지고 놀다(with),가지고놀기
twig : n, 잔 가지,가는 가지,hop the ~ 갑작스레 죽다
twig : vt,vi, 이해하다,알다,깨닫다,알아차리다
twiggy : a, 잔가지의(같은),연약한,섬세한,잔가지가 많은
twiirler : n, 빙빙 도는(돌리는)사람(것),투수,바통걸
twilight : n, 어둑새벽,여명,황혼,땅거미,희미한 빛,여명기
twilight : a,vt, 어스레하게 밝은(밝히다)
twilight sleep : x, (무통 분만법의) 반마취상태
twilight war : x, 박모전 (제2차대전때,서부전선에서의 지구전)
twilight zone : x, 중간 지대,경계 영역,도시의 노후화 지역
twilit : a, 어슴푸레한,희미하게 밝은,박명속의
twill : n, 능직,능직물
twilled : a, 능직으로 짠
twin : a,n, 쌍둥이의 (한 사람),닮은(것),쌍둥이
twin-engined : a, =TWIN-MORTORED
twin-motored : a, 쌍발의
twin bed : x, 트윈베드 (둘을 합치면 더블베드가 됨)
twinborn : a, 쌍둥이로 태어난
twine : n,vt,vi, 꼰실,(실을) 꼬다,꼬기,(사리어)감기(감다),얽힘,얽히다
twine : n,vt,vi, 꼰 실,(특히 포장용,그물제조 용등의)삼실,삼끈,바느질실,종이실,꼬기,꼬아 합침,감김,사림,엉클어짐,뒤얽힘,분규,꼬다,꼬아 합치다,짜다,엮다,뜨다,섞어 짜다,감기게 하다,(덩국 등이)감기다,얽히다,구불구불 거리다,구불구불 가다
twiner : n, 꼬는 사람(것,기계),감기는 것,(식물의)덩굴,감겨 기어오르는 식물(나팔꽃 등)
twinge : n,vi,vt, 쑤시는 듯한 아픔,쑤시듯이 아프(게 하)다
twinight : a, 오후늦게부터 밤에 걸쳐 행하는 더블헤더의
twinkie : n, 바보,얼간이
twinkle : vi,vt,n, 빤짝 빤짝 빛나(게 하)다,(눈을)깜빡할 사이,빤짝임,깜짝임,깜빡할 사이
twinkling : a,n, 번쩍거리는,번득이는,반짝반짝 빛나는,(발놀림이)경쾌한,반짝임,번드거임,깜ㅃ가임,순간,어른거림
twinned : a, 쌍둥이로 태어난,쌍생의,쌍을 이루는,쌍정의
twinning : n, 쌍둥이를 낳기(배기),결합,둘을 결부시켜 인용(연상,비교)하기
twinscrew : a, (스크루가)2축의
twinship : n, 쌍둥이 관계(상태),밀접한 관계,근사(유사)성
twinsize : a, 침대가 트윈 사이즈의
twin towns : x, 자매 도시
twirl : vt,vi, 빙글빙글 돌(리)다,손끝으로 이리저리 만지작 거리다,~ one's thumbs
twirl : n, 회전,빙글빙글 돌리기,(펜의) 장식 글씨
twirp : n, =TWERP
twist : vt,vi, 비틀(리)다,꼬(이)다,감(기)다,구부리다,구부러지다,나사모양으로 만들다,소용돌이 치다,곡해하다,억지로 갖다 붙이다,왜곡하여 말하다,누비고 나아가다,~ off 비틀어 떼다,~ up 꼬다,(종이 등을)나사 모양으로 꼬다
twist : n, 한 번 꼬기(비틀기),꼰 실,새끼,끈,(성격의)비꼬임,기벽,혼합주
twisted : a, 꼬인,비틀어진,(표정,마음이)일그러진,(마약으로)황홀해진,술취한
twister : n, 꼬는 사람,실 꼬는 기계,비트는 사람,(마음이)비틀어진 사람,교활하게 속이는 사람,부정직한 사람,곡구,틀어치는 공,어려운 일(문제),선풍,회오리바람(whirlsind),트위스트를 추는 사람
twistrelease : a, 비틀어 여는(뚜껑),비틀어 끄집어 내는
twisty : a, (길 따위가) 구불구불한,부정직한
twit : n,vt, 문책(하다),힐책(하다),조소(하다)
twitch : vt,vi,n, 홱 잡아 당기다,씰룩씰룩 움직이다
twitchy : a, 초조한,안절부절못하는
twite : n, 홍방울새의 일종(유럽산)
twitter : n,vi,vt, 지저귐,지저귀다,벌벌 떨다,킥킥 웃다,안절부절 못함(못하다)
twixt : prep, =BETWIXT
two : n,a, 2(의),두 개(사람)(의),a day or ~ 하루이틀,by ~s and threes 드문드문,삼삼오오,in ~ 두 동강으로,in ~ ~s 곧.순식간에,put ~ and ~ together 이것 저것 종합하여 생각하다,결론을 내다,~ and ~ or ~ by ~ 둘씩
twobagger : n, =TWOBASE HIT
twobase hit : x, 2루타
twobeat : a, (jazz가)4/4박자로 2박자와 4박자에 accent를 두는
twobit : a, 25센트의,근소한,보잘것 없는
twobyfour : a,n, 가로 2인치(피트) 세로 4인치 (피트)의,좁은,작은,폭 4인치 두께 2인치의 널
twocycle : a, (내연 기관이)2사이클의
twodecker : a, 2중 갑판의(배),2층 있는(전차(버스)(doubledecker)
twodigit : a, 두 자리의(doubledigit)
twodimensional : a, 2차원의,평면적인,(작품 등이)깊이가 없는
twoedged : a, =DOUBLEEDGED
twofaced : a, =DOUBLEFACED
twofer : n, (극장 등의) 반액 할인권
twofisted : a, 두 주먹을 쥔,두주먹을 쓸 수 있는,강한,원기 왕성한,남성적인,정력적인(vigorous)
twofole : n, 둘로 접히는 무대배경
twohanded : a, 양손이 있는,양손을 쓸 수 있는,2인용의
twolegged : a, 다리가 둘인,양각의
twoline : a, (활자가)배형의
twomasted : a, 쌍돛대의,두대박이의
twoness : n, 둘임,이중성
twopart : a, 2부의
twoparty system : x, 2대 정당제
twopaycheck : a, 버는 사람이 둘 있는,수입원이 둘 있는,맞벌이의
twopence : n, 2펜스(은화)
twopenny : a,n, 펜스의,싸구려의
twopennyhalfpenny : a, 하찮은,싸구려의
twophase : a, 2상의
twopiece : n,a, 투피스
twoply : a, 두 겹으로 짠,(실이)두 겹인
twoseater : a, 2인승 비행기(자동차)
twosided : a, 양면이(표리가) 있는
twosome : n, 둘이 하는 경기(댄스)
twospeed : a, 2단 변속의
twospot : n, (카드의)2의패,(도미노의)2의 말,2달러(지폐)
twostep : n, 2박자의 원무(곡)
twostory : a, 2층의
twostroke : a, 2행정 사이클(엔진)의
twotime : vt,vi, 배신하다,속이다(특히 남편,아내,애인을)
twotone : a, 두 색의(같은 또는 다른 계통의 색을 배열한)
twotongued : a, 두말하는,속이는
twould : x, =it would
twoup : n, 동전 2개를 던져 둘 다 (뒷)면인가에 거는 내기
twovalued : a, 진위2가의
twoway : a, 두 길의,양면 교통의,상호적인,송수신 겸용의
twowheeler : n, 2륜 마차,자전거
twyer : n, =TUYERE
Tyburn : n, 런던의 사형장
Tyche : n, 티케(운명의 여신,로마 신화의 Fortuna에 상당)
Tycho : n, 티코(월면 제 3상한 크레이터)
tycoon : n, 실업계의 거물
tycoonate : n, TYCOON의 직위
tying : v, tie의 현재 분사
tyke : n, 똥개(dur),개구쟁이
tylectomy : n, 못(변지)절제술
tylosis : n, 안검 경화증,변지종(조직의 경화),전충 세포(도관부에 있는)
tympan : n, 얇은 막
tympani : n, =TIMPANI
tympanic : a, 고막(중이)의
tympanic membrane : x, 고막
tympanist : n, =TIMPANIST
tympanites : n, 고창
tympanitis : n, 중이염
tympanum : n, 고막,중이,큰 북,(gable 과 현관 위쪽사이 등의)삼각형의 작은 면
Tyndale : n, ,William (1492?-1536)영국의 종교 개혁가(신약 성서를 영역(1526),이것은 A.V.의 모체가 되었음)
tyndallometer : n, 틴달로미터(부유분진 측정기)
Tyne : n, 타인 강(잉글랜드 북동부에서 북해로 흐르는 강)
typal : a, 유형으로서의,전형적인
type : n, 형,유형,양식,전형,견본,표,활자,혈액형,in ~ 활자로 짠(짜서),set ~ 조판하다
type : vt, 타이프라이터로 찍다,(혈액)형을 검사하다,상징하다,...의 전형이 되다
typebar : n, 타이프바(타자기의 활자가 달려있는),(한행이 잇달아 주조된)활자봉(라이노타이프 주조기의)
type cast : vt, (극중 인물의 신장,목소리 따위에 맞는) 배우를 배역하다
typecast : vt, (체격,성격을 고려해서)같은 타입의 배역만을 맡긴다
typeface : n, 활자면,(활자)서체
type founder : x, 활자 주조공(업자)
typefounder : n, 활자 주조 업자
typefoundry : n, 활자 주조소
type metal : x, 활자 합금
typescript : n, 타이프라이터로 친 원고(문서)
typeset : vt, 식자하다,조판하다
typesetter : n, 식자공
typesetting : a, 식자(조판)의
typewrite : vt, 타이프라이터로 찍다(치다)
typewriter : n, 타이프라이터,타자기
typewriting : n, 타자 기술,타자기 사용,타자하는 일,타이프 인쇄(물)
typewritten : a, 타자기로 친
typhlitis : n, 맹장염
typhlology : n, 맹목학
typhoid : a,n, 장티푸스의(같은)
typhoidal : a, 장티푸스(성)의
typhon : n, 타이폰(압축 공기등에 의한 호적)
typhonic : a, 태풍(성)의
typhoon : n, 태풍
typhus : n, 발진티푸스
typic : a, =TYPICAL
typical : a, 전형적인,대표적인,상징적인(of),특징 있는(of)
typicality : n, 전형적임,대표적임,특유성,특징성
typically : ad, 전형적으로,예에 따라,으레,일반적으로,대체로
typification : n, 대표(할 수 있음),상징,전조
typify : vt, 대표하다,...의 전형이 되다,상징하다,예시하다(foreshadow)
typing : n, 타이프라이프치기
typist : n, 타이피스트
typographer : n, 인쇄공,식자공
typographic : a, 인쇄(상)의
typography : n, 인쇄(술)
typological : a, 예표론의,유형학의,인쇄(활자)에 관한
typology : n, 유형학,활자(인쇄)학
Tyr : n, Odin의 아들,승리의 신
tyrannic : a, 포악한,무도한,압제적인
tyrannicide : n, 폭군,살해(자)
tyrannicl : a, 전제 군주적인,압제 적인,무도한,포학한(cruel)
tyrannize : vi,vt, 학정(폭정)을 행하다,학대하다(over)
tyrannosaur : n, 육식 공룡의 하나
tyrannosaurus : n, 육식 공룡의 하나
tyrannous : a, 포악한,폭군적인
tyranny : n, 전제 정치,폭정,포학,학대,포학한 행위,참주정치
tyrant : n, 참주,폭군
Tyre : n, 고대 페니키아의 도시(부유함과 악덕으로 유명했음)
Tyrian : a,n, TYRE의 (사람)
tyro : n, 초심자,초학자,신참자
Tyrol : n, 알프스 산맥 중의 한 지방
Tyrolese : a, 티롤(사람)의
tyrotoxicon : n, (fly) =TSETSE (fly)
tzarina : n, 제정 러시아의 황후(czarina)
Tzigane : n,a, 헝가리계 집시(의)
tzitzith : n,pl, =ZIZITH
